pXC50,N.,SCBO,Sv,X.,nH,nX,nF,nBM,nSK,Se,nC,nBT,nAT,Si,MW,C.,O.,nHet,nCsp2
5.27,3.1,46.0,39.804,0.0,32,0,0,17,33,64.767,27,69,65,73.062,448.61,41.5,6.2,6,15
6.3,2.8,57.0,45.519,0.0,32,0,0,24,39,71.094,32,76,71,79.272,524.66,45.1,7.0,7,23
5.95,3.3,51.0,39.224,0.0,26,0,0,23,34,60.116,28,65,60,66.817,454.56,46.7,6.7,6,21
5.62,3.4,44.0,37.223,0.0,28,0,0,17,31,58.749,25,63,59,65.942,436.62,42.4,5.1,6,15
5.21,7.7,45.5,33.971,0.0,22,0,0,21,30,52.342,23,57,52,58.358,402.49,44.2,5.8,7,16
5.95,3.5,47.0,36.794,0.0,26,0,0,22,31,56.461,27,62,57,63.398,410.55,47.4,3.5,4,20
5.71,3.8,42.0,34.169,0.0,24,0,0,17,29,52.982,23,57,53,59.112,408.56,43.4,5.7,6,15
5.51,3.6,43.0,35.224,0.0,26,0,0,17,30,56.116,24,60,56,62.817,406.52,42.9,7.1,6,15
4.55,2.9,47.0,41.331,0.0,34,0,0,17,34,67.65,28,72,68,76.477,462.64,41.2,5.9,6,15
4.66,3.4,11.0,14.929,0.0,18,0,0,0,11,28.767,8,29,29,33.446,160.27,27.6,6.9,3,0
5.32,4.1,41.0,32.283,2.0,21,1,0,17,28,49.345,22,53,49,54.721,396.9,44.9,6.1,6,15
5.27,4.1,41.0,32.283,2.0,21,1,0,17,28,49.345,22,53,49,54.721,396.9,44.9,6.1,6,15
5.44,3.8,42.0,33.697,0.0,24,0,0,17,29,53.232,23,57,53,59.401,392.49,43.4,7.5,6,15
5.51,3.4,44.0,36.75,0.0,28,0,0,17,31,59.0,25,63,59,66.232,420.55,42.4,6.8,6,15
6.32,2.9,54.0,43.804,0.0,32,0,0,23,37,68.767,31,74,69,77.062,496.65,44.9,5.8,6,21
5.47,3.2,45.0,38.277,0.0,30,0,0,17,32,61.883,26,66,62,69.647,434.58,41.9,6.5,6,15
4.71,5.3,43.0,35.53,0.0,27,0,0,17,30,56.891,24,61,57,64.106,405.54,42.1,5.3,6,15
5.6,3.4,44.0,36.75,0.0,28,0,0,17,31,59.0,25,63,59,66.232,420.55,42.4,6.8,6,15
5.43,3.6,43.0,35.224,0.0,26,0,0,17,30,56.116,24,60,56,62.817,406.52,42.9,7.1,6,15
5.6,3.4,44.0,36.75,0.0,28,0,0,17,31,59.0,25,63,59,66.232,420.55,42.4,6.8,6,15
4.55,4.0,41.0,32.17,0.0,22,0,0,17,28,50.349,22,54,50,55.986,378.46,44.0,8.0,6,15
5.2,4.3,35.0,30.147,6.4,21,3,2,13,26,47.6,20,49,47,53.397,378.88,42.6,2.1,6,13
5.3,4.5,33.0,28.236,4.5,20,2,1,13,24,44.203,19,46,44,49.642,346.86,43.2,2.3,5,13
5.8,4.8,34.0,27.71,4.8,18,2,1,14,24,42.32,19,44,42,47.227,344.84,45.2,2.4,5,15
6.1,4.3,33.0,29.38,2.1,23,1,0,13,24,46.574,20,49,47,52.717,342.9,42.6,2.1,4,13
5.0,7.5,30.5,26.008,2.5,18,1,0,12,22,40.102,16,42,40,44.89,335.89,40.0,2.5,6,10
6.3,4.3,34.0,29.763,4.3,22,2,1,13,25,47.087,20,49,47,53.057,360.89,42.6,2.1,5,13
5.0,4.3,33.0,29.38,2.1,23,1,0,13,24,46.574,20,49,47,52.717,342.9,42.6,2.1,4,13
5.0,4.5,32.0,27.853,2.3,21,1,0,13,23,43.691,19,46,44,49.302,328.87,43.2,2.3,4,13
6.081,6.5,38.0,30.791,13.0,17,6,5,13,29,48.356,19,48,46,53.499,433.84,41.3,2.2,10,13
5.0,6.0,35.0,31.116,2.0,24,1,0,13,26,50.003,20,52,50,56.425,373.92,40.0,4.0,6,13
5.387,6.1,37.0,31.551,8.2,21,4,3,13,28,50.214,20,51,49,56.235,411.89,40.8,2.0,8,13
5.387,5.8,41.0,34.228,13.5,20,7,6,13,32,54.636,21,54,52,60.669,479.89,40.4,1.9,11,13
5.0,5.8,41.0,34.228,13.5,20,7,6,13,32,54.636,21,54,52,60.669,479.89,40.4,1.9,11,13
7.987,1.9,27.0,29.638,0.0,31,0,0,6,22,51.683,20,55,53,59.936,301.52,37.7,1.9,2,6
5.886,6.0,35.0,31.116,2.0,24,1,0,13,26,50.003,20,52,50,56.425,373.92,40.0,4.0,6,13
5.0,6.1,34.0,30.401,2.0,24,1,0,13,25,48.676,20,51,49,55.216,357.92,40.8,2.0,5,13
5.456,6.1,34.0,30.401,2.0,24,1,0,13,25,48.676,20,51,49,55.216,357.92,40.8,2.0,5,13
5.0,6.5,35.0,29.641,6.5,20,3,2,13,26,46.818,19,48,46,52.48,379.87,41.3,2.2,7,13
5.638,6.5,34.0,29.702,4.3,21,2,0,13,25,46.116,19,48,46,51.744,378.33,41.3,2.2,6,13
5.711,6.0,40.0,32.145,2.0,22,1,1,15,28,50.309,22,53,50,56.405,379.47,44.0,4.0,6,16
6.14,7.9,32.0,25.294,2.6,16,1,0,13,22,38.142,17,41,38,42.555,313.81,44.7,2.6,5,13
8.695,1.8,24.0,30.407,0.0,35,0,0,1,22,55.778,19,58,57,64.976,309.55,33.3,3.5,3,1
5.719,6.4,39.0,30.777,2.1,20,1,0,16,27,47.563,20,51,47,52.804,385.88,42.6,6.4,7,13
4.137,3.5,51.0,50.173,0.0,45,0,0,14,40,84.247,32,88,85,95.972,567.87,37.6,4.7,8,14
6.777,1.9,29.0,29.826,0.0,29,0,0,8,23,51.127,20,53,52,58.73,315.5,38.5,3.8,3,9
8.21,11.1,24.0,17.601,0.0,11,0,0,11,16,27.494,11,28,27,30.575,217.25,40.7,7.4,5,6
6.427,2.0,28.0,28.299,0.0,27,0,0,8,22,48.243,19,50,49,55.315,301.47,38.8,4.1,3,9
6.607,4.9,32.0,26.612,2.4,19,1,0,13,22,40.48,19,44,41,45.677,310.85,46.3,0.0,3,13
6.01,2.7,24.0,22.192,0.0,19,0,0,8,18,36.709,15,38,37,41.654,245.35,40.5,5.4,3,9
7.606,1.9,36.0,32.299,0.0,27,0,0,14,26,52.243,23,55,53,59.315,349.51,43.4,3.8,3,15
6.22,1.9,37.0,33.014,0.0,27,0,0,14,27,53.571,23,56,54,60.524,365.51,42.6,5.6,4,15
6.397,1.7,31.0,32.88,0.0,33,0,0,8,25,56.894,22,59,58,65.56,343.56,37.9,3.4,3,9
6.102,3.8,10.0,13.402,0.0,16,0,0,1,10,25.883,7,25,26,30.031,146.24,26.9,7.7,3,1
4.96,1.7,33.0,33.88,0.0,33,0,0,8,26,57.894,23,61,59,66.56,355.57,39.0,3.4,3,9
5.935,2.6,29.0,24.477,0.0,19,0,0,6,20,38.382,18,45,39,43.445,265.38,46.2,2.6,2,6
6.572,2.5,26.0,24.004,0.0,21,0,0,12,19,39.265,17,41,40,44.86,255.39,42.5,2.5,2,12
7.123,4.9,29.0,25.214,0.0,20,0,0,13,21,40.811,17,42,41,46.152,284.39,41.5,4.9,4,12
5.515,0.0,73.0,77.499,0.0,74,0,0,5,62,136.275,48,142,136,154.294,875.22,35.3,10.3,14,9
7.237,1.7,31.0,32.88,0.0,33,0,0,8,25,56.894,22,59,58,65.56,343.56,37.9,3.4,3,9
9.423,2.1,30.0,27.939,0.0,24,0,0,7,23,47.072,18,50,47,53.111,318.43,38.3,8.5,5,7
9.699,2.0,29.0,29.278,0.0,28,0,0,7,23,50.512,19,53,51,57.732,318.48,37.3,5.9,4,7
7.754,2.3,29.0,26.149,0.0,21,0,0,7,22,43.247,17,46,43,48.488,303.39,39.5,9.3,5,7
6.01,2.7,24.0,22.192,0.0,19,0,0,8,18,36.709,15,38,37,41.654,245.35,40.5,5.4,3,9
7.606,1.9,36.0,32.299,0.0,27,0,0,14,26,52.243,23,55,53,59.315,349.51,43.4,3.8,3,15
8.767,2.1,32.0,29.058,0.0,25,0,0,12,23,47.032,21,51,48,53.69,307.47,43.8,2.1,2,12
5.177,0.0,40.0,37.454,1.6,30,1,1,5,32,63.243,22,65,62,70.382,472.49,35.5,12.9,10,6
5.724,1.9,29.0,29.826,0.0,29,0,0,7,23,51.127,20,54,52,58.73,315.5,38.5,3.8,3,7
5.982,5.3,26.0,23.612,2.6,19,1,0,12,19,37.48,16,39,38,42.677,274.82,42.1,0.0,3,11
6.22,2.3,26.0,25.246,0.0,23,0,0,8,20,42.476,17,44,43,48.484,273.41,39.5,4.7,3,9
7.25,1.8,32.0,32.353,0.0,31,0,0,8,25,55.01,22,58,56,63.145,341.54,39.3,3.6,3,9
5.38,2.5,25.0,23.719,0.0,21,0,0,8,19,39.592,16,41,40,45.069,259.38,40.0,5.0,3,9
6.39,2.2,27.0,26.773,0.0,25,0,0,8,21,45.36,18,47,46,51.9,287.44,39.1,4.3,3,9
6.798,1.8,32.0,32.353,0.0,31,0,0,8,25,55.01,22,58,56,63.145,341.54,39.3,3.6,3,9
5.507,1.7,45.0,37.826,0.0,29,0,0,20,31,59.127,28,63,60,66.73,411.58,46.7,3.3,3,21
6.483,1.6,32.0,34.407,0.0,35,0,0,8,26,59.778,23,62,61,68.976,357.59,37.7,3.3,3,9
7.071,4.0,55.0,47.179,1.3,36,1,0,21,39,74.709,31,79,75,84.046,566.22,41.3,4.0,8,19
7.069,1.6,32.0,34.407,0.0,35,0,0,8,26,59.778,23,62,61,68.976,357.59,37.7,3.3,3,9
5.301,1.8,37.0,33.826,0.0,29,0,0,14,27,55.127,24,58,56,62.73,363.54,42.9,3.6,3,15
6.301,1.9,37.0,33.014,0.0,27,0,0,14,27,53.571,23,56,54,60.524,365.51,42.6,5.6,4,15
5.899,1.7,33.0,33.88,0.0,33,0,0,8,26,57.894,23,61,59,66.56,355.57,39.0,3.4,3,9
6.27,1.8,30.0,31.353,0.0,31,0,0,8,24,54.01,21,56,55,62.145,329.53,38.2,3.6,3,9
6.938,1.9,31.0,30.826,0.0,29,0,0,8,24,52.127,21,55,53,59.73,327.51,39.6,3.8,3,9
6.253,2.2,27.0,26.773,0.0,25,0,0,8,21,45.36,18,47,46,51.9,287.44,39.1,4.3,3,9
5.656,5.1,34.5,27.927,7.7,15,3,0,17,24,39.32,18,41,39,43.07,397.77,46.2,0.0,6,15
5.948,2.3,26.0,25.246,0.0,23,0,0,8,20,42.476,17,44,43,48.484,273.41,39.5,4.7,3,9
6.857,1.9,29.0,29.826,0.0,29,0,0,8,23,51.127,20,53,52,58.73,315.5,38.5,3.8,3,9
6.1,6.3,31.0,28.672,2.1,24,1,1,7,24,48.192,18,51,48,54.821,333.45,37.5,4.2,6,7
7.9,4.8,36.0,36.306,1.6,34,1,1,7,29,62.61,23,66,63,71.897,403.6,36.5,3.2,6,7
7.7,3.1,35.0,36.428,0.0,36,0,0,7,28,62.879,24,67,64,72.474,384.62,37.5,3.1,4,7
7.7,3.3,34.0,34.901,0.0,34,0,0,7,27,59.996,23,64,61,69.059,370.59,37.7,3.3,4,7
6.9,3.4,33.0,33.374,0.0,32,0,0,7,26,57.112,22,61,58,65.643,356.56,37.9,3.4,4,7
6.4,3.6,33.0,32.562,0.0,30,0,0,7,26,55.556,21,59,56,63.438,358.53,37.5,5.4,5,7
6.0,3.6,33.0,32.562,0.0,30,0,0,7,26,55.556,21,59,56,63.438,358.53,37.5,5.4,5,7
7.3,3.4,35.0,34.473,1.7,31,1,1,7,28,58.952,22,62,59,67.193,390.55,37.3,5.1,6,7
6.8,3.4,35.0,34.473,1.7,31,1,1,7,28,58.952,22,62,59,67.193,390.55,37.3,5.1,6,7
6.8,3.3,35.0,34.804,0.0,32,0,0,7,28,59.767,22,63,60,68.062,388.56,36.7,6.7,6,7
6.4,5.3,37.0,34.057,0.0,29,0,0,8,28,56.774,22,60,57,64.521,383.54,38.6,5.3,6,7
5.9,3.2,39.0,36.706,0.0,32,0,0,9,30,62.171,22,65,62,70.192,436.63,35.5,8.1,8,7
5.3,3.1,40.0,38.233,0.0,34,0,0,9,31,65.054,23,68,65,73.607,450.66,35.4,7.7,8,7
6.5,3.1,40.0,38.233,0.0,34,0,0,9,31,65.054,23,68,65,73.607,450.66,35.4,7.7,8,7
6.8,3.2,36.0,36.331,0.0,34,0,0,7,29,62.65,23,66,63,71.477,402.59,36.5,6.3,6,7
6.0,4.9,39.0,36.299,0.0,31,0,0,8,30,60.985,23,64,61,69.145,413.57,37.7,6.6,7,7
6.063,1.9,37.0,33.014,0.0,27,0,0,14,27,53.571,23,56,54,60.524,365.51,42.6,5.6,4,15
8.564,1.8,33.0,33.068,0.0,31,0,0,8,26,56.338,22,58,57,64.355,357.54,38.6,5.3,4,7
5.448,1.7,45.0,37.826,0.0,29,0,0,20,31,59.127,28,63,60,66.73,411.58,46.7,3.3,3,21
5.0,0.0,84.0,86.698,0.0,72,0,0,0,78,157.592,42,156,150,172.486,1153.14,28.0,24.0,36,0
8.983,1.9,30.0,30.804,0.0,30,0,0,7,24,53.396,20,56,54,61.147,332.51,37.0,5.6,4,7
6.721,1.9,36.0,32.299,0.0,27,0,0,14,26,52.243,23,55,53,59.315,349.51,43.4,3.8,3,15
5.051,5.1,41.0,36.057,0.0,29,0,0,14,30,58.774,24,62,59,66.521,407.56,40.7,5.1,6,14
5.347,1.9,27.0,29.638,0.0,31,0,0,7,22,51.683,20,54,53,59.936,301.52,37.7,1.9,2,7
5.921,4.3,47.0,42.119,2.9,33,2,2,14,36,69.778,27,72,69,78.655,501.63,39.1,5.8,9,14
5.229,2.3,44.0,30.913,9.3,13,4,4,20,30,45.203,22,46,43,48.807,415.36,51.2,7.0,8,20
5.886,3.1,12.0,16.456,0.0,20,0,0,0,12,31.651,9,32,32,36.862,174.3,28.1,6.3,3,0
4.523,2.3,45.0,31.297,11.6,12,5,5,20,31,45.716,22,46,43,49.147,433.35,51.2,7.0,9,20
5.495,2.8,37.0,25.906,8.3,10,3,3,14,26,38.578,17,39,36,41.056,365.28,47.2,13.9,9,14
4.523,2.3,43.0,30.53,7.0,14,3,3,20,29,44.691,22,46,43,48.467,397.37,51.2,7.0,7,20
4.523,2.3,44.0,31.245,6.8,14,3,3,20,30,46.018,22,47,44,49.677,413.37,50.0,9.1,8,20
5.796,4.8,43.0,30.025,7.1,13,3,3,20,29,43.909,21,45,42,47.55,398.36,50.0,7.1,8,19
5.553,4.8,43.0,30.025,7.1,13,3,3,20,29,43.909,21,45,42,47.55,398.36,50.0,7.1,8,19
5.678,7.3,43.0,29.519,7.3,12,3,3,20,29,43.127,20,44,41,46.633,399.35,48.8,7.3,9,18
5.62,6.3,34.0,23.799,12.5,8,4,3,14,24,34.465,15,34,32,36.664,356.7,46.9,9.4,9,13
5.509,4.8,43.0,30.025,7.1,13,3,3,20,29,43.909,21,45,42,47.55,398.36,50.0,7.1,8,19
4.523,7.3,43.0,29.519,7.3,12,3,3,20,29,43.127,20,44,41,46.633,399.35,48.8,7.3,9,18
4.523,7.3,43.0,29.519,7.3,12,3,3,20,29,43.127,20,44,41,46.633,399.35,48.8,7.3,9,18
5.42,4.8,43.0,30.025,7.1,13,3,3,20,29,43.909,21,45,42,47.55,398.36,50.0,7.1,8,19
5.398,7.3,43.0,29.519,7.3,12,3,3,20,29,43.127,20,44,41,46.633,399.35,48.8,7.3,9,18
5.357,7.3,43.0,29.519,7.3,12,3,3,20,29,43.127,20,44,41,46.633,399.35,48.8,7.3,9,18
5.495,4.7,44.0,30.74,7.0,13,3,3,20,30,45.236,21,46,43,48.76,414.36,48.8,9.3,9,19
5.824,4.7,45.0,31.123,9.3,12,4,4,20,31,45.749,21,46,43,49.099,432.35,48.8,9.3,10,19
5.658,4.3,46.0,32.981,6.4,15,3,3,20,32,49.447,22,50,47,53.384,444.39,46.8,10.6,10,19
5.553,5.0,42.5,29.4,7.5,11,3,3,19,29,42.429,19,43,40,45.265,420.39,47.5,10.0,10,17
6.012,3.6,33.0,33.105,1.8,29,1,0,7,27,56.207,20,58,56,63.591,396.96,35.7,7.1,7,7
5.392,3.9,28.0,29.036,0.0,28,0,0,7,23,50.672,18,52,51,58.022,320.48,35.3,5.9,5,7
5.0,3.8,32.0,31.134,1.9,27,1,1,7,26,53.512,19,55,53,60.572,366.48,35.8,7.5,7,7
6.979,3.3,61.0,66.9,0.0,70,0,0,12,50,117.221,44,125,120,136.114,687.18,36.7,1.7,6,12
6.03,3.8,17.0,15.612,0.0,13,0,0,3,13,26.058,10,26,26,29.408,179.24,38.5,7.7,3,3
5.432,7.5,48.5,42.282,3.0,31,2,0,17,36,67.509,26,71,67,75.821,532.52,38.8,4.5,10,14
6.738,3.4,65.0,67.276,0.0,66,0,0,14,52,116.108,44,123,118,133.702,715.14,37.3,3.4,8,14
7.335,2.4,26.0,24.434,0.0,21,0,0,7,20,40.92,16,43,41,46.279,275.38,39.0,7.3,4,7
5.0,7.1,24.0,18.864,0.0,12,0,0,12,16,27.698,13,30,28,30.993,228.34,46.4,0.0,3,12
8.619,3.2,46.0,38.848,0.0,30,0,0,19,32,61.229,28,66,62,69.228,426.6,45.2,3.2,4,19
6.8,7.1,41.0,41.054,0.0,37,0,0,11,33,69.781,23,72,70,79.603,495.79,32.9,4.3,10,6
4.054,6.7,27.5,26.664,0.0,23,0,0,7,22,45.2,15,46,45,51.195,325.48,33.3,6.7,7,6
8.658,1.8,31.0,31.638,0.0,31,0,0,12,24,53.683,22,56,55,61.936,325.54,40.0,1.8,2,12
4.599,8.0,10.0,12.897,0.0,15,0,0,1,10,25.102,6,24,25,29.114,147.23,24.0,8.0,4,1
5.558,8.1,24.5,22.466,0.0,19,0,0,11,18,36.451,14,38,37,41.737,261.43,37.8,0.0,4,9
4.322,6.3,30.0,28.831,2.1,24,1,0,8,24,48.331,17,49,48,54.634,353.89,35.4,6.3,7,8
7.921,1.9,27.0,29.638,0.0,31,0,0,6,22,51.683,20,55,53,59.936,301.52,37.7,1.9,2,6
6.12,4.3,31.0,27.838,0.0,24,0,0,13,22,44.923,20,48,46,51.564,292.46,43.5,0.0,2,13
5.5,8.0,13.0,13.918,0.0,14,0,0,2,11,24.833,8,25,25,28.697,154.24,32.0,4.0,3,3
5.89,2.0,31.0,29.585,0.0,27,0,0,12,23,48.916,21,52,50,56.105,309.49,42.0,2.0,2,12
4.19,6.3,29.0,28.003,0.0,25,0,0,8,23,48.007,17,49,48,54.69,319.45,35.4,6.3,6,8
4.619,5.9,30.0,29.53,0.0,27,0,0,8,24,50.891,18,52,51,58.106,333.48,35.3,5.9,6,8
4.523,6.3,46.5,33.152,2.1,18,1,0,24,30,49.084,21,51,48,53.518,443.94,43.8,8.3,9,18
4.638,12.0,19.5,16.546,0.0,11,0,0,6,14,24.993,9,27,25,27.996,225.37,36.0,0.0,5,4
5.0,7.4,53.5,43.1,0.0,31,0,0,24,37,67.978,29,72,68,76.517,497.65,42.6,4.4,8,21
4.0,13.6,20.0,14.832,0.0,9,0,0,10,13,22.033,9,24,22,24.661,191.28,40.9,0.0,4,6
5.678,11.1,18.5,17.072,0.0,13,0,0,6,14,26.876,9,28,27,30.411,227.39,33.3,0.0,5,4
4.523,5.9,30.0,29.53,0.0,27,0,0,8,24,50.891,18,52,51,58.106,333.48,35.3,5.9,6,8
8.149,2.0,32.0,30.412,2.0,26,1,0,12,24,49.24,21,52,50,56.049,343.93,42.0,2.0,3,12
7.653,2.4,30.0,26.004,0.0,21,0,0,13,21,41.265,19,44,42,46.86,279.41,45.2,2.4,2,14
6.8,13.7,40.0,32.079,0.0,23,0,0,15,28,51.109,20,54,51,58.019,377.5,39.2,2.0,8,15
9.155,2.1,30.0,27.939,0.0,24,0,0,7,23,47.072,18,50,47,53.111,318.43,38.3,8.5,5,7
10.222,2.1,35.0,29.961,0.0,23,0,0,13,25,47.803,21,51,48,53.694,337.45,43.8,6.3,4,13
5.6,12.2,43.0,32.335,0.0,20,0,0,19,29,49.931,18,52,49,55.364,432.58,36.7,6.1,11,12
5.0,4.5,42.0,39.352,0.0,35,0,0,12,32,66.752,25,70,67,75.976,441.63,37.3,6.0,7,10
5.0,4.7,41.0,37.825,0.0,33,0,0,12,31,63.869,24,67,64,72.561,427.6,37.5,6.3,7,10
5.738,2.3,29.0,26.2,2.3,22,1,1,6,21,42.334,19,48,43,48.405,283.42,44.2,0.0,2,6
5.22,4.0,33.0,30.079,0.0,26,0,0,13,24,49.134,21,52,50,56.188,322.49,42.0,2.0,3,13
6.14,4.3,32.0,28.665,2.2,23,1,0,13,23,45.247,20,48,46,51.508,326.9,43.5,0.0,3,13
5.0,9.5,27.5,17.05,9.5,4,2,2,13,17,22.073,12,22,21,23.426,246.25,57.1,0.0,5,9
4.38,6.4,34.0,29.047,0.0,23,0,0,14,24,46.469,20,49,47,52.856,321.46,42.6,2.1,4,14
5.68,3.8,33.0,30.891,0.0,28,0,0,13,24,50.69,22,54,52,58.394,320.52,42.3,0.0,2,13
6.04,4.3,32.0,28.665,2.2,23,1,0,13,23,45.247,20,48,46,51.508,326.9,43.5,0.0,3,13
5.49,4.1,32.0,29.364,0.0,26,0,0,13,23,47.807,21,51,49,54.979,306.49,42.9,0.0,2,13
5.44,4.7,30.0,26.311,0.0,22,0,0,13,21,42.04,19,45,43,48.149,278.43,44.2,0.0,2,13
4.95,4.3,34.0,28.74,0.0,22,0,0,14,24,45.694,20,48,46,51.567,322.44,43.5,4.3,4,14
4.99,4.7,30.0,26.311,0.0,22,0,0,13,21,42.04,19,45,43,48.149,278.43,44.2,0.0,2,13
6.52,3.8,33.0,30.891,0.0,28,0,0,13,24,50.69,22,54,52,58.394,320.52,42.3,0.0,2,13
6.51,2.1,31.0,28.343,0.0,25,0,0,13,22,45.705,21,49,47,52.481,291.47,44.7,0.0,1,14
5.6,8.1,42.0,37.385,0.0,31,0,0,14,31,61.65,24,65,62,70.308,421.6,38.7,3.2,7,13
7.18,3.8,40.0,33.364,0.0,26,0,0,19,27,51.807,25,56,53,58.979,354.53,47.2,0.0,2,19
5.95,4.1,32.0,29.364,0.0,26,0,0,13,23,47.807,21,51,49,54.979,306.49,42.9,0.0,2,13
5.7,4.1,33.0,29.748,2.0,25,1,1,13,24,48.32,21,51,49,55.319,324.48,42.9,0.0,3,13
4.76,4.3,34.0,28.74,0.0,22,0,0,14,24,45.694,20,48,46,51.567,322.44,43.5,4.3,4,14
6.523,8.6,26.0,21.752,0.0,17,0,0,12,18,34.491,15,37,35,39.401,239.35,42.9,0.0,3,10
5.959,4.0,63.0,58.873,0.0,52,0,0,21,47,97.596,40,103,99,111.586,636.96,40.4,3.0,7,21
5.0,6.3,18.0,18.257,0.0,18,0,0,6,14,31.272,12,33,32,36.318,190.32,37.5,0.0,2,5
5.8,5.9,37.0,31.672,2.0,24,1,1,13,27,51.192,21,54,51,57.821,369.48,41.2,3.9,6,13
5.184,2.6,23.0,22.289,0.0,21,0,0,6,17,36.938,16,41,38,42.65,227.38,42.1,0.0,1,6
5.261,2.6,24.0,22.673,2.6,20,1,1,6,18,37.451,16,41,38,42.99,245.37,42.1,0.0,2,6
5.0,14.8,28.0,19.406,3.7,9,1,0,16,18,27.614,12,29,27,30.29,305.15,44.4,3.7,6,12
5.0,13.3,28.0,19.908,0.0,12,0,0,16,18,30.269,13,32,30,33.863,240.29,43.3,3.3,5,12
5.153,14.8,28.0,19.208,3.7,9,1,0,16,18,27.709,12,29,27,30.392,260.7,44.4,3.7,6,12
5.0,10.6,34.0,29.292,2.1,22,1,0,10,25,47.516,16,49,47,53.511,383.95,34.0,4.3,9,8
5.575,5.9,37.0,32.588,2.0,24,1,0,13,27,50.752,21,54,51,57.136,402.0,41.2,2.0,6,13
6.971,1.8,36.0,33.804,0.0,30,0,0,13,27,56.396,23,59,57,64.147,368.54,40.4,5.3,4,13
9.772,3.1,46.0,40.089,0.0,32,0,0,19,33,64.44,28,68,65,72.853,444.62,43.1,4.6,5,19
4.523,5.2,34.0,33.584,0.0,31,0,0,8,27,57.658,21,60,58,65.936,373.55,36.2,5.2,6,8
4.523,9.4,44.5,34.18,0.0,23,0,0,20,30,53.52,21,56,53,59.777,425.56,39.6,5.7,9,15
5.0,8.2,41.0,36.768,1.6,30,1,1,13,31,61.163,23,64,61,69.648,427.58,37.7,3.3,8,13
4.584,0.0,18.0,20.51,0.0,22,0,0,6,15,36.047,14,37,37,41.777,206.36,37.8,2.7,1,6
5.0,6.1,42.0,39.132,0.0,34,0,0,13,32,65.643,25,69,66,74.849,438.63,37.9,4.5,7,13
5.0,8.2,41.0,36.768,1.6,30,1,1,13,31,61.163,23,64,61,69.648,427.58,37.7,3.3,8,13
5.0,7.7,42.0,38.627,0.0,33,0,0,13,32,64.861,24,68,65,73.933,439.62,36.9,4.6,8,13
5.0,7.8,44.0,39.062,4.7,30,3,3,13,34,65.072,24,67,64,73.742,477.59,37.5,3.1,10,13
5.0,7.0,50.0,43.439,0.0,35,0,0,19,36,70.418,29,75,71,80.138,485.69,40.8,2.8,7,19
5.0,7.7,42.0,39.099,0.0,33,0,0,13,32,64.61,24,68,65,73.643,455.69,36.9,3.1,8,13
6.0,5.5,41.0,35.026,3.6,25,2,1,15,30,55.4,23,57,55,62.18,429.96,41.8,3.6,7,16
5.553,5.8,32.0,30.53,0.0,27,0,0,8,25,51.891,19,54,52,59.106,345.49,36.5,5.8,6,8
5.377,5.8,33.0,31.358,1.9,26,1,0,8,26,52.214,19,54,52,59.05,379.93,36.5,5.8,7,8
6.0,3.7,31.0,31.231,1.9,29,1,1,7,25,53.741,20,56,54,61.568,348.51,37.0,3.7,5,7
5.432,4.8,37.0,36.111,0.0,33,0,0,8,29,61.541,23,65,62,70.351,399.59,37.1,4.8,6,8
5.0,5.1,36.0,34.584,0.0,31,0,0,8,28,58.658,22,62,59,66.936,385.56,37.3,5.1,6,8
5.31,5.8,32.0,30.53,0.0,27,0,0,8,25,51.891,19,54,52,59.106,345.49,36.5,5.8,6,8
5.574,2.7,16.0,19.816,0.0,23,0,0,0,14,35.821,13,39,37,42.066,193.37,35.1,0.0,1,0
6.096,2.9,22.0,20.763,0.0,19,0,0,0,16,34.054,15,41,35,39.235,213.35,42.9,0.0,1,0
5.57,3.0,13.0,17.289,0.0,21,0,0,0,12,31.938,11,34,33,37.65,167.33,33.3,0.0,1,0
6.474,4.0,42.0,32.17,0.0,22,0,0,19,28,50.349,22,53,50,55.986,378.46,44.0,8.0,6,15
4.58,2.9,13.0,17.982,0.0,22,0,0,0,13,34.534,10,35,35,40.277,188.33,28.6,5.7,3,0
4.0,2.9,13.0,17.982,0.0,22,0,0,0,13,34.534,10,35,35,40.277,188.33,28.6,5.7,3,0
4.99,2.6,21.0,21.982,0.0,22,0,0,6,17,38.534,14,40,39,44.277,236.37,35.9,5.1,3,6
4.48,2.6,21.0,21.982,0.0,22,0,0,6,17,38.534,14,40,39,44.277,236.37,35.9,5.1,3,6
8.36,2.0,31.0,29.036,0.0,26,0,0,12,23,48.301,20,51,49,55.107,312.47,40.8,4.1,3,12
8.77,2.0,31.0,29.036,0.0,26,0,0,12,23,48.301,20,51,49,55.107,312.47,40.8,4.1,3,12
6.97,2.0,31.0,29.036,0.0,26,0,0,12,23,48.301,20,51,49,55.107,312.47,40.8,4.1,3,12
5.12,1.9,32.0,30.563,0.0,28,0,0,12,24,51.185,21,54,52,58.522,326.5,40.4,3.8,3,12
4.5,1.9,32.0,30.563,0.0,28,0,0,12,24,51.185,21,54,52,58.522,326.5,40.4,3.8,3,12
8.27,2.2,30.0,27.246,0.0,23,0,0,12,22,44.476,19,47,45,50.484,297.43,42.2,4.4,3,12
8.74,2.2,30.0,27.246,0.0,23,0,0,12,22,44.476,19,47,45,50.484,297.43,42.2,4.4,3,12
7.09,2.2,30.0,27.246,0.0,23,0,0,12,22,44.476,19,47,45,50.484,297.43,42.2,4.4,3,12
7.2,8.5,27.0,26.88,0.0,26,0,0,6,21,46.127,17,50,47,53.56,286.47,36.2,0.0,4,4
4.523,10.5,34.0,25.976,2.6,15,1,0,17,23,38.436,16,40,38,42.558,346.87,42.1,2.6,7,13
5.0,9.3,46.5,35.18,0.0,23,0,0,20,31,54.52,22,58,54,60.777,437.57,40.7,5.6,9,15
5.0,8.6,49.5,37.706,0.0,25,0,0,20,33,58.403,24,63,58,65.192,463.61,41.4,5.2,9,15
4.75,4.5,35.0,28.214,0.0,20,0,0,15,24,43.811,20,46,44,49.152,320.42,45.5,4.5,4,16
4.0,2.9,16.0,18.643,0.0,20,0,0,1,14,33.727,10,35,34,38.782,218.38,29.4,5.9,4,0
4.0,2.9,16.0,18.643,0.0,20,0,0,1,14,33.727,10,35,34,38.782,218.38,29.4,5.9,4,0
4.0,3.3,15.0,16.853,0.0,17,0,0,1,13,29.902,9,31,30,34.159,203.34,30.0,6.7,4,0
4.0,2.9,16.0,18.643,0.0,20,0,0,1,14,33.727,10,35,34,38.782,218.38,29.4,5.9,4,0
4.0,2.9,16.0,18.643,0.0,20,0,0,1,14,33.727,10,35,34,38.782,218.38,29.4,5.9,4,0
4.0,2.9,16.0,18.643,0.0,20,0,0,1,14,33.727,10,35,34,38.782,218.38,29.4,5.9,4,0
4.0,3.3,15.0,16.853,0.0,17,0,0,1,13,29.902,9,31,30,34.159,203.34,30.0,6.7,4,0
4.47,2.9,16.0,18.643,0.0,20,0,0,1,14,33.727,10,35,34,38.782,218.38,29.4,5.9,4,0
7.545,1.9,26.0,29.616,0.0,32,0,0,7,22,52.952,19,54,54,61.353,306.52,35.2,3.7,3,7
6.511,4.8,43.0,38.056,0.0,31,0,0,14,31,61.407,25,65,62,69.647,437.66,40.3,3.2,6,12
7.014,1.9,34.0,31.299,0.0,27,0,0,13,25,51.243,22,54,52,58.315,337.5,42.3,3.8,3,13
7.432,4.2,62.0,57.346,0.0,50,0,0,21,46,94.712,39,100,96,108.171,622.93,40.6,3.1,7,21
6.678,3.1,60.0,57.664,0.0,53,0,0,20,45,96.05,40,102,98,110.294,607.96,40.8,2.0,5,20
6.824,3.7,69.0,63.927,0.0,56,0,0,21,51,105.363,44,113,107,120.417,689.04,41.1,2.8,7,21
7.237,3.9,66.0,61.4,0.0,54,0,0,21,49,101.479,42,108,103,116.001,663.0,40.8,2.9,7,21
7.523,4.0,63.0,58.873,0.0,52,0,0,21,47,97.596,40,103,99,111.586,636.96,40.4,3.0,7,21
5.699,4.0,65.0,59.873,0.0,52,0,0,21,48,98.596,41,105,100,112.586,648.97,41.0,3.0,7,21
5.292,4.3,63.0,56.008,0.0,46,0,0,21,46,91.272,38,97,92,103.55,622.88,41.3,4.3,8,21
5.268,3.8,60.0,50.556,3.8,36,3,3,21,44,81.058,34,84,80,90.825,607.73,42.5,5.0,10,21
5.495,3.9,71.0,62.738,2.9,49,3,3,21,53,102.461,42,108,102,115.815,730.95,41.2,3.9,11,21
5.91,4.1,40.0,31.74,0.0,22,0,0,15,27,48.694,23,53,49,54.567,358.47,46.9,4.1,4,16
4.27,6.3,36.0,30.047,0.0,23,0,0,15,25,47.469,21,50,48,53.856,333.47,43.8,2.1,4,16
5.553,4.2,67.0,58.684,3.2,45,3,3,21,50,95.694,39,100,95,107.984,690.88,41.1,4.2,11,21
5.77,4.3,66.0,57.157,3.3,43,3,3,21,49,92.81,38,97,92,104.569,676.85,41.3,4.3,11,21
5.796,4.3,66.0,57.157,3.3,43,3,3,21,49,92.81,38,97,92,104.569,676.85,41.3,4.3,11,21
5.292,4.5,62.0,54.481,0.0,44,0,0,21,45,88.388,37,94,89,100.135,608.85,41.6,4.5,8,21
5.0,6.4,29.0,27.574,0.0,25,0,0,7,22,46.352,18,50,47,53.272,299.46,38.3,2.1,4,7
5.0,6.7,29.0,26.762,0.0,23,0,0,7,22,44.796,17,48,45,51.066,301.43,37.8,4.4,5,7
5.9,6.3,30.0,28.289,0.0,25,0,0,7,23,47.68,18,51,48,54.481,315.46,37.5,4.2,5,7
6.027,3.8,72.0,64.265,2.9,51,3,3,21,54,105.345,43,111,105,119.23,744.98,41.0,3.8,11,21
4.57,4.9,31.0,25.784,0.0,20,0,0,14,21,40.156,19,43,41,45.733,276.41,46.3,0.0,2,15
4.72,4.9,31.0,25.784,0.0,20,0,0,14,21,40.156,19,43,41,45.733,276.41,46.3,0.0,2,15
5.456,4.5,65.0,55.631,3.4,41,3,3,21,48,89.927,37,94,89,101.154,662.82,41.6,4.5,11,21
5.509,3.9,71.0,62.738,2.9,49,3,3,21,53,102.461,42,108,102,115.815,730.95,41.2,3.9,11,21
5.8,7.1,23.5,24.234,0.0,23,0,0,6,19,41.545,14,43,42,47.776,281.47,33.3,2.4,5,4
5.569,4.5,65.0,56.963,3.4,41,3,0,21,48,89.36,37,94,89,99.967,712.17,41.6,4.5,11,21
7.086,4.3,33.0,28.936,2.1,23,1,1,13,24,46.763,20,49,47,53.113,326.45,42.6,2.1,4,13
6.4,8.2,40.0,37.092,0.0,29,0,0,11,32,62.229,19,63,61,69.57,487.67,31.1,9.8,13,6
6.4,8.2,40.0,37.092,0.0,29,0,0,11,32,62.229,19,63,61,69.57,487.67,31.1,9.8,13,6
5.4,5.8,29.5,30.147,0.0,27,0,0,6,25,52.622,16,53,52,59.444,373.53,30.8,9.6,9,4
6.01,4.1,40.0,31.74,0.0,22,0,0,15,27,48.694,23,53,49,54.567,358.47,46.9,4.1,4,16
6.868,2.3,30.0,26.816,0.0,23,0,0,12,21,42.821,20,47,44,49.066,277.44,45.5,0.0,1,12
6.2,9.3,37.0,33.323,0.0,25,0,0,11,29,55.134,17,56,54,61.531,443.61,31.5,9.3,12,6
6.6,8.9,41.0,35.323,0.0,25,0,0,16,31,57.134,19,58,56,63.531,467.63,33.9,8.9,12,9
4.26,6.7,35.0,28.52,0.0,21,0,0,15,24,44.585,20,47,45,50.441,319.44,44.4,2.2,4,16
9.97,1.8,30.0,32.089,0.0,32,0,0,6,24,54.701,21,59,56,63.063,346.61,37.5,1.8,3,6
8.92,1.9,29.0,30.299,0.0,29,0,0,6,23,50.876,20,55,52,58.441,331.57,38.5,1.9,3,6
8.49,1.8,30.0,32.089,0.0,32,0,0,6,24,54.701,21,59,56,63.063,346.61,37.5,1.8,3,6
5.0,2.2,32.0,28.246,0.0,23,0,0,6,23,45.476,20,52,46,51.484,309.44,43.5,4.3,3,6
5.77,2.2,32.0,28.246,0.0,23,0,0,6,23,45.476,20,52,46,51.484,309.44,43.5,4.3,3,6
5.0,4.9,30.0,25.499,0.0,20,0,0,6,21,40.483,18,47,41,45.943,280.4,43.9,2.4,3,5
5.0,4.9,30.0,25.499,0.0,20,0,0,6,21,40.483,18,47,41,45.943,280.4,43.9,2.4,3,5
6.031,2.3,31.0,26.719,0.0,21,0,0,6,22,42.592,19,49,43,48.069,295.41,44.2,4.7,3,6
5.236,2.3,31.0,26.719,0.0,21,0,0,6,22,42.592,19,49,43,48.069,295.41,44.2,4.7,3,6
5.381,2.1,33.0,28.961,0.0,23,0,0,6,24,46.803,20,53,47,52.694,325.44,42.6,6.4,4,6
5.808,2.4,33.0,26.907,0.0,19,0,0,6,23,42.036,19,49,42,46.863,309.39,45.2,7.1,4,6
6.034,2.2,32.0,28.246,0.0,23,0,0,6,23,45.476,20,52,46,51.484,309.44,43.5,4.3,3,6
6.1,4.3,31.0,27.838,0.0,24,0,0,13,22,44.923,20,48,46,51.564,292.46,43.5,0.0,2,13
6.873,1.4,37.0,40.25,0.0,42,0,0,12,30,70.37,27,73,72,81.429,412.7,37.5,2.8,3,12
9.11,1.8,30.0,32.089,0.0,32,0,0,6,24,54.701,21,59,56,63.063,346.61,37.5,1.8,3,6
4.35,3.1,12.0,16.456,0.0,20,0,0,0,12,31.651,9,32,32,36.862,174.3,28.1,6.3,3,0
4.52,3.1,12.0,16.456,0.0,20,0,0,0,12,31.651,9,32,32,36.862,174.3,28.1,6.3,3,0
5.105,3.1,12.0,16.456,0.0,20,0,0,0,12,31.651,9,32,32,36.862,174.3,28.1,6.3,3,0
5.0,8.3,28.5,18.577,8.3,6,2,2,13,18,24.956,13,25,24,26.842,260.28,54.2,0.0,5,9
5.476,1.8,39.0,34.112,1.8,26,1,1,14,29,55.411,23,57,55,62.073,399.5,41.8,7.3,6,15
4.0,2.0,35.0,30.773,0.0,25,0,0,14,25,49.36,22,52,50,55.9,335.48,44.0,4.0,3,15
4.0,1.9,37.0,33.014,0.0,27,0,0,14,27,53.571,23,56,54,60.524,365.51,42.6,5.6,4,15
4.0,1.8,39.0,34.014,0.0,27,0,0,14,28,54.571,24,58,55,61.524,377.52,43.6,5.5,4,15
4.0,1.9,39.0,33.202,0.0,25,0,0,14,28,53.014,23,56,53,59.318,379.49,43.4,7.5,5,15
4.0,3.0,45.0,40.616,0.0,34,0,0,15,33,66.323,28,70,67,75.268,446.64,41.8,4.5,5,16
4.0,3.3,45.0,39.217,3.3,28,2,0,15,33,61.203,26,64,61,68.326,487.46,42.6,4.9,7,16
4.0,3.1,46.0,39.991,0.0,32,0,0,16,33,64.843,26,68,65,72.982,468.67,40.0,6.2,7,15
5.582,1.8,38.0,33.729,0.0,27,0,0,14,28,54.898,23,57,55,61.734,381.51,41.8,7.3,5,15
5.943,1.9,38.0,32.487,0.0,25,0,0,14,27,51.687,23,55,52,58.109,363.49,44.2,5.8,4,15
4.0,1.9,38.0,32.487,0.0,25,0,0,14,27,51.687,23,55,52,58.109,363.49,44.2,5.8,4,15
5.65,1.8,38.0,33.729,0.0,27,0,0,14,28,54.898,23,57,55,61.734,381.51,41.8,7.3,5,15
5.298,1.9,41.5,33.773,0.0,25,0,0,19,28,52.36,25,56,53,58.9,371.51,47.2,3.8,3,19
4.0,2.0,36.0,31.487,0.0,25,0,0,14,26,50.687,22,53,51,57.109,351.48,43.1,5.9,4,15
5.513,1.9,37.0,32.202,0.0,25,0,0,14,27,52.014,22,54,52,58.318,367.48,42.3,7.7,5,15
5.629,1.8,40.0,34.398,1.8,26,1,1,14,29,55.083,24,58,55,61.864,395.51,43.6,5.5,5,15
4.0,1.9,39.0,32.871,1.9,24,1,1,14,28,52.2,23,55,52,58.449,381.48,44.2,5.8,5,15
6.131,1.9,39.0,32.871,1.9,24,1,1,14,28,52.2,23,55,52,58.449,381.48,44.2,5.8,5,15
5.572,1.8,40.0,34.729,0.0,27,0,0,14,29,55.898,24,59,56,62.734,393.52,42.9,7.1,5,15
5.618,1.8,40.0,34.729,0.0,27,0,0,14,29,55.898,24,59,56,62.734,393.52,42.9,7.1,5,15
4.0,1.8,39.0,34.112,1.8,26,1,1,14,29,55.411,23,57,55,62.073,399.5,41.8,7.3,6,15
4.0,1.7,40.0,35.971,0.0,29,0,0,14,30,59.109,24,61,59,66.358,411.54,40.7,8.5,6,15
4.0,1.7,40.0,35.971,0.0,29,0,0,14,30,59.109,24,61,59,66.358,411.54,40.7,8.5,6,15
7.523,2.0,36.0,31.487,0.0,25,0,0,14,26,50.687,22,53,51,57.109,351.48,43.1,5.9,4,15
4.0,1.8,38.0,34.541,0.0,29,0,0,14,28,56.454,24,59,57,63.939,379.54,42.1,5.3,4,15
4.0,1.7,39.0,36.068,0.0,31,0,0,14,29,59.338,25,62,60,67.355,393.57,41.7,5.0,4,15
7.222,1.9,38.0,32.487,0.0,25,0,0,14,27,51.687,23,55,52,58.109,363.49,44.2,5.8,4,15
4.0,1.7,40.0,35.541,0.0,29,0,0,14,29,57.454,25,61,58,64.939,391.55,43.1,5.2,4,15
4.0,1.6,41.0,37.068,0.0,31,0,0,14,30,60.338,26,64,61,68.355,405.58,42.6,4.9,4,15
5.936,1.8,38.0,34.541,0.0,29,0,0,14,28,56.454,24,59,57,63.939,379.54,42.1,5.3,4,15
4.0,2.0,37.0,30.961,0.0,23,0,0,14,26,48.803,22,52,49,54.694,349.46,44.9,6.1,4,15
6.201,1.8,39.0,34.014,0.0,27,0,0,14,28,54.571,24,58,55,61.524,377.52,43.6,5.5,4,15
6.721,2.0,36.0,31.96,0.0,25,0,0,14,26,50.436,22,53,51,56.82,367.55,43.1,3.9,4,15
6.959,1.9,40.0,33.389,0.0,25,0,0,16,28,53.091,22,55,53,59.238,399.55,41.5,7.5,6,15
6.553,2.0,35.0,30.773,0.0,25,0,0,14,25,49.36,22,52,50,55.9,335.48,44.0,4.0,3,15
7.097,2.1,35.0,29.629,2.1,22,1,1,14,25,46.989,21,49,47,52.824,339.44,44.7,4.3,4,15
6.131,1.9,37.0,33.014,0.0,27,0,0,14,27,53.571,23,56,54,60.524,365.51,42.6,5.6,4,15
6.387,2.0,36.0,31.6,2.0,24,1,0,14,26,49.683,22,52,50,55.844,369.92,44.0,4.0,4,15
6.432,2.0,36.0,31.798,2.0,24,1,0,14,26,49.589,22,52,50,55.741,414.37,44.0,4.0,4,15
6.357,3.8,40.0,32.697,0.0,24,0,0,16,28,52.232,22,54,52,58.401,380.48,42.3,7.7,6,15
4.0,1.8,41.0,34.916,0.0,27,0,0,16,29,55.974,23,58,56,62.654,413.58,41.1,7.1,6,15
6.638,1.8,39.0,34.014,0.0,27,0,0,14,28,54.571,24,58,55,61.524,377.52,43.6,5.5,4,15
6.553,1.9,39.0,33.202,0.0,25,0,0,14,28,53.014,23,56,53,59.318,379.49,43.4,7.5,5,15
6.921,2.0,38.0,31.675,0.0,23,0,0,14,27,50.131,22,53,50,55.903,365.46,44.0,8.0,5,15
5.609,1.9,38.0,33.398,1.9,26,1,1,14,28,54.083,23,56,54,60.864,383.5,42.6,5.6,5,15
4.0,1.6,41.0,37.497,0.0,31,0,0,14,31,61.992,25,64,62,69.773,425.57,40.3,8.1,6,15
4.0,1.7,38.0,35.353,0.0,31,0,0,14,28,58.01,25,61,59,66.145,377.57,42.4,3.4,3,15
6.119,4.1,35.0,30.267,0.0,24,0,0,14,25,48.578,21,51,49,54.983,336.47,42.9,4.1,4,14
6.854,4.1,35.0,30.267,0.0,24,0,0,14,25,48.578,21,51,49,54.983,336.47,42.9,4.1,4,14
6.721,2.1,33.5,29.433,0.0,23,0,0,13,24,46.552,20,49,47,52.404,341.51,42.6,4.3,4,13
4.0,1.5,48.0,40.783,0.0,31,0,0,20,34,64.665,29,68,65,72.564,457.61,44.6,6.2,5,21
5.903,1.9,37.0,33.014,0.0,27,0,0,14,27,53.571,23,56,54,60.524,365.51,42.6,5.6,4,15
6.824,1.9,37.0,33.014,0.0,27,0,0,14,27,53.571,23,56,54,60.524,365.51,42.6,5.6,4,15
5.442,2.0,36.0,31.487,0.0,25,0,0,14,26,50.687,22,53,51,57.109,351.48,43.1,5.9,4,15
6.328,1.8,38.0,34.541,0.0,29,0,0,14,28,56.454,24,59,57,63.939,379.54,42.1,5.3,4,15
4.0,1.8,38.0,34.541,0.0,29,0,0,14,28,56.454,24,59,57,63.939,379.54,42.1,5.3,4,15
6.538,1.9,36.0,32.299,0.0,27,0,0,14,26,52.243,23,55,53,59.315,349.51,43.4,3.8,3,15
6.721,2.0,36.0,31.156,2.0,24,1,1,14,26,49.872,22,52,50,56.239,353.47,44.0,4.0,4,15
4.523,9.1,27.0,21.954,3.0,14,1,0,11,19,33.334,13,35,33,37.06,295.82,39.4,3.0,6,8
5.124,5.6,22.5,20.95,0.0,19,0,0,6,17,35.869,13,37,36,40.945,235.34,36.1,5.6,4,3
5.0,5.7,27.5,22.16,0.0,16,0,0,12,19,35.043,15,36,35,39.322,256.33,42.9,5.7,4,9
5.0,7.1,18.5,16.633,0.0,14,0,0,6,14,28.16,10,28,28,31.907,194.26,35.7,7.1,4,3
5.736,4.7,31.5,26.477,0.0,21,0,0,12,22,42.752,18,45,43,48.36,297.41,41.9,4.7,4,9
5.0,5.3,21.0,21.477,0.0,21,0,0,2,17,37.752,13,39,38,43.36,237.36,34.2,5.3,4,1
5.386,5.3,21.0,21.477,0.0,21,0,0,2,17,37.752,13,39,38,43.36,237.36,34.2,5.3,4,1
5.0,5.7,27.0,22.16,0.0,16,0,0,8,19,35.043,15,37,35,39.322,256.33,42.9,5.7,4,7
5.638,6.1,17.0,18.235,0.0,19,0,0,2,14,32.542,11,33,33,37.735,195.32,33.3,3.0,3,1
5.0,4.8,29.0,25.477,0.0,21,0,0,8,21,41.752,17,44,42,47.36,285.4,40.5,4.8,4,7
5.0,5.3,28.0,23.687,0.0,18,0,0,8,20,37.927,16,40,38,42.737,270.36,42.1,5.3,4,7
5.2,6.3,19.5,18.423,0.0,17,0,0,6,15,31.985,11,32,32,36.529,209.3,34.4,6.3,4,3
5.0,5.4,22.0,21.499,0.0,20,0,0,2,17,36.483,14,39,37,41.943,232.36,37.8,2.7,3,1
5.0,5.3,23.0,22.214,0.0,20,0,0,2,18,37.811,14,40,38,43.152,248.36,36.8,5.3,4,1
5.289,5.9,20.0,19.687,0.0,18,0,0,2,16,33.927,12,35,34,38.737,222.32,35.3,5.9,4,1
5.0,7.3,28.5,24.686,0.0,20,0,0,7,21,41.298,15,43,41,46.652,290.38,36.6,7.3,6,4
6.77,3.6,55.0,61.846,0.0,66,0,0,12,46,109.453,40,115,112,127.283,635.1,35.7,1.8,6,12
6.2,9.5,57.5,46.712,0.0,35,0,0,27,39,73.159,31,79,74,83.221,537.8,41.9,0.0,8,20
5.0,2.4,36.5,27.923,2.4,16,1,0,18,25,41.804,19,43,41,45.602,357.81,46.3,9.8,6,17
6.15,1.9,32.0,31.375,0.0,30,0,0,12,24,52.741,22,56,54,60.728,324.53,40.7,1.9,2,12
3.64,2.4,55.0,50.535,0.0,44,0,0,24,40,82.414,36,87,84,94.135,536.82,42.9,2.4,4,24
6.08,2.3,56.0,52.062,0.0,46,0,0,24,41,85.297,37,90,87,97.55,550.85,42.5,2.3,4,24
5.54,2.9,39.0,39.24,0.0,38,0,0,12,30,66.436,27,71,68,76.68,406.67,39.7,1.5,3,12
7.081,3.7,41.0,45.181,0.0,49,0,0,13,33,79.628,30,83,82,93.045,451.82,36.6,0.0,3,13
5.16,3.2,42.0,37.923,0.0,33,0,0,18,30,61.727,27,66,63,70.642,401.62,42.9,1.6,3,18
4.74,2.2,57.0,54.116,0.0,50,0,0,24,42,90.065,38,95,92,103.38,566.9,41.3,2.2,4,24
6.642,4.3,37.0,39.073,0.0,41,0,0,13,29,68.094,26,71,70,79.384,395.7,37.1,0.0,3,13
4.59,2.6,41.0,42.82,0.0,44,0,0,12,32,74.087,29,79,76,85.925,436.75,38.2,1.3,3,12
4.87,3.8,32.0,30.606,0.0,28,0,0,12,24,51.018,21,54,52,58.604,324.51,40.4,1.9,3,12
5.85,4.1,31.0,29.079,0.0,26,0,0,12,23,48.134,20,51,49,55.188,310.48,40.8,2.0,3,12
10.288,2.1,36.0,30.786,0.0,22,0,0,11,26,48.342,19,52,48,53.536,392.56,39.6,8.3,7,9
4.61,3.0,14.0,17.928,0.0,20,0,0,0,13,32.4,10,34,33,37.572,202.38,30.3,3.0,3,0
4.63,3.0,14.0,17.928,0.0,20,0,0,0,13,32.4,10,34,33,37.572,202.38,30.3,3.0,3,0
4.97,3.0,14.0,17.928,0.0,20,0,0,0,13,32.4,10,34,33,37.572,202.38,30.3,3.0,3,0
4.28,3.0,14.0,17.456,0.0,20,0,0,0,13,32.651,10,34,33,37.862,186.31,30.3,6.1,3,0
4.99,3.0,14.0,17.928,0.0,20,0,0,0,13,32.4,10,34,33,37.572,202.38,30.3,3.0,3,0
5.43,3.1,12.0,16.456,0.0,20,0,0,0,12,31.651,9,32,32,36.862,174.3,28.1,6.3,3,0
7.107,2.0,35.0,30.773,0.0,25,0,0,14,25,49.36,22,52,50,55.9,335.48,44.0,4.0,3,15
5.527,1.9,29.0,29.826,0.0,29,0,0,7,23,51.127,20,54,52,58.73,315.5,38.5,3.8,3,7
7.485,8.1,115.0,98.425,0.0,77,0,0,42,83,159.562,64,168,160,181.021,1124.54,40.0,3.8,19,39
5.0,9.5,34.0,27.128,2.4,19,1,0,16,23,41.8,18,45,42,47.259,326.86,42.9,0.0,5,13
7.757,4.0,91.0,30.508,1.6,60,2,2,34,65,124.432,52,131,125,140.499,900.05,41.6,3.2,13,35
5.0,6.5,33.0,28.875,2.2,22,1,0,13,24,45.792,19,48,46,51.8,343.89,41.3,2.2,5,13
6.292,6.5,19.0,18.16,0.0,16,0,0,2,15,31.043,11,32,31,35.322,208.29,35.5,6.5,4,1
5.301,4.5,61.0,53.766,0.0,44,0,0,21,44,87.061,37,93,88,98.925,592.85,42.0,3.4,7,21
6.382,3.8,49.0,56.792,0.0,62,0,0,12,42,101.686,36,105,104,118.453,583.02,34.6,1.9,6,12
6.405,1.7,30.0,33.407,0.0,35,0,0,2,25,58.778,22,63,60,67.976,345.58,36.7,3.3,3,3
5.98,4.1,40.0,31.74,0.0,22,0,0,15,27,48.694,23,53,49,54.567,358.47,46.9,4.1,4,16
4.57,4.5,35.0,28.214,0.0,20,0,0,15,24,43.811,20,46,44,49.152,320.42,45.5,4.5,4,16
4.0,10.0,19.5,18.599,0.0,15,0,0,6,15,29.76,10,31,30,33.826,241.42,33.3,0.0,5,4
4.28,6.3,36.0,30.047,0.0,23,0,0,15,25,47.469,21,50,48,53.856,333.47,43.8,2.1,4,16
6.285,8.2,46.0,42.987,0.0,38,0,0,14,35,72.403,27,76,73,83.052,478.71,37.0,2.7,8,13
4.18,6.7,35.0,28.52,0.0,21,0,0,15,24,44.585,20,47,45,50.441,319.44,44.4,2.2,4,16
5.77,3.2,45.0,38.749,0.0,30,0,0,17,32,61.632,26,66,62,69.358,450.65,41.9,4.8,6,15
4.52,4.5,35.0,28.214,0.0,20,0,0,15,24,43.811,20,46,44,49.152,320.42,45.5,4.5,4,16
5.0,9.5,34.0,26.683,2.4,19,1,1,16,23,41.989,18,45,42,47.655,310.41,42.9,0.0,5,13
5.0,8.3,35.0,29.354,0.0,24,0,0,16,24,47.243,20,51,48,54.145,320.48,41.7,0.0,4,13
5.0,8.9,37.0,28.977,6.7,19,3,3,16,26,45.898,19,48,45,51.749,360.42,42.2,0.0,7,13
4.27,6.7,35.0,28.52,0.0,21,0,0,15,24,44.585,20,47,45,50.441,319.44,44.4,2.2,4,16
5.0,8.7,35.0,28.542,0.0,22,0,0,16,24,45.687,19,49,46,51.939,322.45,41.3,2.2,5,13
5.0,8.7,35.0,29.014,0.0,22,0,0,16,24,45.436,19,49,46,51.65,338.52,41.3,0.0,5,13
5.0,7.7,43.0,33.354,0.0,24,0,0,22,28,51.243,24,56,52,58.145,368.52,46.2,0.0,4,19
5.0,7.8,36.0,30.88,0.0,26,0,0,16,25,50.127,21,54,51,57.56,334.51,41.2,0.0,4,13
5.0,9.5,34.0,26.683,2.4,19,1,1,16,23,41.989,18,45,42,47.655,310.41,42.9,0.0,5,13
4.745,4.5,36.0,28.214,0.0,20,0,0,16,24,43.811,20,48,44,49.152,320.42,45.5,4.5,4,14
6.225,6.2,49.0,40.559,1.5,31,1,1,22,34,64.618,28,69,65,73.355,458.63,43.1,1.5,6,19
5.0,8.7,36.0,28.827,0.0,22,0,0,17,24,45.36,20,49,46,51.73,318.46,43.5,0.0,4,15
5.956,3.6,43.0,35.658,3.6,26,2,2,19,30,55.716,26,59,56,63.074,404.54,46.4,0.0,4,20
5.086,3.8,42.0,33.697,0.0,24,0,0,17,29,53.232,23,57,53,59.401,392.49,43.4,7.5,6,15
5.378,4.1,40.0,31.455,0.0,22,0,0,17,27,49.022,22,53,49,54.777,362.46,44.9,6.1,5,15
5.411,3.8,41.0,32.982,0.0,24,0,0,17,28,51.905,23,56,52,58.192,376.49,44.2,5.8,5,15
5.762,3.8,41.0,32.982,0.0,24,0,0,17,28,51.905,23,56,52,58.192,376.49,44.2,5.8,5,15
5.328,8.3,15.5,14.106,0.0,12,0,0,5,12,24.276,8,25,24,27.491,168.22,33.3,8.3,4,3
6.959,6.7,17.5,17.16,0.0,16,0,0,5,14,30.043,10,31,30,34.322,196.28,33.3,6.7,4,3
6.543,1.4,48.0,44.46,0.0,39,0,0,19,35,72.545,32,77,74,82.806,469.72,43.2,2.7,3,19
6.009,3.1,18.0,18.38,0.0,17,0,0,2,15,32.153,11,33,32,36.448,211.29,34.4,9.4,4,3
4.0,4.7,22.0,23.982,0.0,24,0,0,2,19,42.905,14,44,43,49.192,268.4,32.6,7.0,5,3
5.83,3.2,45.0,38.749,0.0,30,0,0,17,32,61.632,26,66,62,69.358,450.65,41.9,4.8,6,15
5.65,3.4,44.0,36.75,0.0,28,0,0,17,31,59.0,25,63,59,66.232,420.55,42.4,6.8,6,15
4.88,3.4,11.0,15.401,0.0,18,0,0,0,11,28.516,8,29,29,33.157,176.34,27.6,3.4,3,0
6.594,2.2,27.0,26.773,0.0,25,0,0,8,21,45.36,18,47,46,51.9,287.44,39.1,4.3,3,9
7.201,2.0,30.0,29.299,0.0,27,0,0,8,23,49.243,20,52,50,56.315,313.48,40.0,4.0,3,9
4.95,3.2,45.0,38.277,0.0,30,0,0,17,32,61.883,26,66,62,69.647,434.58,41.9,6.5,6,15
4.772,2.7,24.0,22.192,0.0,19,0,0,8,18,36.709,15,38,37,41.654,245.35,40.5,5.4,3,9
6.48,2.0,35.0,30.773,0.0,25,0,0,14,25,49.36,22,52,50,55.9,335.48,44.0,4.0,3,15
6.669,1.9,31.0,30.826,0.0,29,0,0,8,24,52.127,21,55,53,59.73,327.51,39.6,3.8,3,9
6.326,1.7,38.0,35.353,0.0,31,0,0,14,28,58.01,25,61,59,66.145,377.57,42.4,3.4,3,15
6.577,2.2,27.0,26.773,0.0,25,0,0,8,21,45.36,18,47,46,51.9,287.44,39.1,4.3,3,9
6.628,1.6,33.0,35.933,0.0,37,0,0,8,27,62.661,24,65,64,72.391,371.62,37.5,3.1,3,9
5.876,2.5,25.0,23.719,0.0,21,0,0,8,19,39.592,16,41,40,45.069,259.38,40.0,5.0,3,9
5.683,5.9,32.5,30.101,0.0,27,0,0,12,24,50.236,20,53,51,57.687,325.5,39.2,2.0,4,10
4.508,2.3,33.0,27.719,0.0,21,0,0,14,23,43.592,20,46,44,49.069,307.42,45.5,4.5,3,15
7.267,2.0,30.0,29.299,0.0,27,0,0,8,23,49.243,20,52,50,56.315,313.48,40.0,4.0,3,9
6.294,1.9,29.0,29.826,0.0,29,0,0,8,23,51.127,20,53,52,58.73,315.5,38.5,3.8,3,9
6.075,1.8,37.0,33.826,0.0,29,0,0,14,27,55.127,24,58,56,62.73,363.54,42.9,3.6,3,15
5.953,1.6,33.0,35.933,0.0,37,0,0,8,27,62.661,24,65,64,72.391,371.62,37.5,3.1,3,9
5.805,1.7,38.0,35.353,0.0,31,0,0,14,28,58.01,25,61,59,66.145,377.57,42.4,3.4,3,15
5.37,1.9,34.0,31.299,0.0,27,0,0,13,25,51.243,22,54,52,58.315,337.5,42.3,3.8,3,13
6.712,1.8,30.0,31.353,0.0,31,0,0,8,24,54.01,21,56,55,62.145,329.53,38.2,3.6,3,9
8.069,1.7,25.0,31.767,0.0,38,0,0,6,22,57.948,21,60,60,68.18,304.6,35.0,0.0,1,5
7.2,8.2,47.0,43.979,0.0,36,0,0,12,37,73.654,24,76,73,83.105,552.8,32.9,6.8,13,8
5.804,2.3,33.0,27.719,0.0,21,0,0,14,23,43.592,20,46,44,49.069,307.42,45.5,4.5,3,15
6.466,2.0,28.0,28.299,0.0,27,0,0,8,22,48.243,19,50,49,55.315,301.47,38.8,4.1,3,9
6.653,1.9,28.0,30.353,0.0,31,0,0,7,23,53.01,20,55,54,61.145,317.52,37.0,3.7,3,7
5.873,6.7,35.0,29.063,2.2,20,1,0,13,25,45.236,19,48,45,50.595,357.87,42.2,4.4,6,13
5.475,3.4,35.0,33.945,0.0,32,0,0,13,26,56.458,24,60,58,65.225,348.58,41.4,0.0,2,13
5.05,4.0,33.0,30.079,0.0,26,0,0,13,24,49.134,21,52,50,56.188,322.49,42.0,2.0,3,13
5.49,4.0,33.0,30.552,0.0,26,0,0,13,24,48.883,21,52,50,55.899,338.56,42.0,0.0,3,13
4.34,6.4,34.0,29.047,0.0,23,0,0,14,24,46.469,20,49,47,52.856,321.46,42.6,2.1,4,14
5.23,4.1,32.0,29.364,0.0,26,0,0,13,23,47.807,21,51,49,54.979,306.49,42.9,0.0,2,13
5.98,4.3,32.0,28.221,2.2,23,1,1,13,23,45.436,20,48,46,51.904,310.45,43.5,0.0,3,13
6.11,4.1,33.0,30.192,2.0,25,1,0,13,24,48.131,21,51,49,54.923,340.93,42.9,0.0,3,13
6.17,4.1,32.0,29.364,0.0,26,0,0,13,23,47.807,21,51,49,54.979,306.49,42.9,0.0,2,13
5.84,4.1,32.0,29.364,0.0,26,0,0,13,23,47.807,21,51,49,54.979,306.49,42.9,0.0,2,13
5.63,3.8,35.0,31.891,0.0,28,0,0,13,25,51.69,23,56,53,59.394,332.53,43.4,0.0,2,13
5.7,4.0,34.0,30.364,0.0,26,0,0,13,24,48.807,22,53,50,55.979,318.5,44.0,0.0,2,13
5.1,4.7,30.0,26.311,0.0,22,0,0,13,21,42.04,19,45,43,48.149,278.43,44.2,0.0,2,13
5.66,3.8,33.0,30.891,0.0,28,0,0,13,24,50.69,22,54,52,58.394,320.52,42.3,0.0,2,13
4.18,6.4,34.0,29.047,0.0,23,0,0,14,24,46.469,20,49,47,52.856,321.46,42.6,2.1,4,14
6.699,3.9,64.0,60.4,0.0,54,0,0,21,48,100.479,41,106,102,115.001,650.99,40.2,2.9,7,21
5.57,3.9,35.0,31.079,0.0,26,0,0,13,25,50.134,22,54,51,57.188,334.5,43.1,2.0,3,13
5.0,8.2,41.0,37.212,1.6,30,1,0,13,31,60.974,23,64,61,69.252,444.03,37.7,3.3,8,13
5.0,8.2,41.0,37.212,1.6,30,1,0,13,31,60.974,23,64,61,69.252,444.03,37.7,3.3,8,13
8.25,2.2,32.0,28.718,0.0,23,0,0,12,23,45.225,20,49,46,51.195,325.51,43.5,2.2,3,12
6.6,10.6,34.0,29.555,0.0,21,0,0,11,26,48.04,15,49,47,53.491,399.55,31.9,8.5,11,6
8.49,2.2,32.0,28.718,0.0,23,0,0,12,23,45.225,20,49,46,51.195,325.51,43.5,2.2,3,12
8.46,2.0,33.0,30.508,0.0,26,0,0,12,24,49.051,21,53,50,55.818,340.55,42.0,2.0,3,12
9.39,2.0,33.0,30.508,0.0,26,0,0,12,24,49.051,21,53,50,55.818,340.55,42.0,2.0,3,12
9.7,1.8,30.0,32.089,0.0,32,0,0,6,24,54.701,21,59,56,63.063,346.61,37.5,1.8,3,6
8.7,1.9,29.0,30.299,0.0,29,0,0,6,23,50.876,20,55,52,58.441,331.57,38.5,1.9,3,6
7.0,8.9,41.0,35.323,0.0,25,0,0,16,31,57.134,19,58,56,63.531,467.63,33.9,8.9,12,9
8.7,1.9,29.0,30.299,0.0,29,0,0,6,23,50.876,20,55,52,58.441,331.57,38.5,1.9,3,6
9.68,2.1,30.0,27.939,0.0,24,0,0,7,23,47.072,18,50,47,53.111,318.43,38.3,8.5,5,7
5.796,4.0,70.0,61.211,3.0,47,3,3,21,52,99.577,41,105,99,112.4,716.92,41.4,4.0,11,21
6.022,4.3,66.0,58.49,3.3,43,3,0,21,49,92.243,38,97,92,103.382,726.2,41.3,4.3,11,21
5.602,4.5,65.0,56.963,3.4,41,3,0,21,48,89.36,37,94,89,99.967,712.17,41.6,4.5,11,21
5.292,4.5,62.0,54.481,0.0,44,0,0,21,45,88.388,37,94,89,100.135,608.85,41.6,4.5,8,21
5.42,5.4,25.0,22.778,2.7,18,1,0,8,19,37.193,14,37,37,41.889,281.79,37.8,5.4,5,7
8.87,1.9,29.0,30.299,0.0,29,0,0,6,23,50.876,20,55,52,58.441,331.57,38.5,1.9,3,6
7.0,7.4,43.0,40.86,0.0,33,0,0,11,35,69.323,21,70,68,77.61,531.73,30.9,10.3,14,6
4.523,3.0,30.0,22.327,0.0,13,0,0,14,20,33.385,16,35,33,36.618,267.3,48.5,9.1,4,14
5.34,3.1,12.0,16.456,0.0,20,0,0,0,12,31.651,9,32,32,36.862,174.3,28.1,6.3,3,0
5.0,5.1,28.0,23.95,0.0,19,0,0,8,20,38.869,16,41,39,43.945,271.37,41.0,5.1,4,7
7.476,4.5,31.0,27.498,0.0,22,0,0,12,22,43.116,19,47,44,49.069,310.5,43.2,0.0,3,12
5.0,5.1,28.0,23.95,0.0,19,0,0,8,20,38.869,16,41,39,43.945,271.37,41.0,5.1,4,7
5.247,4.8,29.0,25.477,0.0,21,0,0,8,21,41.752,17,44,42,47.36,285.4,40.5,4.8,4,7
5.0,6.3,21.5,19.16,0.0,16,0,0,6,16,32.043,12,33,32,36.322,220.3,37.5,6.3,4,3
5.0,5.3,28.0,23.687,0.0,18,0,0,8,20,37.927,16,40,38,42.737,270.36,42.1,5.3,4,7
6.264,5.9,20.0,19.687,0.0,18,0,0,2,16,33.927,12,35,34,38.737,222.32,35.3,5.9,4,1
6.125,1.9,65.0,62.223,0.0,58,0,0,24,48,103.599,44,111,106,119.041,647.04,41.5,1.9,4,24
5.81,2.3,57.0,51.799,0.0,45,0,0,24,41,84.356,37,90,86,96.342,549.84,43.0,2.3,4,24
4.64,3.0,14.0,17.456,0.0,20,0,0,0,13,32.651,10,34,33,37.862,186.31,30.3,6.1,3,0
3.91,3.4,41.0,36.133,0.0,30,0,0,18,29,57.901,26,62,59,66.019,386.58,44.1,1.7,3,18
5.12,2.1,58.0,55.642,0.0,52,0,0,24,43,92.948,39,98,95,106.795,580.93,41.1,2.1,4,24
6.255,2.0,63.0,58.642,0.0,52,0,0,24,46,95.948,42,103,98,109.795,616.96,42.9,2.0,4,24
4.115,3.1,12.0,16.456,0.0,20,0,0,0,12,31.651,9,32,32,36.862,174.3,28.1,6.3,3,0
4.63,2.4,56.0,50.008,0.0,42,0,0,24,40,80.53,36,86,82,91.719,534.8,43.9,2.4,4,24
5.42,5.4,25.0,22.778,2.7,18,1,0,8,19,37.193,14,37,37,41.889,281.79,37.8,5.4,5,7
5.867,2.5,29.0,25.154,7.5,18,3,3,12,22,40.803,17,41,40,45.879,309.36,42.5,2.5,5,12
7.348,4.4,30.0,27.665,2.2,23,1,0,12,22,44.247,19,47,45,50.508,314.89,42.2,0.0,3,12
7.886,9.5,33.0,27.128,2.4,19,1,0,13,23,41.8,18,45,42,47.259,326.86,42.9,0.0,5,13
5.65,3.7,44.0,34.697,0.0,24,0,0,18,30,54.232,24,58,54,60.401,404.5,44.4,7.4,6,17
6.43,4.1,32.0,29.364,0.0,26,0,0,13,23,47.807,21,51,49,54.979,306.49,42.9,0.0,2,13
4.26,6.5,37.0,29.52,0.0,21,0,0,15,25,45.585,21,49,46,51.441,331.45,45.7,2.2,4,16
5.162,5.1,30.5,24.687,0.0,18,0,0,12,21,38.927,17,41,39,43.737,282.37,43.6,5.1,4,9
6.192,3.6,41.0,34.891,0.0,28,0,0,19,28,54.69,26,59,56,62.394,368.56,46.4,0.0,2,20
5.833,5.9,32.5,30.101,0.0,27,0,0,12,24,50.236,20,53,51,57.687,325.5,39.2,2.0,4,10
7.06,4.7,30.0,26.311,0.0,22,0,0,13,21,42.04,19,45,43,48.149,278.43,44.2,0.0,2,13
5.0,8.7,35.0,28.542,0.0,22,0,0,16,24,45.687,19,49,46,51.939,322.45,41.3,2.2,5,13
5.02,3.6,33.0,32.396,0.0,31,0,0,12,25,54.843,22,58,56,63.226,339.55,39.3,1.8,3,12
5.77,4.5,65.0,55.631,3.4,41,3,3,21,48,89.927,37,94,89,101.154,662.82,41.6,4.5,11,21
7.634,2.4,29.0,25.289,0.0,21,0,0,13,20,39.938,19,43,41,45.65,263.41,46.3,0.0,1,14
5.733,2.8,37.0,26.153,16.7,9,6,6,14,27,39.345,17,38,36,42.071,389.27,47.2,8.3,10,14
4.4,3.7,15.5,15.424,0.0,15,0,0,5,12,26.614,10,28,27,30.614,165.26,37.0,3.7,2,4
4.2,4.2,14.5,13.897,0.0,13,0,0,5,11,23.731,9,25,24,27.199,151.23,37.5,4.2,2,4
4.32,4.8,13.5,12.37,0.0,11,0,0,5,10,20.847,8,22,21,23.784,137.2,38.1,4.8,2,4
8.55,1.9,27.0,29.562,0.0,30,0,0,6,22,50.818,19,54,52,58.648,320.57,36.5,1.9,3,6
4.35,4.2,14.5,13.897,0.0,13,0,0,5,11,23.731,9,25,24,27.199,151.23,37.5,4.2,2,4
4.78,4.8,13.5,12.37,0.0,11,0,0,5,10,20.847,8,22,21,23.784,137.2,38.1,4.8,2,4
4.5,4.8,13.5,12.37,0.0,11,0,0,5,10,20.847,8,22,21,23.784,137.2,38.1,4.8,2,4
4.8,4.2,14.5,13.897,0.0,13,0,0,5,11,23.731,9,25,24,27.199,151.23,37.5,4.2,2,4
4.12,4.2,14.5,13.897,0.0,13,0,0,5,11,23.731,9,25,24,27.199,151.23,37.5,4.2,2,4
6.0,4.9,55.5,41.101,1.6,24,1,1,26,37,61.847,29,65,61,68.239,497.56,47.5,6.6,8,25
4.5,3.7,15.5,15.424,0.0,15,0,0,5,12,26.614,10,28,27,30.614,165.26,37.0,3.7,2,4
5.929,2.7,35.0,25.718,8.1,12,3,3,14,25,39.134,17,39,37,42.261,351.3,45.9,10.8,8,14
5.388,3.1,33.0,23.145,12.5,9,4,4,14,23,34.109,16,34,32,36.767,323.26,50.0,6.3,7,14
5.487,3.1,33.0,23.145,12.5,9,4,4,14,23,34.109,16,34,32,36.767,323.26,50.0,6.3,7,14
5.714,3.4,30.0,21.494,6.9,9,2,1,14,20,29.916,15,31,29,32.174,334.15,51.7,6.9,5,14
5.77,2.7,35.0,25.718,8.1,12,3,3,14,25,39.134,17,39,37,42.261,351.3,45.9,10.8,8,14
4.301,8.3,44.0,37.143,0.0,29,0,0,14,31,59.44,25,64,60,67.683,415.59,41.7,1.7,6,13
4.301,6.8,41.0,36.476,1.7,29,1,0,13,30,58.545,24,63,59,66.544,425.02,40.7,1.7,6,13
4.301,8.2,45.0,37.573,0.0,29,0,0,15,32,61.094,24,65,61,69.102,435.58,39.3,4.9,8,13
4.301,6.5,44.0,38.325,4.8,29,3,3,13,33,62.643,25,66,62,71.035,458.58,40.3,1.6,8,13
8.106,3.9,34.0,31.739,0.0,26,0,0,12,25,49.96,21,54,51,56.819,370.63,41.2,0.0,4,12
5.914,2.3,20.0,23.487,0.0,25,0,0,1,18,42.687,14,44,43,49.109,255.4,32.6,7.0,4,1
6.301,2.2,30.0,28.277,2.2,22,1,0,12,23,44.872,18,46,45,50.414,427.31,40.0,6.7,5,12
4.523,6.8,45.0,37.122,1.7,27,1,1,15,32,59.581,23,63,59,66.864,458.61,39.0,5.1,9,13
7.465,8.8,36.0,33.573,0.0,29,0,0,8,28,57.094,20,60,57,65.102,387.54,35.1,5.3,8,8
4.523,6.8,45.0,37.122,1.7,27,1,1,15,32,59.581,23,63,59,66.864,458.61,39.0,5.1,9,13
4.523,7.8,48.0,40.722,4.7,28,3,3,14,36,65.265,25,68,64,73.247,519.65,39.1,3.1,11,14
4.523,6.8,45.0,37.122,1.7,27,1,1,15,32,59.581,23,63,59,66.864,458.61,39.0,5.1,9,13
4.523,7.8,49.0,41.105,6.3,27,4,4,14,37,65.778,25,68,64,73.587,537.64,39.1,3.1,12,14
4.523,6.8,45.0,37.764,1.7,27,1,0,15,32,59.298,23,63,59,66.365,519.51,39.0,5.1,9,13
4.523,7.8,49.0,41.105,6.3,27,4,4,14,37,65.778,25,68,64,73.587,537.64,39.1,3.1,12,14
4.523,7.8,49.0,41.549,6.3,27,4,3,14,37,65.589,25,68,64,73.191,554.09,39.1,3.1,12,14
4.301,6.5,45.0,38.709,6.5,28,4,4,13,34,63.156,25,66,62,71.374,476.57,40.3,1.6,9,13
6.91,2.3,33.0,27.817,2.3,20,1,1,12,24,44.432,19,47,44,49.618,329.4,43.2,6.8,5,12
4.301,6.8,41.0,36.476,1.7,29,1,0,13,30,58.545,24,63,59,66.544,425.02,40.7,1.7,6,13
4.301,6.5,42.0,37.559,1.6,31,1,1,13,31,61.618,25,66,62,70.355,422.6,40.3,1.6,6,13
4.301,6.5,42.0,37.559,1.6,31,1,1,13,31,61.618,25,66,62,70.355,422.6,40.3,1.6,6,13
4.301,8.3,45.0,37.971,1.7,28,1,0,14,32,59.763,25,64,60,67.627,450.03,41.7,1.7,7,13
7.465,7.3,35.0,32.552,0.0,28,0,0,8,27,54.992,20,58,55,62.604,372.52,36.4,5.5,7,8
4.301,6.5,45.0,38.709,6.5,28,4,4,13,34,63.156,25,66,62,71.374,476.57,40.3,1.6,9,13
5.0,3.0,35.0,24.885,15.2,8,5,4,14,25,35.665,16,35,33,37.818,418.15,48.5,9.1,9,14
6.465,2.1,34.0,29.433,0.0,23,0,0,13,24,46.552,20,50,47,52.404,341.51,42.6,4.3,4,12
6.56,1.9,31.0,31.013,0.0,29,0,0,7,24,52.203,20,56,53,59.65,347.57,37.7,3.8,4,6
6.28,1.9,31.0,31.013,0.0,29,0,0,7,24,52.203,20,56,53,59.65,347.57,37.7,3.8,4,6
5.73,2.7,38.0,26.868,16.2,9,6,6,14,28,40.672,17,39,37,43.281,405.27,45.9,10.8,11,14
5.332,3.4,31.0,22.321,10.3,8,3,1,14,21,30.24,15,31,29,32.118,368.59,51.7,6.9,6,14
6.54,1.9,31.0,31.013,0.0,29,0,0,7,24,52.203,20,56,53,59.65,347.57,37.7,3.8,4,6
5.857,4.4,66.5,65.479,0.0,59,0,0,16,54,113.639,39,115,113,128.796,758.03,34.5,8.8,15,14
5.0,4.8,27.0,25.124,2.4,21,1,1,7,21,42.207,16,44,42,47.907,292.39,38.1,4.8,5,7
5.677,3.1,33.0,23.589,12.5,9,4,3,14,23,33.92,16,34,32,36.371,339.71,50.0,6.3,7,14
5.0,14.8,27.0,18.381,0.0,10,0,0,16,17,27.385,12,29,27,30.448,226.26,44.4,3.7,5,12
4.523,3.1,33.0,23.145,12.5,9,4,4,14,23,34.109,16,34,32,36.767,323.26,50.0,6.3,7,14
4.72,4.2,14.5,13.897,0.0,13,0,0,5,11,23.731,9,25,24,27.199,151.23,37.5,4.2,2,4
5.484,2.8,34.0,25.003,8.3,12,3,3,14,24,37.807,17,38,36,41.052,335.3,47.2,8.3,7,14
5.496,3.1,32.0,22.762,9.4,10,3,3,14,22,33.596,16,34,32,36.427,305.27,50.0,6.3,6,14
5.402,3.0,31.0,23.154,3.0,12,1,0,14,21,33.709,16,35,33,36.562,301.74,48.5,9.1,5,14
5.147,3.1,33.0,23.145,12.5,9,4,4,14,23,34.109,16,34,32,36.767,323.26,50.0,6.3,7,14
4.66,3.7,15.5,15.424,0.0,15,0,0,5,12,26.614,10,28,27,30.614,165.26,37.0,3.7,2,4
5.39,3.0,34.0,24.304,12.1,9,4,3,14,24,35.247,16,35,33,37.581,355.71,48.5,9.1,8,14
5.146,3.0,32.0,23.982,6.1,11,2,0,14,22,34.033,16,35,33,36.506,336.18,48.5,9.1,6,14
4.301,8.2,46.0,38.4,1.6,28,1,0,15,33,61.418,24,65,61,69.046,470.02,39.3,4.9,9,13
4.301,6.8,42.0,37.304,3.4,28,2,0,13,31,58.869,24,63,59,66.488,459.46,40.7,1.7,7,13
8.488,2.3,33.0,27.289,0.0,21,0,0,14,22,41.938,21,46,43,47.65,287.43,48.8,0.0,1,16
9.224,2.3,27.0,25.961,0.0,23,0,0,7,21,43.803,17,46,44,49.694,289.41,38.6,6.8,4,7
4.301,6.5,45.0,39.153,6.5,28,4,3,13,34,62.967,25,66,62,70.979,493.02,40.3,1.6,9,13
4.523,6.8,45.0,37.566,1.7,27,1,0,15,32,59.392,23,63,59,66.468,475.06,39.0,5.1,9,13
4.301,6.5,45.0,38.709,6.5,28,4,4,13,34,63.156,25,66,62,71.374,476.57,40.3,1.6,9,13
4.301,6.5,42.0,37.559,1.6,31,1,1,13,31,61.618,25,66,62,70.355,422.6,40.3,1.6,6,13
4.412,6.5,41.0,37.176,0.0,32,0,0,13,30,61.105,25,66,62,70.015,404.61,40.3,1.6,5,13
6.46,2.1,34.0,29.433,0.0,23,0,0,13,24,46.552,20,50,47,52.404,341.51,42.6,4.3,4,12
4.301,6.5,42.0,38.003,1.6,31,1,0,13,31,61.429,25,66,62,69.959,439.05,40.3,1.6,6,13
5.387,3.4,29.0,21.11,3.4,10,1,0,14,19,29.404,15,31,29,31.835,316.16,51.7,6.9,4,14
6.27,1.9,31.0,31.013,0.0,29,0,0,7,24,52.203,20,56,53,59.65,347.57,37.7,3.8,4,6
4.63,3.6,15.5,15.687,0.0,16,0,0,5,12,27.556,10,29,28,31.822,166.27,35.7,3.6,2,4
6.499,2.4,32.5,26.665,0.0,19,0,0,13,22,40.458,19,44,41,45.365,309.46,46.3,2.4,3,13
6.2,4.5,34.5,37.351,0.0,37,0,0,7,29,65.385,22,67,66,75.102,423.69,33.3,4.5,7,5
7.63,1.8,32.0,32.804,0.0,32,0,0,7,25,56.029,21,60,57,64.273,362.61,36.8,3.5,4,6
6.65,1.8,32.0,32.804,0.0,32,0,0,7,25,56.029,21,60,57,64.273,362.61,36.8,3.5,4,6
7.28,2.0,35.0,31.223,0.0,26,0,0,13,25,50.378,21,54,51,57.027,356.55,41.2,3.9,4,12
5.482,2.0,35.0,30.983,4.1,23,2,1,13,26,49.196,21,51,49,55.183,375.9,42.9,4.1,5,13
6.592,1.9,36.0,32.299,0.0,27,0,0,14,26,52.243,23,55,53,59.315,349.51,43.4,3.8,3,15
4.355,2.9,16.0,18.643,0.0,20,0,0,1,14,33.727,10,35,34,38.782,218.38,29.4,5.9,4,0
7.372,2.1,34.0,29.246,0.0,23,0,0,14,24,46.476,21,49,47,52.484,321.45,44.7,4.3,3,15
6.48,1.8,32.0,32.804,0.0,32,0,0,7,25,56.029,21,60,57,64.273,362.61,36.8,3.5,4,6
6.564,2.1,34.0,29.246,0.0,23,0,0,14,24,46.476,21,49,47,52.484,321.45,44.7,4.3,3,15
6.319,1.9,36.0,32.299,0.0,27,0,0,14,26,52.243,23,55,53,59.315,349.51,43.4,3.8,3,15
6.9,4.9,30.5,34.11,0.0,35,0,0,6,26,60.174,20,62,61,69.477,381.65,32.8,3.3,6,4
5.612,8.2,34.0,29.783,0.0,24,0,0,14,25,48.898,19,50,49,55.564,340.47,38.8,4.1,6,14
9.801,1.6,46.0,39.893,0.0,30,0,0,17,33,62.876,26,67,63,70.196,484.71,41.3,6.3,7,15
5.44,3.2,16.5,17.214,0.0,18,0,0,5,13,30.44,11,32,31,35.237,180.3,35.5,3.2,2,4
5.745,4.5,29.0,26.702,6.8,21,3,3,7,23,44.789,17,46,44,50.792,326.4,38.6,2.3,6,7
3.7,8.2,40.0,37.092,0.0,29,0,0,11,32,62.229,19,63,61,69.57,487.67,31.1,9.8,13,6
4.68,3.6,15.5,15.687,0.0,16,0,0,5,12,27.556,10,29,28,31.822,166.27,35.7,3.6,2,4
5.02,3.2,16.5,17.214,0.0,18,0,0,5,13,30.44,11,32,31,35.237,180.3,35.5,3.2,2,4
5.5,3.6,15.5,15.687,0.0,16,0,0,5,12,27.556,10,29,28,31.822,166.27,35.7,3.6,2,4
6.615,1.8,32.0,32.804,0.0,32,0,0,7,25,56.029,21,60,57,64.273,362.61,36.8,3.5,4,6
6.36,2.1,38.0,30.629,2.1,22,1,1,17,26,47.989,22,51,48,53.824,351.45,45.8,4.2,4,15
5.33,3.2,16.5,17.214,0.0,18,0,0,5,13,30.44,11,32,31,35.237,180.3,35.5,3.2,2,4
5.9,5.3,33.5,33.389,0.0,29,0,0,7,28,57.832,18,58,57,65.069,415.57,31.6,10.5,10,5
6.415,2.0,35.0,31.223,0.0,26,0,0,13,25,50.378,21,54,51,57.027,356.55,41.2,3.9,4,12
6.85,1.9,29.0,30.277,0.0,30,0,0,7,23,52.145,19,55,53,59.858,336.57,35.8,3.8,4,6
7.266,5.0,28.0,24.971,0.0,20,0,0,12,20,39.232,17,42,40,44.653,284.46,42.5,0.0,3,12
5.57,4.3,31.0,27.838,0.0,24,0,0,13,22,44.923,20,48,46,51.564,292.46,43.5,0.0,2,13
5.534,4.9,30.0,25.214,0.0,20,0,0,11,21,40.811,17,44,41,46.152,284.39,41.5,4.9,4,9
6.64,1.7,34.5,33.616,0.0,32,0,0,11,26,56.952,23,61,58,65.353,354.56,39.7,3.4,3,10
7.92,1.7,34.5,33.616,0.0,32,0,0,11,26,56.952,23,61,58,65.353,354.56,39.7,3.4,3,10
6.06,1.7,34.5,33.616,0.0,32,0,0,11,26,56.952,23,61,58,65.353,354.56,39.7,3.4,3,10
6.33,1.9,33.5,31.826,0.0,29,0,0,11,25,53.127,22,57,54,60.73,339.52,40.7,3.7,3,10
8.81,1.7,34.5,33.616,0.0,32,0,0,11,26,56.952,23,61,58,65.353,354.56,39.7,3.4,3,10
7.81,1.8,33.5,32.902,0.0,32,0,0,11,25,55.625,23,60,57,64.143,338.56,40.4,1.8,2,10
7.43,1.9,37.5,32.036,0.0,26,0,0,17,26,51.301,23,55,52,58.107,348.5,44.2,3.8,3,16
7.94,1.7,34.5,33.616,0.0,32,0,0,11,26,56.952,23,61,58,65.353,354.56,39.7,3.4,3,10
5.81,1.9,33.5,31.826,0.0,29,0,0,11,25,53.127,22,57,54,60.73,339.52,40.7,3.7,3,10
8.48,1.9,33.5,31.826,0.0,29,0,0,11,25,53.127,22,57,54,60.73,339.52,40.7,3.7,3,10
6.98,2.1,35.5,29.531,0.0,23,0,0,17,24,46.149,22,50,47,52.275,317.46,46.8,2.1,2,16
7.56,1.9,33.5,31.826,0.0,29,0,0,11,25,53.127,22,57,54,60.73,339.52,40.7,3.7,3,10
7.01,2.1,36.5,30.246,0.0,23,0,0,17,25,47.476,22,51,48,53.484,333.46,45.8,4.2,3,16
7.26,1.9,32.5,31.111,0.0,29,0,0,11,24,51.8,22,56,53,59.521,323.52,41.5,1.9,2,10
4.574,3.5,44.0,35.938,0.0,26,0,0,17,31,57.443,24,61,57,64.026,422.52,42.1,8.8,7,15
7.5,2.0,36.5,31.321,0.0,26,0,0,17,25,49.974,23,54,51,56.898,332.5,45.1,2.0,2,16
8.15,1.9,33.5,31.826,0.0,29,0,0,11,25,53.127,22,57,54,60.73,339.52,40.7,3.7,3,10
5.42,1.7,26.0,31.879,0.0,35,0,0,6,23,56.527,20,58,58,65.686,337.63,34.5,1.7,3,6
4.2,3.1,12.0,16.456,0.0,20,0,0,0,12,31.651,9,32,32,36.862,174.3,28.1,6.3,3,0
4.362,4.2,38.0,30.455,0.0,22,0,0,16,26,48.022,21,52,48,53.777,350.45,43.8,6.3,5,14
5.683,2.3,43.0,30.53,7.0,14,3,3,20,29,44.691,22,46,43,48.467,397.37,51.2,7.0,7,20
4.78,2.6,14.0,19.509,0.0,24,0,0,0,14,37.418,11,38,38,43.692,202.36,28.9,5.3,3,0
4.49,2.6,14.0,19.509,0.0,24,0,0,0,14,37.418,11,38,38,43.692,202.36,28.9,5.3,3,0
4.18,2.4,15.0,21.036,0.0,26,0,0,0,15,40.301,12,41,41,47.107,216.39,29.3,4.9,3,0
4.0,2.9,13.0,17.982,0.0,22,0,0,0,13,34.534,10,35,35,40.277,188.33,28.6,5.7,3,0
4.0,2.9,13.0,17.982,0.0,22,0,0,0,13,34.534,10,35,35,40.277,188.33,28.6,5.7,3,0
4.03,3.1,12.0,16.456,0.0,20,0,0,0,12,31.651,9,32,32,36.862,174.3,28.1,6.3,3,0
4.55,2.9,13.0,17.982,0.0,22,0,0,0,13,34.534,10,35,35,40.277,188.33,28.6,5.7,3,0
4.0,2.9,13.0,17.982,0.0,22,0,0,0,13,34.534,10,35,35,40.277,188.33,28.6,5.7,3,0
4.28,2.6,14.0,19.509,0.0,24,0,0,0,14,37.418,11,38,38,43.692,202.36,28.9,5.3,3,0
4.08,2.6,14.0,19.509,0.0,24,0,0,0,14,37.418,11,38,38,43.692,202.36,28.9,5.3,3,0
4.81,2.9,13.0,17.982,0.0,22,0,0,0,13,34.534,10,35,35,40.277,188.33,28.6,5.7,3,0
5.409,2.1,45.0,32.772,6.4,16,3,3,20,31,48.902,23,50,47,53.092,427.4,48.9,8.5,8,20
5.244,2.7,35.0,25.718,8.1,12,3,3,14,25,39.134,17,39,37,42.261,351.3,45.9,10.8,8,14
5.0,7.7,36.5,31.595,0.0,26,0,0,17,26,51.454,21,54,52,58.77,350.51,40.4,1.9,5,14
5.569,2.3,43.0,30.53,7.0,14,3,3,20,29,44.691,22,46,43,48.467,397.37,51.2,7.0,7,20
5.319,4.8,44.0,30.852,9.5,12,4,3,20,30,44.233,21,45,42,47.494,432.8,50.0,7.1,9,19
5.444,4.8,44.0,30.408,9.5,12,4,4,20,30,44.422,21,45,42,47.89,416.35,50.0,7.1,9,19
5.481,7.0,42.5,30.046,7.0,14,3,3,19,29,45.011,20,46,43,49.049,401.37,46.5,7.0,9,17
5.605,3.8,42.0,33.697,0.0,24,0,0,17,29,53.232,23,57,53,59.401,392.49,43.4,7.5,6,15
5.388,4.0,41.0,32.17,0.0,22,0,0,17,28,50.349,22,54,50,55.986,378.46,44.0,8.0,6,15
5.222,4.0,41.0,32.17,0.0,22,0,0,17,28,50.349,22,54,50,55.986,378.46,44.0,8.0,6,15
5.553,2.5,41.5,29.19,7.5,12,3,3,19,28,41.883,20,43,40,44.972,403.4,50.0,7.5,8,18
5.721,2.3,44.0,31.245,6.8,14,3,3,20,30,46.018,22,47,44,49.677,413.37,50.0,9.1,8,20
5.284,10.8,27.0,22.488,0.0,18,0,0,10,19,36.92,14,40,37,42.109,258.36,37.8,2.7,5,6
7.0,2.9,23.0,22.132,5.7,17,2,0,6,18,35.029,14,37,35,39.333,286.22,40.0,2.9,4,6
4.01,2.9,13.0,17.982,0.0,22,0,0,0,13,34.534,10,35,35,40.277,188.33,28.6,5.7,3,0
4.0,3.3,15.0,16.853,0.0,17,0,0,1,13,29.902,9,31,30,34.159,203.34,30.0,6.7,4,0
4.0,3.3,15.0,16.853,0.0,17,0,0,1,13,29.902,9,31,30,34.159,203.34,30.0,6.7,4,0
4.0,3.3,15.0,16.853,0.0,17,0,0,1,13,29.902,9,31,30,34.159,203.34,30.0,6.7,4,0
4.0,3.3,15.0,16.853,0.0,17,0,0,1,13,29.902,9,31,30,34.159,203.34,30.0,6.7,4,0
4.99,6.5,19.5,18.16,0.0,16,0,0,6,15,31.043,11,32,31,35.322,208.29,35.5,6.5,4,4
5.419,3.6,43.0,35.224,0.0,26,0,0,17,30,56.116,24,60,56,62.817,406.52,42.9,7.1,6,15
4.325,3.7,43.0,34.412,0.0,24,0,0,17,30,54.56,23,58,54,60.611,408.49,42.6,9.3,7,15
5.692,3.3,51.0,39.224,0.0,26,0,0,23,34,60.116,28,65,60,66.817,454.56,46.7,6.7,6,21
5.24,4.3,39.0,29.928,0.0,20,0,0,17,26,46.138,21,50,46,51.362,348.43,45.7,6.5,5,15
5.064,3.6,43.0,35.224,0.0,26,0,0,17,30,56.116,24,60,56,62.817,406.52,42.9,7.1,6,15
5.324,3.6,43.0,35.224,0.0,26,0,0,17,30,56.116,24,60,56,62.817,406.52,42.9,7.1,6,15
8.168,2.3,30.0,26.816,0.0,23,0,0,13,21,42.821,20,46,44,49.066,277.44,45.5,0.0,1,14
5.896,1.7,42.0,38.701,3.3,29,2,0,17,31,59.476,25,62,60,66.796,645.35,41.7,5.0,6,15
8.409,5.0,28.0,24.971,0.0,20,0,0,12,20,39.232,17,42,40,44.653,284.46,42.5,0.0,3,12
6.567,5.0,29.0,24.784,0.0,20,0,0,12,20,39.156,18,43,40,44.733,264.4,45.0,0.0,2,12
6.271,4.8,28.0,25.311,0.0,22,0,0,12,20,41.04,18,44,42,47.149,266.42,42.9,0.0,2,12
6.344,5.2,40.0,35.176,0.0,30,0,0,16,28,56.734,25,60,58,65.1,372.58,43.1,0.0,3,19
6.863,2.5,26.0,24.004,0.0,21,0,0,12,19,39.265,17,41,40,44.86,255.39,42.5,2.5,2,12
5.01,3.8,10.0,13.402,0.0,16,0,0,1,10,25.883,7,25,26,30.031,146.24,26.9,7.7,3,1
5.678,7.4,16.5,15.633,0.0,14,0,0,5,13,27.16,9,28,27,30.907,182.25,33.3,7.4,4,3
6.022,7.7,19.5,16.106,0.0,12,0,0,6,14,26.276,10,27,26,29.491,192.24,38.5,7.7,4,3
5.523,2.0,31.0,29.202,0.0,25,0,0,8,24,49.014,19,51,49,55.318,331.45,38.8,8.2,5,9
7.674,5.0,29.0,25.799,2.5,19,1,0,12,21,39.556,17,42,40,44.597,318.9,42.5,0.0,4,12
8.78,1.5,40.0,38.594,0.0,35,0,0,13,30,63.854,26,68,65,72.896,425.69,40.0,3.1,4,12
7.468,9.5,31.5,26.487,0.0,20,0,0,12,22,41.552,17,45,42,47.235,312.48,40.5,0.0,5,11
5.595,5.8,37.0,32.476,0.0,25,0,0,13,27,51.756,21,55,52,58.401,383.56,40.4,3.8,6,13
6.73,6.1,34.0,30.874,2.0,24,1,0,12,25,48.425,20,52,49,54.926,373.99,40.8,0.0,5,12
4.25,4.2,13.0,13.612,0.0,13,0,0,2,11,24.058,8,24,24,27.408,155.22,33.3,8.3,3,3
5.42,5.4,25.0,22.778,2.7,18,1,0,8,19,37.193,14,37,37,41.889,281.79,37.8,5.4,5,7
5.5,5.2,38.0,34.982,1.7,30,1,0,16,28,57.327,23,60,58,65.461,400.01,39.7,1.7,5,13
5.961,1.8,22.0,28.977,0.0,35,0,0,0,20,53.123,19,57,55,62.557,277.55,34.5,0.0,1,0
5.875,4.7,24.0,24.552,0.0,24,0,0,7,19,42.251,16,44,43,48.773,260.42,37.2,2.3,3,7
5.097,6.1,19.0,18.972,0.0,18,0,0,2,15,32.6,12,34,33,37.528,206.32,36.4,3.0,3,1
9.081,2.0,33.0,30.036,0.0,26,0,0,13,24,49.301,21,52,50,56.107,324.48,42.0,4.0,3,13
7.29,9.7,22.5,18.94,0.0,15,0,0,7,16,30.934,12,32,31,35.196,217.3,38.7,3.2,4,4
6.367,2.7,28.0,24.418,5.4,17,2,0,12,20,36.702,17,39,37,41.123,306.25,45.9,0.0,3,12
5.66,1.8,40.0,35.111,0.0,29,0,0,19,28,55.8,26,59,57,63.521,371.56,45.6,1.8,2,20
6.77,10.3,32.0,25.601,2.6,17,1,0,13,22,38.916,17,42,39,43.844,312.83,43.6,0.0,5,13
7.626,2.3,27.0,25.531,0.0,23,0,0,12,20,42.149,18,44,43,48.275,269.42,41.9,2.3,2,12
5.16,3.7,13.5,14.687,0.0,16,0,0,5,11,26.556,9,27,27,30.822,154.26,33.3,3.7,2,4
5.924,2.0,31.0,29.585,0.0,27,0,0,12,23,48.916,21,52,50,56.105,309.49,42.0,2.0,2,12
5.824,1.8,41.0,35.939,1.8,28,1,0,19,29,56.123,26,59,57,63.465,406.0,45.6,1.8,3,20
6.9,10.6,37.0,29.751,0.0,21,0,0,14,26,47.232,19,50,47,53.232,351.45,40.4,4.3,7,13
