pXC50,nH,nS,nHM,nC,nAT,RBN,SCBO,nSK,nBM,nBO,nCsp2,nAB,nHet,nBT,Si,MW,Se,nCsp3,nN
5.0,30,0,0,27,61.0,3,46.5,31,21,36,17,21,4,66.0,68.391,410.61,59.894,10,4
8.222,25,1,4,22,57.0,11,43.5,32,18,34,15,17,10,59.0,64.207,556.4,57.283,7,6
6.38,40,0,0,32,80.0,6,54.0,40,17,45,14,16,8,85.0,90.98,550.76,79.876,18,4
5.99,37,1,1,30,76.0,6,53.0,39,17,44,13,16,9,81.0,86.359,553.79,75.959,17,5
6.83,40,0,0,30,78.0,7,49.0,38,13,42,12,12,8,82.0,88.98,526.74,77.876,18,4
5.21,40,0,0,30,78.0,7,49.0,38,13,42,12,12,8,82.0,88.98,526.74,77.876,18,4
5.0,26,0,0,21,54.0,7,39.0,28,16,31,12,16,7,57.0,61.189,382.51,54.109,9,4
5.0,26,0,0,21,54.0,7,39.0,28,16,31,12,16,7,57.0,61.189,382.51,54.109,9,4
5.0,26,0,0,21,54.0,7,39.0,28,16,31,12,16,7,57.0,61.189,382.51,54.109,9,4
5.0,28,0,0,22,56.0,7,39.0,28,16,31,13,16,6,59.0,63.394,380.54,55.665,9,4
5.0,25,0,0,21,52.0,6,38.0,27,16,30,13,16,6,55.0,58.69,367.49,52.007,8,3
5.0,26,0,0,22,55.0,7,40.0,29,16,32,13,16,7,58.0,62.445,399.51,55.403,9,3
5.0,24,0,0,22,54.0,6,41.0,30,16,33,13,16,8,57.0,61.915,419.49,55.101,9,3
5.0,32,1,1,28,70.0,10,55.0,38,24,42,19,22,10,74.0,78.773,536.71,70.491,9,4
5.0,29,0,0,24,59.0,8,42.0,30,16,34,13,16,6,63.0,66.521,407.56,58.774,11,3
5.0,31,0,0,24,61.0,8,41.0,30,16,33,13,16,6,64.0,68.936,409.58,60.658,11,3
5.0,26,0,0,23,59.0,8,44.0,33,16,36,13,16,10,62.0,67.749,465.52,60.64,10,3
5.0,27,1,2,22,60.0,8,46.0,33,18,36,13,16,11,63.0,67.887,495.05,61.047,9,4
5.0,30,0,0,24,62.0,8,44.0,32,17,35,14,16,8,65.0,70.228,438.58,62.203,10,4
5.0,26,0,0,21,54.0,7,39.0,28,16,31,12,16,7,57.0,61.189,382.51,54.109,9,4
5.0,30,0,0,23,60.0,8,41.0,30,16,33,13,16,7,63.0,68.019,410.57,59.876,10,4
5.0,33,0,0,26,67.0,11,46.0,34,17,37,14,16,8,70.0,75.77,467.62,67.196,12,3
5.0,28,0,0,23,58.0,8,41.0,30,16,33,13,16,7,61.0,65.86,413.54,58.287,10,3
5.0,32,1,1,24,66.0,9,47.0,34,18,37,13,16,10,69.0,74.773,488.67,66.491,11,4
5.0,33,0,0,26,66.0,8,45.0,33,16,37,13,16,7,70.0,74.561,451.62,65.869,13,3
5.0,28,0,0,23,59.0,9,42.0,31,16,34,13,16,8,62.0,67.07,429.54,59.614,10,3
5.0,28,0,0,22,56.0,7,39.0,28,16,31,13,16,6,59.0,63.394,380.54,55.665,9,4
5.0,33,0,0,25,64.0,8,42.0,31,16,34,13,16,6,67.0,72.351,423.61,63.541,12,3
5.0,34,0,0,27,69.0,9,48.0,35,17,39,14,16,8,73.0,78.059,478.65,68.97,13,4
5.0,25,1,1,21,52.0,6,38.0,27,16,30,13,16,6,55.0,58.401,383.56,51.756,8,3
5.0,25,1,1,21,52.0,6,38.0,27,16,30,13,16,6,55.0,58.401,383.56,51.756,8,3
5.0,28,0,0,23,58.0,8,41.0,30,16,33,13,16,7,61.0,65.86,413.54,58.287,10,3
5.0,27,1,1,23,57.0,7,42.0,30,17,33,14,16,7,60.0,64.026,425.6,56.967,9,3
5.0,27,1,1,22,55.0,7,39.0,28,16,31,13,16,6,58.0,61.816,397.59,54.64,9,3
5.0,27,1,1,22,55.0,7,39.0,28,16,31,13,16,6,58.0,61.816,397.59,54.64,9,3
5.0,24,1,2,21,56.0,7,45.0,32,18,35,13,16,11,59.0,63.602,483.01,57.349,8,4
5.0,26,0,1,22,55.0,7,40.0,29,16,32,13,16,7,58.0,62.05,415.96,55.214,9,3
5.0,31,1,1,24,64.0,9,46.0,33,18,36,13,16,9,67.0,72.275,473.65,64.389,11,3
5.0,26,0,0,22,57.0,8,44.0,31,18,34,13,16,9,60.0,64.607,426.52,57.763,9,4
5.0,37,1,1,29,77.0,11,56.5,40,23,44,17,21,11,81.0,87.102,567.78,77.36,12,5
5.0,28,0,0,24,61.0,9,45.0,33,17,36,14,16,9,64.0,69.279,457.55,61.941,10,3
5.0,29,0,0,24,62.0,9,45.0,33,17,36,14,16,9,65.0,70.568,456.57,62.716,10,4
5.0,28,0,1,24,61.0,9,45.0,33,17,36,14,16,9,64.0,68.884,474.0,61.752,10,3
5.0,24,0,1,22,54.0,7,42.0,30,17,33,14,16,8,57.0,60.844,429.94,54.658,8,3
5.0,28,1,2,23,63.0,9,48.0,35,18,38,13,16,12,66.0,71.642,527.07,64.443,10,4
5.0,23,0,2,21,51.0,6,39.0,28,16,31,13,16,7,54.0,57.369,420.37,51.327,8,3
5.0,32,1,1,26,70.0,10,54.5,38,23,42,16,21,12,74.0,79.354,540.71,70.811,10,6
5.0,26,1,1,21,54.0,7,39.0,28,16,31,12,16,7,57.0,60.899,398.58,53.858,9,4
5.0,37,1,1,28,75.0,10,52.0,38,18,42,13,16,10,79.0,84.73,543.75,75.367,15,3
5.0,29,1,1,23,58.0,8,40.0,29,16,32,13,16,6,61.0,65.231,411.62,57.523,10,3
5.0,24,1,1,21,53.0,5,41.0,29,17,32,14,16,8,56.0,59.693,412.56,53.302,7,4
5.0,23,1,1,23,52.0,8,43.0,29,22,32,19,22,6,55.0,57.986,405.56,51.872,4,3
5.0,26,1,2,22,55.0,7,40.0,29,16,32,13,16,7,58.0,61.76,432.03,54.963,9,3
8.284,68,2,2,55,149.0,13,109.0,81,37,86,35,28,26,154.0,168.958,1153.49,151.043,20,12
6.0,68,2,2,55,148.0,12,108.0,80,37,85,35,28,25,153.0,167.749,1137.49,149.716,20,12
5.0,63,2,2,53,141.0,10,106.0,78,37,83,35,28,25,146.0,159.629,1110.41,143.174,18,11
7.62,72,2,2,57,156.0,16,112.0,84,37,89,35,28,27,161.0,176.998,1197.55,158.137,22,12
7.42,58,2,2,50,130.0,9,99.0,72,36,77,34,28,22,135.0,146.882,1023.32,131.65,16,10
6.368,65,2,2,54,144.0,10,107.0,79,37,84,35,28,25,149.0,163.045,1124.44,146.057,19,11
7.097,63,2,2,48,135.0,12,95.0,72,30,76,28,22,24,139.0,153.42,1034.36,136.847,20,11
6.461,66,2,2,49,138.0,17,94.0,72,29,76,27,22,23,142.0,156.752,1035.39,139.512,22,10
6.137,65,2,3,49,138.0,17,95.0,73,29,77,27,22,24,142.0,156.473,1161.28,139.581,22,10
6.077,75,2,3,55,159.0,20,107.0,84,29,89,27,22,29,164.0,180.596,1323.44,161.636,28,10
6.0,85,2,3,61,180.0,23,119.0,95,29,101,27,22,34,186.0,204.719,1485.6,183.69,34,10
6.317,77,3,4,58,167.0,23,115.0,90,31,95,29,22,32,172.0,189.35,1425.56,170.25,29,10
6.0,95,2,3,67,201.0,26,131.0,106,29,113,27,22,39,208.0,228.842,1647.76,205.745,40,10
6.472,63,2,3,49,137.0,17,97.0,74,30,78,28,22,25,141.0,155.267,1175.26,139.025,21,10
5.986,73,2,3,55,158.0,20,109.0,85,30,90,28,22,30,163.0,179.39,1337.42,161.079,27,10
6.099,83,2,3,61,179.0,23,121.0,96,30,102,28,22,35,185.0,203.513,1499.58,183.134,33,10
6.085,93,2,3,67,200.0,26,133.0,107,30,114,28,22,40,207.0,227.636,1661.74,205.188,39,10
6.449,77,3,4,58,167.0,23,115.0,90,31,95,29,22,32,172.0,189.35,1425.56,170.25,29,10
5.0,28,0,0,26,58.0,3,45.5,30,21,35,17,21,4,63.0,64.976,396.58,57.01,9,4
6.385,68,0,0,51,139.0,17,94.0,71,30,75,29,22,20,143.0,158.118,981.29,139.915,22,10
6.0,74,0,0,63,158.0,21,116.0,84,43,90,42,34,21,164.0,178.573,1147.47,158.894,21,10
6.461,74,0,0,63,158.0,21,116.0,84,43,90,42,34,21,164.0,178.573,1147.47,158.894,21,10
6.604,70,0,0,55,145.0,17,101.5,75,35,80,33,27,20,150.0,164.533,1031.35,145.799,22,10
6.0,70,0,0,56,146.0,18,103.0,76,36,81,35,28,20,151.0,165.533,1043.36,146.799,21,10
6.0,70,0,0,56,146.0,18,103.0,76,36,81,35,28,20,151.0,165.533,1043.36,146.799,21,10
6.0,76,0,0,67,164.0,21,123.5,88,48,95,46,39,21,171.0,184.988,1197.53,164.777,21,10
5.009,34,0,0,28,66.0,8,46.5,32,21,36,17,21,4,70.0,74.221,426.66,64.661,11,4
6.18,34,1,1,28,70.0,11,48.5,36,18,39,17,17,8,73.0,78.607,510.71,70.054,11,2
6.143,37,1,2,30,78.0,13,54.5,41,19,44,18,17,11,81.0,87.963,601.23,78.465,12,4
5.0,35,0,1,29,73.0,12,50.5,38,18,41,17,17,9,76.0,82.255,543.11,73.512,12,2
5.0,35,0,1,29,73.0,12,50.5,38,18,41,17,17,9,76.0,82.255,543.11,73.512,12,2
5.0,38,0,0,30,76.0,13,50.5,38,18,41,17,17,8,79.0,85.727,522.7,76.072,13,2
5.0,38,0,0,30,76.0,13,50.5,38,18,41,17,17,8,79.0,85.727,522.7,76.072,13,2
5.398,36,0,0,32,76.0,11,56.0,40,23,44,21,22,8,80.0,85.311,544.7,76.189,11,2
6.745,36,1,1,29,75.0,12,52.5,39,19,42,18,17,10,78.0,84.603,552.76,75.258,11,4
6.367,33,1,2,28,70.0,11,49.5,37,18,40,17,17,9,73.0,78.551,545.15,70.378,11,2
6.357,36,1,1,32,76.0,11,56.0,40,23,44,21,22,8,80.0,85.022,560.77,75.938,11,2
7.155,23,1,4,21,54.0,10,42.5,31,18,33,15,17,10,56.0,60.791,542.37,54.4,6,6
6.289,30,1,4,23,62.0,11,41.0,32,13,34,12,12,9,64.0,69.954,559.45,61.832,11,5
4.824,28,1,4,26,63.0,8,48.0,35,19,38,18,18,9,66.0,70.539,593.46,62.949,8,5
5.77,24,1,4,23,56.0,10,44.0,32,19,34,17,18,9,58.0,62.708,553.39,56.182,6,5
5.377,22,1,4,18,49.0,9,35.0,27,13,28,12,12,9,50.0,55.293,491.32,49.298,6,5
6.384,25,1,4,23,58.0,7,45.5,33,18,36,15,17,10,61.0,65.207,568.41,58.283,8,6
6.322,21,1,4,20,51.0,9,41.5,30,18,32,15,17,10,53.0,57.376,528.34,51.516,5,6
5.398,28,1,3,23,60.0,12,43.5,32,18,34,15,17,9,62.0,67.78,491.54,59.938,8,6
6.284,25,1,4,26,61.0,10,51.5,36,24,39,21,23,10,64.0,68.207,604.44,61.283,5,6
6.321,28,1,4,22,59.0,10,40.0,31,13,33,12,12,9,61.0,66.539,545.42,58.949,10,5
4.149,31,1,2,26,63.0,12,44.0,32,19,34,18,18,6,65.0,70.568,511.58,62.083,8,4
5.155,27,1,2,22,57.0,11,41.5,30,18,32,15,17,8,59.0,64.319,487.52,56.636,7,6
5.77,25,1,4,22,57.0,11,43.5,32,18,34,15,17,10,59.0,64.207,556.4,57.283,7,6
7.796,29,1,2,26,63.0,11,49.0,34,23,37,19,22,8,66.0,70.734,537.58,62.52,7,6
7.301,29,1,2,22,59.0,12,41.5,30,18,32,14,17,8,61.0,66.734,489.54,58.52,8,6
6.095,26,1,4,20,55.0,10,37.0,29,13,30,12,12,9,56.0,62.124,519.38,55.065,8,5
6.733,27,1,4,24,61.0,12,46.0,34,19,36,17,18,10,63.0,68.622,582.44,61.167,7,6
5.155,29,1,2,23,60.0,12,42.5,31,18,33,15,17,8,62.0,67.734,501.55,59.52,8,6
7.018,25,1,4,22,57.0,11,43.5,32,18,34,15,17,10,59.0,64.207,556.4,57.283,7,6
4.149,30,1,4,27,66.0,9,49.0,36,19,39,18,18,9,69.0,73.954,607.49,65.832,9,5
5.699,30,1,2,24,61.0,11,42.5,31,18,33,16,17,7,63.0,68.651,500.56,60.301,8,5
6.0,26,1,4,20,55.0,11,37.0,29,13,30,12,12,9,56.0,62.124,519.38,55.065,8,5
7.081,47,0,0,34,90.0,16,57.0,43,19,46,17,16,9,93.0,102.048,589.86,89.374,17,5
8.022,58,2,2,42,122.0,10,83.0,64,24,67,22,16,22,125.0,138.882,927.24,123.65,20,10
8.377,29,0,0,25,64.0,12,48.0,35,19,37,17,16,10,66.0,73.197,485.59,65.003,8,5
8.456,58,2,2,42,122.0,10,83.0,64,24,67,22,16,22,125.0,138.882,927.24,123.65,20,10
5.0,32,1,1,31,71.0,9,60.0,39,31,44,23,30,8,76.0,79.517,536.76,70.501,8,6
5.301,19,0,0,25,47.0,4,46.0,28,28,32,24,28,3,51.0,51.817,361.47,46.374,1,3
5.0,32,0,0,28,67.0,8,51.5,35,23,39,19,21,7,71.0,75.597,468.66,66.425,9,6
5.357,51,0,0,42,100.0,19,68.0,49,28,54,26,28,7,105.0,112.297,661.96,98.821,16,3
5.0,19,0,0,21,47.0,6,44.0,28,24,31,18,22,7,50.0,52.817,373.45,47.349,3,5
5.0,33,1,1,27,67.0,7,49.0,34,21,38,15,20,7,71.0,75.434,475.72,66.283,12,5
5.301,20,0,0,21,45.0,5,39.0,25,22,28,18,22,4,48.0,50.315,328.45,44.476,3,4
5.143,20,1,1,23,48.0,5,45.0,28,26,32,20,26,5,52.0,53.235,384.54,47.552,3,4
5.74,66,2,2,49,137.0,17,93.0,71,29,75,27,22,22,141.0,155.543,1019.39,138.185,22,10
6.569,79,2,2,73,175.0,20,136.0,96,55,104,53,46,23,183.0,196.532,1334.77,175.588,20,11
5.228,21,0,0,21,47.0,6,40.5,26,22,29,18,21,5,50.0,52.813,343.47,46.578,3,5
5.149,23,0,0,26,54.0,7,49.5,31,28,35,24,27,5,58.0,60.228,405.54,53.461,2,5
5.0,21,0,0,26,54.0,7,51.5,33,28,37,24,27,7,58.0,60.908,441.52,54.487,2,5
5.0,26,0,0,24,56.0,7,44.5,30,22,33,18,21,6,59.0,62.979,402.54,55.781,6,4
5.401,22,0,0,27,58.0,8,54.5,36,28,40,24,27,9,62.0,65.872,489.54,59.21,3,5
5.0,31,0,0,30,66.0,8,53.5,35,28,39,24,27,5,70.0,73.889,461.66,64.996,6,5
7.0,54,0,0,46,113.0,9,82.0,59,28,65,26,22,13,119.0,127.42,803.06,113.108,20,6
7.168,102,2,2,74,217.0,26,149.0,115,43,120,39,28,41,222.0,247.808,1640.1,220.635,35,20
6.155,102,2,2,74,217.0,26,149.0,115,43,120,39,28,41,222.0,247.808,1640.1,220.635,35,20
8.432,104,2,2,76,219.0,26,149.0,115,43,120,41,28,39,224.0,249.642,1638.12,222.199,35,18
9.0,101,2,2,70,210.0,24,139.0,109,37,113,35,22,39,214.0,240.1,1561.04,213.206,35,19
7.097,101,2,2,70,210.0,24,139.0,109,37,113,35,22,39,214.0,240.1,1561.04,213.206,35,19
6.907,102,2,2,74,217.0,26,149.0,115,43,120,39,28,41,222.0,247.808,1640.1,220.635,35,20
6.0,69,2,3,58,151.0,18,112.5,82,41,88,37,33,24,157.0,170.689,1177.98,152.268,21,12
6.24,69,2,3,58,151.0,18,112.5,82,41,88,37,33,24,157.0,170.689,1177.98,152.268,21,12
6.0,68,2,3,56,149.0,18,111.0,81,40,87,35,32,25,155.0,168.772,1166.96,150.486,21,13
6.0,76,0,1,62,160.0,31,114.0,84,42,89,40,34,22,165.0,181.221,1170.94,160.875,22,11
5.546,78,0,1,66,166.0,31,121.5,88,47,94,44,39,22,172.0,187.636,1221.0,166.759,22,11
6.218,71,2,2,62,156.0,18,119.0,85,46,92,42,38,23,163.0,175.871,1194.58,157.054,20,11
6.0,78,0,1,66,166.0,31,121.5,88,47,94,44,39,22,172.0,187.636,1221.0,166.759,22,11
6.0,75,0,0,61,158.0,31,113.0,83,42,88,40,34,22,163.0,179.071,1138.47,158.995,21,11
5.931,104,2,2,76,219.0,26,149.0,115,43,120,41,28,39,224.0,249.642,1638.12,222.199,35,18
6.0,67,2,3,57,148.0,18,111.5,81,41,87,37,33,24,154.0,167.274,1163.95,149.385,20,12
6.0,69,2,3,58,151.0,19,112.5,82,41,88,37,33,24,157.0,170.689,1177.98,152.268,21,12
6.0,72,2,2,59,154.0,18,112.5,82,41,88,37,33,23,160.0,174.16,1157.57,154.828,22,12
8.699,104,2,2,76,219.0,26,149.0,115,43,120,41,28,39,224.0,249.642,1638.12,222.199,35,18
6.0,69,2,3,58,151.0,18,112.5,82,41,88,37,33,24,157.0,170.689,1177.98,152.268,21,12
6.0,69,2,3,58,151.0,18,112.5,82,41,88,37,33,24,157.0,170.689,1177.98,152.268,21,12
6.0,71,2,3,59,154.0,18,113.5,83,41,89,37,33,24,160.0,174.104,1192.01,155.152,22,12
6.0,69,2,3,58,151.0,18,112.5,82,41,88,37,33,24,157.0,170.689,1177.98,152.268,21,12
6.0,69,2,3,58,151.0,18,112.5,82,41,88,37,33,24,157.0,170.689,1177.98,152.268,21,12
6.0,68,2,2,55,148.0,18,110.0,80,40,86,34,32,25,154.0,167.911,1133.51,149.381,21,14
6.0,71,2,2,60,155.0,18,117.5,84,45,91,39,37,24,162.0,175.243,1182.58,156.046,21,13
6.0,61,2,3,54,139.0,14,108.5,78,41,84,37,33,24,145.0,157.028,1121.86,140.734,17,12
6.0,63,2,3,55,142.0,14,109.5,79,41,85,37,33,24,148.0,160.443,1135.89,143.617,18,12
6.0,73,2,3,61,158.0,19,116.0,85,42,91,39,34,24,164.0,178.519,1218.05,159.035,22,12
8.77,104,2,2,76,219.0,26,149.0,115,43,120,41,28,39,224.0,249.642,1638.12,222.199,35,18
8.638,104,2,2,76,219.0,26,149.0,115,43,120,41,28,39,224.0,249.642,1638.12,222.199,35,18
7.602,103,2,2,74,216.0,26,144.0,113,39,117,39,24,39,220.0,246.353,1615.08,219.424,35,17
7.796,103,2,2,74,216.0,26,144.0,113,39,117,39,24,39,220.0,246.353,1615.08,219.424,35,17
7.921,105,2,2,78,221.0,26,150.5,116,44,121,43,29,38,226.0,251.559,1649.14,223.981,35,17
7.921,105,2,2,78,221.0,26,150.5,116,44,121,43,29,38,226.0,251.559,1649.14,223.981,35,17
6.0,107,2,2,78,225.0,28,152.5,118,44,123,42,29,40,230.0,256.555,1679.18,228.184,36,19
6.0,107,2,2,78,225.0,28,152.5,118,44,123,42,29,40,230.0,256.555,1679.18,228.184,36,19
9.155,66,2,2,54,142.0,14,103.0,76,36,81,34,28,22,147.0,160.543,1079.44,143.185,20,10
7.387,67,2,2,56,144.0,14,104.5,77,37,82,36,29,21,149.0,162.46,1090.46,144.966,20,9
6.0,69,2,2,56,148.0,16,106.5,79,37,84,35,29,23,153.0,167.456,1120.5,149.17,21,11
6.229,69,2,2,56,148.0,16,106.5,79,37,84,35,29,23,153.0,167.456,1120.5,149.17,21,11
6.886,25,1,2,25,58.0,9,50.0,33,26,37,19,26,8,62.0,65.006,477.08,57.847,6,6
6.854,28,1,1,26,61.0,9,50.0,33,26,37,19,26,7,65.0,68.477,456.67,60.407,7,6
8.509,207,3,3,137,427.0,76,275.0,220,62,227,60,28,83,434.0,489.819,3149.06,434.507,77,41
6.0,60,0,0,46,121.0,11,82.0,61,28,65,26,22,15,125.0,137.247,837.14,121.079,20,8
6.0,58,0,0,45,118.0,11,81.0,60,28,64,26,22,15,122.0,133.832,823.11,118.196,19,8
6.0,58,0,0,45,118.0,11,81.0,60,28,64,26,22,15,122.0,133.832,823.11,118.196,19,8
6.0,58,0,0,45,118.0,11,81.0,60,28,64,26,22,15,122.0,133.832,823.11,118.196,19,8
6.0,60,0,0,46,121.0,11,82.0,61,28,65,26,22,15,125.0,137.247,837.14,121.079,20,8
6.428,60,0,0,46,121.0,11,82.0,61,28,65,26,22,15,125.0,137.247,837.14,121.079,20,8
6.0,62,0,0,47,124.0,11,83.0,62,28,66,26,22,15,128.0,140.663,851.17,123.963,21,8
6.67,70,2,2,64,154.0,16,119.0,84,48,91,46,40,20,161.0,172.954,1171.58,154.297,18,10
7.201,70,2,2,64,154.0,16,119.0,84,48,91,46,40,20,161.0,172.954,1171.58,154.297,18,10
5.149,34,0,0,28,66.0,8,46.5,32,21,36,17,21,4,70.0,74.221,426.66,64.661,11,4
6.0,26,0,0,25,56.0,3,45.5,30,21,35,17,21,5,61.0,62.77,398.55,55.454,8,4
6.0,73,2,2,63,158.0,18,119.0,85,46,92,42,38,22,165.0,178.077,1192.61,158.61,21,11
6.016,74,2,2,64,160.0,19,120.5,86,47,93,43,39,22,167.0,180.366,1203.64,160.384,21,12
6.0,69,2,2,54,146.0,17,103.5,77,35,82,32,27,23,151.0,165.456,1096.48,147.17,22,11
6.0,69,2,2,54,146.0,17,103.5,77,35,82,32,27,23,151.0,165.456,1096.48,147.17,22,11
8.161,63,2,2,48,135.0,12,95.0,72,30,76,28,22,24,139.0,153.42,1034.36,136.847,20,11
6.0,65,2,2,54,144.0,10,107.0,79,37,84,35,28,25,149.0,163.045,1124.44,146.057,19,11
8.456,69,2,2,57,148.0,14,106.5,79,37,84,36,29,22,153.0,167.084,1120.49,149.177,21,9
8.658,69,2,2,57,148.0,14,106.5,79,37,84,36,29,22,153.0,167.084,1120.49,149.177,21,9
8.638,69,2,2,57,148.0,14,106.5,79,37,84,36,29,22,153.0,167.084,1120.49,149.177,21,9
5.165,37,0,0,30,74.0,9,52.0,37,19,41,18,16,7,78.0,83.554,499.72,73.301,12,5
5.143,34,0,0,30,71.0,10,55.0,37,27,41,21,26,7,75.0,80.012,494.7,70.309,9,6
5.0,21,0,0,23,49.0,5,45.0,28,26,32,20,26,5,53.0,54.813,367.49,48.578,3,5
6.0,105,2,2,85,222.0,25,156.5,117,53,124,52,41,32,229.0,250.977,1645.17,223.686,33,13
5.0,105,2,2,85,222.0,25,156.5,117,53,124,52,41,32,229.0,250.977,1645.17,223.686,33,13
6.0,105,2,2,85,222.0,25,156.5,117,53,124,52,41,32,229.0,250.977,1645.17,223.686,33,13
8.398,68,2,2,55,145.0,14,104.0,77,36,82,34,28,22,150.0,163.958,1093.47,146.068,21,10
6.0,104,2,2,76,216.0,21,145.0,112,41,118,39,28,36,222.0,245.851,1594.1,218.551,37,16
6.0,76,2,2,66,164.0,20,123.0,88,48,95,45,40,22,171.0,184.781,1229.68,164.268,21,12
6.0,98,2,2,77,208.0,21,145.5,110,47,116,46,35,33,214.0,235.814,1556.03,210.253,31,14
9.222,78,2,2,60,163.0,18,113.0,85,37,90,35,28,25,168.0,184.825,1207.64,164.134,25,12
7.0,68,0,0,59,147.0,19,110.0,79,41,86,39,34,20,154.0,166.118,1077.37,147.915,20,10
6.0,73,2,2,62,158.0,19,119.0,85,46,92,41,38,23,165.0,178.449,1192.62,158.603,21,13
6.166,69,2,2,53,143.0,14,99.0,74,30,80,28,22,21,149.0,162.037,1052.47,143.515,25,11
6.0,75,2,2,65,163.0,19,123.0,88,47,95,43,38,23,170.0,183.702,1234.65,163.821,22,11
6.306,68,2,2,51,147.0,19,104.0,79,32,83,30,22,28,151.0,167.539,1133.47,149.363,21,14
5.0,65,2,2,49,137.0,17,95.0,72,30,76,28,22,23,141.0,155.626,1032.39,138.403,21,11
6.416,23,0,0,27,60.0,4,58.5,37,31,43,22,31,10,66.0,67.857,494.58,60.723,5,8
6.889,36,0,0,32,74.0,10,55.0,38,24,42,22,22,6,78.0,83.055,508.72,73.199,10,4
8.481,37,0,0,33,78.0,11,59.0,41,25,45,23,22,8,82.0,87.763,551.75,77.629,10,5
6.0,68,2,3,58,150.0,18,112.5,82,41,88,38,33,24,156.0,169.4,1178.96,151.494,20,11
6.253,73,2,2,63,158.0,18,119.0,85,46,92,42,38,22,165.0,178.077,1192.61,158.61,21,11
6.0,73,2,2,63,158.0,18,119.0,85,46,92,42,38,22,165.0,178.077,1192.61,158.61,21,11
5.0,27,0,0,22,55.0,7,39.0,28,16,31,13,16,6,58.0,62.106,381.52,54.891,9,3
5.0,31,0,0,24,61.0,8,41.0,30,16,33,13,16,6,64.0,68.936,409.58,60.658,11,3
5.0,24,0,1,21,51.0,6,38.0,27,16,30,13,16,6,54.0,57.425,385.93,51.003,8,3
5.0,27,0,0,22,54.0,6,38.0,27,16,30,13,16,5,57.0,60.896,365.52,53.563,9,3
5.0,31,1,1,23,65.0,9,47.0,34,18,37,13,16,11,68.0,73.856,489.66,65.709,10,5
5.0,25,0,0,21,52.0,6,38.0,27,16,30,13,16,6,55.0,58.69,367.49,52.007,8,3
4.82,32,0,0,26,66.0,4,47.0,34,15,38,13,12,8,70.0,74.644,464.62,66.087,13,4
5.44,27,0,1,26,62.0,2,52.0,35,21,41,15,20,9,68.0,69.817,535.49,62.214,11,6
5.09,30,0,1,26,64.0,2,48.0,34,14,39,14,10,8,69.0,72.15,524.51,63.88,12,5
5.25,27,0,1,26,62.0,2,52.0,35,21,41,15,20,9,68.0,69.817,535.49,62.214,11,6
6.385,68,0,0,51,139.0,17,94.0,71,30,75,29,22,20,143.0,158.118,981.29,139.915,22,10
6.851,70,0,0,56,145.0,18,102.0,75,36,80,35,28,19,150.0,164.324,1027.36,145.472,21,10
5.31,30,0,1,26,64.0,2,48.0,34,14,39,14,10,8,69.0,72.15,524.51,63.88,12,5
7.215,79,2,2,66,170.0,18,123.5,91,44,97,43,35,25,176.0,191.951,1282.7,171.243,23,11
6.0,64,2,2,48,136.0,17,95.0,72,30,76,27,22,24,140.0,154.709,1033.38,137.621,21,12
6.0,66,2,2,50,138.0,17,95.0,72,30,76,28,22,22,142.0,156.543,1031.4,139.185,22,10
6.0,98,2,2,77,210.0,22,149.0,112,47,119,45,34,35,217.0,238.396,1584.05,212.573,32,16
6.214,103,2,3,75,212.0,18,141.0,109,40,115,38,28,34,218.0,240.943,1659.98,213.639,37,16
9.301,90,2,2,67,189.0,20,129.0,99,39,104,37,28,32,194.0,214.944,1411.85,191.392,30,14
6.0,111,2,2,83,227.0,27,151.5,116,47,122,46,35,33,233.0,257.595,1639.23,228.329,37,15
6.379,108,2,2,84,226.0,25,157.0,118,52,125,50,40,34,233.0,256.262,1662.22,227.664,34,16
5.904,69,2,2,59,154.0,18,115.5,85,41,91,37,33,26,160.0,175.179,1211.54,156.366,22,12
8.161,70,2,2,57,149.0,14,106.5,79,37,84,36,29,22,154.0,168.373,1119.51,149.952,21,10
8.62,72,2,2,58,157.0,17,114.0,85,38,90,36,28,27,162.0,177.998,1209.56,159.137,22,12
8.06,70,2,2,57,149.0,14,106.5,79,37,84,36,29,22,154.0,168.373,1119.51,149.952,21,10
6.0,96,2,3,75,206.0,22,145.0,110,46,116,44,34,35,212.0,233.618,1670.9,208.541,31,15
6.0,73,2,2,63,158.0,18,119.0,85,46,92,42,38,22,165.0,178.077,1192.61,158.61,21,11
8.921,72,2,2,58,156.0,16,113.0,84,38,89,36,28,26,161.0,176.788,1193.56,157.81,22,12
6.3,68,0,0,59,146.0,19,109.0,78,41,85,39,34,19,153.0,164.908,1061.37,146.588,20,10
6.391,67,2,2,54,143.0,14,103.0,76,36,81,34,28,22,148.0,161.832,1078.46,143.959,20,11
6.0,71,2,2,59,153.0,18,112.5,82,41,88,38,33,23,159.0,172.871,1158.55,154.054,21,11
6.361,66,2,4,54,144.0,18,105.0,78,36,83,33,28,24,149.0,162.562,1329.26,144.872,21,12
9.076,62,2,2,48,132.0,12,93.0,70,30,74,28,22,22,136.0,149.712,1003.34,133.417,20,10
6.0,69,2,2,57,148.0,14,106.5,79,37,84,36,29,22,153.0,167.084,1120.49,149.177,21,9
8.495,79,2,2,65,172.0,20,126.0,93,44,99,42,34,28,178.0,194.742,1314.71,173.89,23,13
6.8,70,2,2,57,150.0,18,110.0,80,40,86,36,32,23,156.0,169.745,1131.53,150.945,21,12
5.38,67,0,0,58,142.0,17,105.0,75,41,81,39,34,17,148.0,160.201,1018.34,142.159,19,9
6.0,79,2,2,68,169.0,21,125.0,90,48,97,46,40,22,176.0,190.323,1258.72,169.261,22,11
6.0,99,2,2,77,206.0,21,141.5,107,46,113,45,35,30,212.0,233.313,1511.03,207.381,32,13
6.0,98,2,2,75,204.0,22,140.0,106,45,112,43,34,31,210.0,231.396,1500.01,205.599,32,14
6.0,105,2,2,83,222.0,25,156.0,117,52,124,50,40,34,229.0,251.558,1649.17,224.006,33,15
6.74,67,2,2,50,140.0,17,96.0,73,30,77,28,22,23,144.0,159.041,1046.42,141.286,22,11
6.031,84,2,2,67,176.0,19,124.0,92,43,98,41,34,25,182.0,199.07,1297.77,176.784,26,12
6.0,104,2,2,76,216.0,21,145.0,112,41,118,39,28,36,222.0,245.851,1594.1,218.551,37,16
6.573,90,2,2,71,192.0,19,136.0,102,45,108,43,34,31,198.0,217.735,1443.89,194.064,28,14
8.886,66,2,2,54,142.0,14,103.0,76,36,81,34,28,22,147.0,160.543,1079.44,143.185,20,10
6.585,48,0,0,40,98.0,20,69.0,50,28,55,24,28,10,103.0,110.384,680.92,97.81,16,4
8.62,78,2,2,64,168.0,19,122.0,90,43,96,41,34,26,174.0,190.034,1271.68,169.461,23,12
6.0,75,2,2,65,162.0,19,121.5,87,47,94,44,39,22,169.0,182.492,1218.65,162.494,21,11
6.0,98,2,2,77,210.0,22,149.0,112,47,119,45,34,35,217.0,238.396,1584.05,212.573,32,16
6.0,64,1,1,49,135.0,17,94.0,71,30,75,28,22,22,139.0,153.417,1001.3,136.552,21,10
8.745,66,2,2,54,142.0,14,103.0,76,36,81,34,28,22,147.0,160.543,1079.44,143.185,20,10
6.199,71,2,2,59,153.0,18,112.5,82,41,88,38,33,23,159.0,172.871,1158.55,154.054,21,11
6.67,70,0,0,51,141.0,17,93.0,71,29,75,27,22,20,145.0,160.533,983.31,141.799,24,10
8.7,100,2,2,70,209.0,24,139.0,109,37,113,35,22,39,213.0,238.811,1562.02,212.432,35,18
8.268,67,2,2,55,146.0,14,107.0,79,37,84,35,28,24,151.0,165.25,1122.47,147.614,20,11
8.745,66,2,2,54,142.0,14,103.0,76,36,81,34,28,22,147.0,160.543,1079.44,143.185,20,10
6.0,96,2,2,74,202.0,21,140.0,106,45,112,43,34,32,208.0,229.19,1501.98,204.042,31,14
6.0,98,2,2,75,204.0,21,140.0,106,45,112,43,34,31,210.0,231.396,1500.01,205.599,32,14
5.0,89,2,2,72,195.0,19,143.5,106,50,113,45,39,34,202.0,221.399,1496.92,197.603,27,17
6.0,75,3,3,62,161.0,20,117.5,86,41,93,37,33,24,168.0,182.041,1231.7,161.857,25,12
6.0,109,2,2,83,229.0,22,158.0,120,48,127,46,34,37,236.0,260.18,1697.23,231.42,37,17
6.0,100,2,2,72,205.0,25,136.0,105,40,110,38,28,33,210.0,233.392,1494.02,206.802,34,16
5.983,73,2,2,63,158.0,19,119.0,85,46,92,41,38,22,165.0,178.077,1192.61,158.61,22,11
6.0,60,2,2,43,125.0,14,84.0,65,24,68,22,16,22,128.0,142.297,941.27,126.534,21,10
5.77,44,0,0,35,86.0,17,57.0,42,22,46,20,22,7,90.0,96.763,572.81,85.396,15,2
6.301,51,0,0,42,101.0,20,69.0,50,28,55,26,28,8,106.0,113.507,677.96,100.148,16,3
5.871,50,0,0,42,100.0,20,69.0,50,28,55,26,28,8,105.0,112.218,678.94,99.374,16,2
5.699,50,0,0,42,100.0,20,69.0,50,28,55,26,28,8,105.0,112.218,678.94,99.374,16,2
7.0,48,0,0,39,97.0,20,67.5,49,27,54,23,27,10,102.0,109.384,668.91,96.81,16,4
5.523,42,0,0,32,83.0,17,55.5,41,21,45,17,21,9,87.0,93.929,562.78,82.832,15,4
5.699,43,0,0,33,83.0,17,52.0,40,18,43,18,18,7,86.0,93.474,549.77,82.621,15,1
6.444,49,0,0,41,99.0,20,69.0,50,28,55,25,28,9,104.0,111.301,679.93,98.592,16,3
6.051,49,0,0,41,99.0,20,69.0,50,28,55,25,28,9,104.0,111.301,679.93,98.592,16,3
5.721,50,0,0,42,100.0,20,69.0,50,28,55,26,28,8,105.0,112.218,678.94,99.374,16,2
5.921,48,0,1,41,99.0,20,70.0,51,28,56,25,28,10,104.0,111.245,714.37,98.916,16,3
5.9,51,0,0,42,102.0,20,70.0,51,28,56,25,28,9,107.0,114.716,693.96,101.476,17,3
5.0,31,0,0,28,65.0,8,49.0,34,22,38,19,22,6,69.0,73.355,458.63,64.618,9,4
6.097,49,0,0,39,99.0,21,68.5,50,27,55,22,27,11,104.0,111.882,683.93,98.912,17,5
5.0,35,0,0,29,71.0,8,51.0,36,19,40,18,16,7,75.0,80.138,485.69,70.418,11,5
5.606,41,0,0,33,81.0,7,56.0,40,19,45,18,16,7,86.0,91.384,539.79,80.068,15,5
6.0,48,1,1,36,101.0,10,70.0,53,22,56,20,16,17,104.0,114.886,752.99,102.181,16,8
5.0,43,0,0,32,88.0,17,60.0,45,21,47,19,16,13,90.0,100.218,621.82,88.581,13,7
6.0,56,0,0,44,115.0,11,80.0,59,28,63,26,22,15,119.0,130.417,809.08,115.312,18,8
7.08,51,0,0,36,100.0,21,64.0,49,21,51,19,16,13,102.0,113.879,677.94,100.116,17,7
5.0,38,0,0,30,72.0,10,48.5,34,21,38,17,21,4,76.0,81.052,454.72,70.428,13,4
5.921,21,1,4,23,54.0,8,48.0,33,23,36,19,22,10,57.0,60.376,564.37,54.516,4,6
7.854,23,0,3,21,54.0,10,42.5,31,18,33,15,17,10,56.0,61.081,526.3,54.651,6,6
6.0,18,1,4,21,50.0,7,47.0,32,23,35,18,22,11,53.0,56.044,551.33,50.851,3,7
5.854,27,1,4,23,60.0,12,44.5,33,18,35,15,17,10,62.0,67.622,570.43,60.167,8,6
6.754,23,1,3,21,56.0,11,46.5,33,20,35,15,17,12,58.0,63.452,508.48,57.043,6,7
5.0,31,1,1,25,63.0,9,46.0,32,21,35,15,20,7,66.0,71.019,449.68,62.4,10,5
5.495,56,0,0,44,115.0,11,80.0,59,28,63,26,22,15,119.0,130.417,809.08,115.312,18,8
6.879,29,1,4,24,63.0,13,45.5,34,18,36,15,17,10,65.0,71.037,584.46,63.051,9,6
6.928,27,1,2,22,57.0,11,41.5,30,18,32,15,17,8,59.0,64.319,487.52,56.636,7,6
5.416,22,0,1,26,54.0,7,50.5,32,28,36,24,27,6,58.0,60.172,439.98,53.785,2,5
7.131,25,1,1,25,58.0,9,50.0,33,26,37,19,26,8,62.0,65.402,460.63,58.036,6,6
6.64,57,2,2,45,122.0,12,87.0,65,29,69,27,22,20,126.0,138.174,932.25,123.221,18,9
5.177,22,0,0,27,57.0,7,53.5,35,28,39,24,27,8,61.0,64.663,473.54,57.883,3,5
5.0,27,0,0,24,57.0,6,44.5,30,22,33,18,21,6,60.0,64.268,401.56,56.556,6,5
5.0,21,0,0,26,55.0,6,52.5,34,28,38,24,27,8,59.0,62.117,457.52,55.814,2,5
6.0,57,2,2,45,122.0,12,87.0,65,29,69,27,22,20,126.0,138.174,932.25,123.221,18,9
5.3,25,0,0,27,58.0,8,51.5,33,28,37,24,27,6,62.0,64.853,435.57,57.672,3,5
5.0,23,0,0,28,59.0,7,54.5,36,28,40,24,27,8,63.0,66.789,488.55,59.992,4,4
7.137,43,0,0,40,91.0,13,70.0,48,31,53,29,28,8,96.0,102.009,641.88,90.279,11,5
6.0,61,2,2,43,127.0,15,85.0,66,24,69,22,16,23,130.0,144.795,956.29,128.636,21,11
8.886,66,2,2,54,143.0,14,104.0,77,36,82,34,28,23,148.0,161.752,1095.44,144.512,20,10
6.0,111,2,2,84,232.0,22,159.0,121,48,128,46,34,37,239.0,263.595,1711.26,234.304,38,17
6.0,67,2,2,50,140.0,17,96.0,73,30,77,28,22,23,144.0,159.041,1046.42,141.286,22,11
6.0,99,2,2,77,207.0,21,142.5,108,46,114,45,35,31,213.0,234.522,1527.03,208.708,32,13
6.0,67,2,2,50,140.0,17,96.0,73,30,77,28,22,23,144.0,159.041,1046.42,141.286,22,11
6.0,66,2,2,56,146.0,18,111.0,80,38,85,33,28,24,151.0,165.287,1127.5,147.17,21,14
6.0,74,2,2,64,160.0,19,120.5,86,47,93,43,39,22,167.0,180.366,1203.64,160.384,21,12
7.0,66,0,0,56,143.0,19,107.5,77,40,84,36,33,21,150.0,162.075,1051.34,144.025,20,12
8.959,68,2,2,55,148.0,15,108.0,80,37,85,35,28,25,153.0,167.749,1137.49,149.716,20,12
6.493,67,2,2,50,141.0,17,97.0,74,30,78,28,22,24,145.0,160.25,1062.42,142.614,22,11
6.155,98,2,3,75,206.0,21,142.0,108,45,114,43,34,33,212.0,233.615,1640.92,207.77,32,15
6.839,78,3,3,66,167.0,20,124.0,89,46,97,41,38,23,175.0,188.116,1263.77,167.228,25,12
6.0,69,2,2,58,150.0,18,111.5,81,41,87,37,33,23,156.0,169.875,1145.53,151.13,21,12
6.0,67,2,3,57,148.0,18,111.5,81,41,87,37,33,24,154.0,167.274,1163.95,149.385,20,12
6.0,106,2,2,83,223.0,25,156.0,117,52,124,50,40,34,230.0,252.847,1648.19,224.78,33,16
6.0,96,2,2,74,201.0,21,139.0,105,45,111,43,34,31,207.0,227.98,1485.98,202.715,31,14
9.0,73,2,2,58,156.0,15,111.0,83,37,88,35,28,25,161.0,176.705,1180.56,157.592,23,11
6.0,95,2,3,74,202.0,21,141.0,107,45,113,43,34,33,208.0,228.91,1627.87,204.112,31,14
8.284,67,2,2,55,146.0,14,107.0,79,37,84,35,28,24,151.0,165.25,1122.47,147.614,20,11
6.0,99,2,3,73,206.0,18,139.0,107,40,113,38,28,34,212.0,234.113,1631.92,207.871,35,16
6.0,100,2,2,74,210.0,21,143.0,110,41,116,39,28,36,216.0,239.02,1566.04,212.784,35,16
7.928,69,2,2,57,148.0,14,106.5,79,37,84,36,29,22,153.0,167.084,1120.49,149.177,21,9
7.125,30,0,0,25,61.0,8,44.0,31,18,34,16,16,6,64.0,68.81,418.59,60.549,9,4
5.0,29,0,0,23,58.0,8,40.0,29,16,32,13,16,6,61.0,65.521,395.55,57.774,10,3
5.0,31,0,0,25,62.0,7,43.0,31,16,35,13,16,6,66.0,69.936,421.59,61.658,12,3
5.0,24,0,0,21,51.0,6,38.0,27,16,30,13,16,6,54.0,57.821,369.48,51.192,8,3
5.0,28,1,1,22,60.0,8,45.0,32,18,35,13,16,10,63.0,67.943,460.61,60.723,9,4
6.0,110,2,2,81,225.0,27,150.0,115,46,121,44,34,34,231.0,255.678,1628.21,226.548,37,16
8.745,68,2,2,55,145.0,14,104.0,77,36,82,34,28,22,150.0,163.958,1093.47,146.068,21,10
8.252,73,2,2,58,156.0,16,111.0,83,37,88,35,28,25,161.0,176.705,1180.56,157.592,23,11
6.0,72,2,2,61,155.0,15,114.0,83,42,89,40,34,22,161.0,174.788,1169.57,155.835,21,10
6.0,67,2,2,50,140.0,17,96.0,73,30,77,28,22,23,144.0,159.041,1046.42,141.286,22,11
6.0,75,3,3,65,162.0,18,123.0,87,47,95,43,38,22,170.0,182.203,1234.72,162.243,22,11
8.959,67,2,2,54,145.0,14,105.0,78,36,83,34,28,24,150.0,164.25,1110.46,146.614,20,11
6.0,106,2,2,85,224.0,25,157.5,118,53,125,52,41,33,231.0,253.475,1660.19,225.788,33,14
8.155,74,0,0,60,156.0,15,113.0,82,41,88,37,32,22,162.0,176.945,1123.46,156.886,23,12
7.0,69,2,2,57,148.0,15,109.0,79,40,85,36,32,22,154.0,167.247,1116.51,148.843,21,11
6.0,105,2,2,81,223.0,22,156.0,118,48,125,46,34,37,230.0,253.349,1669.17,225.653,35,17
6.0,66,2,2,54,144.0,18,105.0,78,36,83,33,28,24,149.0,163.8,1113.46,145.759,21,12
6.0,99,2,2,75,206.0,21,141.0,107,45,113,43,34,32,212.0,233.894,1515.03,207.701,32,15
6.0,70,2,2,58,150.0,18,110.5,80,41,86,37,33,22,156.0,169.536,1127.54,150.617,21,12
7.209,83,2,2,71,179.0,18,134.5,96,52,104,47,43,25,187.0,201.944,1342.81,179.675,24,13
8.745,68,2,3,57,147.0,14,106.5,79,37,84,36,29,22,152.0,165.595,1230.38,147.919,21,9
9.046,77,2,2,64,166.0,18,121.0,89,43,95,41,34,25,172.0,187.536,1256.66,167.359,23,11
6.876,67,2,2,55,146.0,14,107.0,79,37,84,35,28,24,151.0,165.25,1122.47,147.614,20,11
6.0,65,2,2,52,142.0,18,103.5,77,35,82,31,27,25,147.0,161.883,1102.44,143.977,21,13
6.0,99,2,2,77,206.0,21,141.5,107,46,113,45,35,30,212.0,233.313,1511.03,207.381,32,13
6.173,76,2,2,64,162.0,20,120.0,86,46,93,41,38,22,169.0,182.781,1205.66,162.268,23,12
8.585,79,2,2,65,172.0,20,126.0,93,44,99,42,34,28,178.0,194.742,1314.71,173.89,23,13
6.0,102,2,2,79,216.0,22,151.0,114,47,121,45,34,35,223.0,245.226,1612.11,218.341,34,16
8.959,71,2,2,57,153.0,16,110.0,82,37,87,35,28,25,158.0,173.29,1166.53,154.708,22,11
9.155,66,2,2,54,142.0,14,103.0,76,36,81,34,28,22,147.0,160.543,1079.44,143.185,20,10
9.155,66,2,2,54,142.0,14,103.0,76,36,81,34,28,22,147.0,160.543,1079.44,143.185,20,10
8.386,70,2,2,57,150.0,15,110.0,80,40,86,36,32,23,156.0,169.745,1131.53,150.945,21,12
9.7,103,2,2,75,215.0,24,145.0,112,42,117,40,28,37,220.0,244.934,1595.09,217.77,35,17
9.292,66,2,2,54,143.0,14,104.0,77,36,82,34,28,23,148.0,161.752,1095.44,144.512,20,10
6.0,102,2,2,79,216.0,22,151.0,114,47,121,45,34,35,223.0,245.226,1612.11,218.341,34,16
6.0,97,2,3,75,205.0,21,142.0,108,45,114,43,34,33,211.0,232.326,1641.9,206.995,32,14
5.0,96,2,2,74,202.0,21,140.0,106,45,112,43,34,32,208.0,229.19,1501.98,204.042,31,14
6.0,99,2,2,77,206.0,21,141.5,107,46,113,45,35,30,212.0,233.313,1511.03,207.381,32,13
6.0,72,2,2,62,156.0,18,118.0,84,46,91,41,38,22,163.0,175.951,1177.6,156.501,21,12
6.0,66,2,2,54,144.0,18,105.0,78,36,83,33,28,24,149.0,163.8,1113.46,145.759,21,12
6.0,67,2,2,50,140.0,17,96.0,73,30,77,28,22,23,144.0,159.041,1046.42,141.286,22,11
5.0,102,2,2,78,215.0,23,149.0,113,47,119,45,34,35,221.0,244.226,1600.1,217.341,33,16
8.824,68,2,2,55,148.0,15,108.0,80,37,85,35,28,25,153.0,167.749,1137.49,149.716,20,12
6.0,54,0,0,44,114.0,11,82.0,60,28,65,26,22,16,119.0,129.211,823.06,114.756,18,8
6.072,65,2,2,52,142.0,18,103.5,77,35,82,31,27,25,147.0,161.883,1102.44,143.977,21,13
6.0,67,2,2,50,140.0,18,96.0,73,30,77,28,22,23,144.0,159.041,1046.42,141.286,22,11
8.745,66,2,2,54,143.0,14,104.0,77,36,82,34,28,23,148.0,161.752,1095.44,144.512,20,10
7.678,68,2,3,57,147.0,14,106.5,79,37,84,36,29,22,152.0,165.595,1230.38,147.919,21,9
6.0,96,2,2,74,201.0,21,139.0,105,45,111,43,34,31,207.0,227.98,1485.98,202.715,31,14
6.0,70,2,2,54,144.0,15,99.5,74,34,79,31,27,20,149.0,162.954,1051.48,144.297,23,10
5.785,72,3,5,58,155.0,20,111.0,83,36,89,33,28,25,161.0,175.174,1232.53,156.108,25,12
8.77,98,2,2,72,205.0,24,139.0,107,41,112,39,28,35,210.0,233.396,1524.0,207.573,33,16
6.0,67,2,3,57,148.0,18,111.5,81,41,87,37,33,24,154.0,167.274,1163.95,149.385,20,12
6.0,92,2,2,65,191.0,26,126.0,99,33,104,31,22,34,196.0,217.778,1421.85,193.93,34,14
8.754,104,2,2,76,219.0,26,149.0,115,43,120,41,28,39,224.0,249.642,1638.12,222.199,35,18
7.0,67,2,2,56,145.0,15,108.0,78,40,84,36,32,22,151.0,163.832,1102.48,145.959,20,11
6.0,99,2,2,77,206.0,22,141.5,107,46,113,45,35,30,212.0,233.313,1511.03,207.381,32,13
6.0,97,2,2,75,206.0,22,144.0,109,46,115,44,34,34,212.0,233.898,1545.01,208.472,31,15
6.0,65,2,2,49,137.0,17,95.0,72,30,76,28,22,23,141.0,155.626,1032.39,138.403,21,11
6.0,77,2,2,67,166.0,20,124.0,89,48,96,46,40,22,173.0,186.908,1244.69,166.377,21,11
6.0,97,2,2,76,203.0,21,140.5,106,46,112,45,35,30,209.0,229.897,1497.0,204.497,31,13
7.0,72,0,0,61,152.0,20,111.0,80,41,87,39,34,19,159.0,171.739,1089.43,152.355,22,10
5.804,66,2,2,59,147.0,17,115.0,81,46,88,41,38,22,154.0,165.705,1135.51,147.85,18,12
6.241,67,2,2,50,140.0,17,96.0,73,30,77,28,22,23,144.0,159.041,1046.42,141.286,22,11
8.886,66,2,2,54,143.0,14,104.0,77,36,82,34,28,23,148.0,161.752,1095.44,144.512,20,10
8.77,98,2,2,72,205.0,24,139.0,107,41,112,39,28,35,210.0,233.396,1524.0,207.573,33,16
6.0,110,2,2,83,228.0,22,155.0,118,47,125,45,34,35,235.0,258.887,1668.23,229.875,38,16
6.0,72,2,2,61,156.0,17,115.0,84,42,90,40,34,23,162.0,175.998,1185.57,157.163,21,10
6.0,134,2,2,93,267.0,39,170.0,133,48,139,46,34,40,273.0,304.242,1884.61,268.445,47,20
6.0,108,2,2,82,225.0,22,154.0,117,47,124,45,34,35,232.0,255.472,1654.2,226.991,37,16
6.121,70,2,2,58,151.0,18,111.5,81,41,87,37,33,23,157.0,170.745,1143.54,151.945,21,12
9.076,62,2,2,48,132.0,12,93.0,70,30,74,28,22,22,136.0,149.712,1003.34,133.417,20,10
6.0,98,2,2,72,203.0,18,137.0,105,40,111,38,28,33,209.0,230.977,1492.0,204.919,34,16
5.0,99,2,2,76,207.0,23,142.5,108,46,114,44,35,32,213.0,234.894,1527.04,208.701,32,15
8.854,79,2,2,62,170.0,17,121.0,91,39,96,37,28,29,175.0,192.951,1294.68,172.217,25,13
6.18,98,2,3,77,209.0,21,146.5,111,47,117,46,35,34,215.0,236.824,1680.94,211.097,31,15
6.0,135,2,2,95,269.0,39,171.5,134,49,140,48,35,39,275.0,306.159,1895.63,270.227,47,19
6.138,74,2,2,63,159.0,19,119.0,85,46,92,41,38,22,166.0,179.366,1191.63,159.384,22,12
7.523,68,2,3,57,147.0,14,106.5,79,37,84,36,29,22,152.0,165.595,1230.38,147.919,21,9
7.445,79,2,2,66,170.0,19,126.0,91,47,98,43,38,25,177.0,192.114,1278.72,170.908,23,13
8.796,75,2,2,63,163.0,18,120.0,88,43,94,41,34,25,169.0,184.121,1242.63,164.475,22,11
6.0,97,2,2,76,203.0,21,140.5,106,46,112,45,35,30,209.0,229.897,1497.0,204.497,31,13
8.921,77,2,2,64,169.0,19,125.0,92,44,98,42,34,28,175.0,191.327,1300.68,171.006,22,13
7.387,67,2,2,56,144.0,14,104.5,77,37,82,36,29,21,149.0,162.46,1090.46,144.966,20,9
8.456,70,2,3,57,153.0,16,111.0,83,37,88,35,28,26,158.0,173.011,1292.42,154.777,22,11
9.7,106,2,2,77,222.0,26,150.0,116,43,121,41,28,39,227.0,253.057,1652.15,225.082,36,18
8.456,96,2,2,71,202.0,22,138.0,106,41,111,39,28,35,207.0,229.981,1509.97,204.69,32,16
5.0,106,2,2,79,216.0,24,144.0,110,45,116,43,34,31,222.0,245.056,1556.13,217.133,36,14
6.0,101,2,3,74,209.0,18,140.0,108,40,114,38,28,34,215.0,237.528,1645.95,210.755,36,16
6.0,105,2,2,83,222.0,25,156.0,117,52,124,50,40,34,229.0,251.558,1649.17,224.006,33,15
6.0,107,2,2,82,226.0,22,157.0,119,48,126,46,34,37,233.0,256.764,1683.2,228.537,36,17
6.815,67,2,2,55,146.0,14,107.0,79,37,84,35,28,24,151.0,165.25,1122.47,147.614,20,11
6.0,99,2,2,68,205.0,24,133.0,106,33,109,33,18,38,208.0,234.313,1522.98,208.33,35,17
6.0,100,2,2,74,210.0,21,143.0,110,41,116,39,28,36,216.0,239.02,1566.04,212.784,35,16
9.5,97,2,2,73,208.0,22,145.0,111,43,116,41,28,38,213.0,236.898,1581.01,211.446,32,17
7.0,66,0,0,58,143.0,18,108.0,77,41,84,39,34,19,150.0,161.493,1047.34,143.705,19,10
6.0,65,2,2,52,142.0,18,103.5,77,35,82,31,27,25,147.0,161.883,1102.44,143.977,21,13
6.668,103,2,3,75,212.0,18,141.0,109,40,115,38,28,34,218.0,240.943,1659.98,213.639,37,16
6.0,98,2,2,75,205.0,21,141.0,107,45,113,43,34,32,211.0,232.605,1516.01,206.926,32,14
6.059,68,2,2,51,147.0,19,104.0,79,32,83,30,22,28,151.0,167.539,1133.47,149.363,21,14
8.638,85,2,2,68,181.0,21,129.0,96,44,102,42,34,28,187.0,204.987,1356.8,182.541,26,13
8.523,68,2,2,55,149.0,15,109.0,81,37,86,35,28,26,154.0,168.958,1153.49,151.043,20,12
9.009,62,2,2,48,132.0,12,93.0,70,30,74,28,22,22,136.0,149.712,1003.34,133.417,20,10
6.0,67,2,2,50,140.0,17,96.0,73,30,77,28,22,23,144.0,159.041,1046.42,141.286,22,11
6.0,122,2,2,87,246.0,33,160.0,124,47,130,45,34,37,252.0,279.96,1756.41,247.497,42,18
6.0,109,2,2,83,229.0,22,158.0,120,48,127,46,34,37,236.0,260.18,1697.23,231.42,37,17
6.0,72,2,2,61,156.0,17,115.0,84,42,90,40,34,23,162.0,175.998,1185.57,157.163,21,10
6.0,66,2,2,54,144.0,18,105.0,78,36,83,33,28,24,149.0,163.8,1113.46,145.759,21,12
6.0,88,2,2,74,190.0,20,139.0,102,50,109,48,40,28,197.0,214.529,1433.88,191.533,26,12
5.0,93,2,2,74,197.0,20,138.5,104,46,110,45,35,30,203.0,223.067,1468.94,198.73,29,13
8.638,85,2,2,68,181.0,21,129.0,96,44,102,42,34,28,187.0,204.987,1356.8,182.541,26,13
6.0,74,2,2,64,160.0,19,120.5,86,47,93,43,39,22,167.0,180.366,1203.64,160.384,21,12
6.754,58,2,2,54,144.0,18,113.0,86,36,91,33,28,32,149.0,166.517,1257.38,149.861,21,12
5.58,67,0,0,58,142.0,17,105.0,75,41,81,39,34,17,148.0,160.201,1018.34,142.159,19,9
6.0,96,2,2,76,205.0,22,145.5,109,48,115,45,35,33,211.0,232.399,1542.0,207.37,31,14
6.0,110,2,2,83,228.0,22,155.0,118,47,125,45,34,35,235.0,258.887,1668.23,229.875,38,16
6.0,96,2,3,74,203.0,21,141.0,107,45,113,43,34,33,209.0,230.199,1626.89,204.886,31,15
6.312,106,2,2,84,226.0,26,160.0,120,53,127,51,40,36,233.0,256.266,1692.2,228.435,33,16
6.0,98,2,2,75,204.0,21,140.0,106,45,112,43,34,31,210.0,231.396,1500.01,205.599,32,14
8.854,104,2,2,76,219.0,22,149.0,115,43,120,41,28,39,224.0,249.642,1638.12,222.199,35,18
6.0,56,0,0,44,115.0,11,80.0,59,28,63,26,22,15,119.0,130.417,809.08,115.312,18,8
8.854,67,2,2,56,145.0,14,105.5,78,37,83,36,29,22,150.0,163.669,1106.46,146.294,20,9
6.0,64,2,2,48,136.0,17,95.0,72,30,76,27,22,24,140.0,154.709,1033.38,137.621,21,12
6.0,72,2,3,63,158.0,18,120.0,86,46,93,42,38,23,165.0,177.798,1318.5,158.679,21,11
7.305,72,2,2,58,153.0,15,111.0,81,40,87,36,32,23,159.0,173.16,1145.56,153.828,22,12
6.5,62,0,0,56,134.0,15,102.0,72,40,79,38,34,16,141.0,150.872,975.26,134.29,18,8
6.452,67,2,2,50,141.0,17,97.0,74,30,78,28,22,24,145.0,160.25,1062.42,142.614,22,11
6.0,106,2,2,81,222.0,22,153.0,116,47,123,45,34,35,229.0,252.057,1640.17,224.108,36,16
7.004,108,2,2,82,225.0,22,154.0,117,47,124,45,34,35,232.0,255.472,1654.2,226.991,37,16
6.0,100,2,2,73,206.0,18,138.0,106,40,112,38,28,33,212.0,234.392,1506.03,207.802,35,16
6.0,100,2,2,74,210.0,21,143.0,110,41,116,39,28,36,216.0,239.02,1566.04,212.784,35,16
6.0,68,2,2,60,150.0,17,116.0,82,46,89,41,38,22,157.0,169.12,1149.54,150.734,19,12
6.0,69,2,2,54,146.0,17,103.5,77,35,82,32,27,23,151.0,165.456,1096.48,147.17,22,11
8.456,69,2,2,57,148.0,14,106.5,79,37,84,36,29,22,153.0,167.084,1120.49,149.177,21,9
9.009,62,2,2,48,132.0,12,93.0,70,30,74,28,22,22,136.0,149.712,1003.34,133.417,20,10
6.0,72,2,2,62,156.0,18,118.0,84,46,91,41,38,22,163.0,175.951,1177.6,156.501,21,12
7.921,68,2,3,57,147.0,14,106.5,79,37,84,36,29,22,152.0,165.595,1230.38,147.919,21,9
6.979,69,2,2,57,148.0,14,106.5,79,37,84,36,29,22,153.0,167.084,1120.49,149.177,21,9
6.0,96,2,2,74,201.0,21,139.0,105,45,111,43,34,31,207.0,227.98,1485.98,202.715,31,14
6.0,57,2,2,52,142.0,18,111.5,85,35,90,31,27,33,147.0,164.601,1246.36,148.079,21,13
6.611,107,2,2,84,225.0,25,157.0,118,52,125,50,40,34,232.0,254.974,1663.2,226.89,34,15
6.0,98,2,2,75,204.0,21,140.0,106,45,112,43,34,31,210.0,231.396,1500.01,205.599,32,14
6.0,97,2,2,74,203.0,21,140.0,106,45,112,43,34,32,209.0,230.479,1501.0,204.817,31,15
6.0,106,2,2,84,226.0,26,160.0,120,53,127,51,40,36,233.0,256.266,1692.2,228.435,33,16
8.921,67,2,2,56,145.0,14,105.5,78,37,83,36,29,22,150.0,163.669,1106.46,146.294,20,9
10.0,104,2,2,76,218.0,25,148.0,114,43,119,41,28,38,223.0,248.432,1622.12,220.871,35,18
6.0,97,2,2,73,208.0,22,145.0,111,43,116,41,28,38,213.0,236.898,1581.01,211.446,32,17
6.0,99,2,2,77,206.0,21,141.5,107,46,113,45,35,30,212.0,233.313,1511.03,207.381,32,13
6.112,107,2,3,84,226.0,25,158.0,119,52,126,50,40,35,233.0,255.983,1788.11,227.733,34,16
6.0,69,2,2,58,150.0,18,111.5,81,41,87,37,33,23,156.0,169.875,1145.53,151.13,21,12
6.0,69,2,2,54,146.0,17,103.5,77,35,82,32,27,23,151.0,165.456,1096.48,147.17,22,11
8.009,79,2,2,66,170.0,18,123.5,91,44,97,43,35,25,176.0,191.951,1282.7,171.243,23,11
6.0,79,3,3,65,168.0,21,124.5,89,46,97,40,37,24,176.0,189.615,1266.78,168.33,25,13
9.276,69,2,2,57,148.0,14,106.5,79,37,84,36,29,22,153.0,167.084,1120.49,149.177,21,9
8.036,69,2,2,57,148.0,14,106.5,79,37,84,36,29,22,153.0,167.084,1120.49,149.177,21,9
6.0,82,0,1,75,178.0,32,137.0,96,58,104,54,50,21,186.0,200.257,1317.13,178.199,21,11
6.0,65,2,2,49,137.0,17,95.0,72,30,76,28,22,23,141.0,155.626,1032.39,138.403,21,11
4.0,51,0,0,36,100.0,21,64.0,49,21,51,19,16,13,102.0,113.879,677.94,100.116,17,7
5.05,54,0,0,44,113.0,11,81.0,59,28,64,26,22,15,118.0,128.002,807.06,113.428,18,8
6.0,57,2,2,45,122.0,14,87.0,65,29,69,27,22,20,126.0,138.174,932.25,123.221,18,9
6.947,29,1,2,24,61.0,12,44.0,32,19,34,17,18,8,63.0,68.734,513.56,60.52,7,6
8.745,66,2,2,54,142.0,14,103.0,76,36,81,34,28,22,147.0,160.543,1079.44,143.185,20,10
6.646,98,2,2,75,204.0,21,140.0,106,45,112,43,34,31,210.0,231.396,1500.01,205.599,32,14
6.0,151,0,0,119,312.0,34,217.0,161,73,172,69,56,42,323.0,353.85,2211.91,313.445,50,21
6.0,71,2,2,52,146.0,17,98.0,75,30,79,28,22,23,150.0,165.871,1074.48,147.054,24,11
6.0,98,2,2,75,204.0,22,140.0,106,45,112,43,34,31,210.0,231.396,1500.01,205.599,32,14
6.0,99,2,2,77,206.0,21,141.5,107,46,113,45,35,30,212.0,233.313,1511.03,207.381,32,13
5.33,65,0,0,57,139.0,17,104.0,74,41,80,39,34,17,145.0,156.786,1004.31,139.275,18,9
8.699,71,2,2,57,153.0,16,110.0,82,37,87,35,28,25,158.0,173.29,1166.53,154.708,22,11
9.26,69,2,2,57,148.0,14,106.5,79,37,84,36,29,22,153.0,167.084,1120.49,149.177,21,9
6.25,98,2,2,77,208.0,21,145.5,110,47,116,46,35,33,214.0,235.814,1556.03,210.253,31,14
6.0,105,2,3,84,226.0,26,161.0,121,53,128,51,40,37,233.0,255.987,1818.09,228.504,33,16
6.0,82,0,1,75,178.0,32,137.0,96,58,104,54,50,21,186.0,200.257,1317.13,178.199,21,11
6.0,111,2,2,84,232.0,22,159.0,121,48,128,46,34,37,239.0,263.595,1711.26,234.304,38,17
5.522,75,2,2,64,162.0,20,121.5,87,47,94,43,39,23,169.0,182.864,1218.66,162.486,21,13
6.0,99,2,2,77,206.0,21,141.5,107,46,113,45,35,30,212.0,233.313,1511.03,207.381,32,13
7.0,54,0,0,44,113.0,11,81.0,59,28,64,26,22,15,118.0,128.002,807.06,113.428,18,8
7.276,27,1,4,23,60.0,12,44.5,33,18,35,15,17,10,62.0,67.622,570.43,60.167,8,6
6.097,28,1,1,27,63.0,10,53.0,35,27,39,20,26,8,67.0,70.686,484.68,62.734,7,6
5.854,42,0,0,32,84.0,8,57.0,42,18,47,16,16,10,89.0,95.301,574.8,83.825,16,6
6.0,65,1,1,49,136.0,17,94.0,71,30,75,28,22,22,140.0,154.706,1000.32,137.326,21,11
5.0,96,2,2,74,202.0,21,140.0,106,45,112,43,34,32,208.0,229.19,1501.98,204.042,31,14
6.0,70,2,2,52,151.0,20,106.0,81,32,85,30,22,29,155.0,172.164,1163.5,153.574,22,14
8.481,78,2,2,61,167.0,16,118.0,89,38,94,36,28,28,172.0,189.453,1267.65,169.115,25,12
6.052,75,3,3,62,161.0,20,117.5,86,41,93,37,33,24,168.0,182.041,1231.7,161.857,25,12
7.1,100,2,2,70,209.0,24,139.0,109,37,113,35,22,39,213.0,238.811,1562.02,212.432,35,18
8.921,67,2,2,54,144.0,14,104.0,77,36,82,34,28,23,149.0,163.041,1094.46,145.286,20,11
6.025,71,2,2,60,154.0,18,116.5,83,45,90,39,37,23,161.0,174.034,1166.58,154.719,21,13
8.721,76,2,2,63,165.0,18,121.0,89,43,95,41,34,26,171.0,186.619,1257.65,166.577,22,12
6.0,67,2,2,50,141.0,17,97.0,74,30,78,28,22,24,145.0,160.25,1062.42,142.614,22,11
5.799,69,2,3,58,150.0,18,111.5,81,41,87,37,33,23,156.0,169.48,1161.98,150.941,21,12
6.0,101,2,3,74,209.0,18,140.0,108,40,114,38,28,34,215.0,237.528,1645.95,210.755,36,16
5.541,72,3,5,58,155.0,20,111.0,83,36,89,33,28,25,161.0,175.174,1232.53,156.108,25,12
5.48,66,2,4,54,144.0,18,105.0,78,36,83,33,28,24,149.0,162.804,1235.26,145.192,21,12
6.0,91,2,2,73,194.0,19,137.5,103,46,109,45,35,30,200.0,219.652,1454.91,195.846,28,13
6.0,100,2,2,74,210.0,21,143.0,110,41,116,39,28,36,216.0,239.02,1566.04,212.784,35,16
8.056,76,2,3,64,169.0,19,126.0,93,44,99,42,34,29,175.0,191.047,1426.57,171.075,22,13
6.38,99,2,2,77,206.0,21,141.5,107,46,113,45,35,30,212.0,233.313,1511.03,207.381,32,13
8.4,102,2,2,75,215.0,25,147.0,113,43,118,41,28,38,220.0,245.017,1608.09,217.988,34,18
9.0,100,2,2,70,209.0,24,139.0,109,37,113,35,22,39,213.0,238.811,1562.02,212.432,35,18
6.2,74,0,0,62,155.0,22,112.0,81,41,88,39,34,19,162.0,175.154,1103.46,155.239,23,10
6.0,48,2,2,36,102.0,10,71.0,54,22,57,20,16,18,105.0,115.806,785.06,103.258,16,8
6.0,66,2,2,54,144.0,18,105.0,78,36,83,33,28,24,149.0,163.8,1113.46,145.759,21,12
6.105,59,2,2,50,128.0,13,95.0,69,35,74,33,28,19,133.0,144.38,978.32,128.777,17,9
8.367,68,2,2,55,149.0,15,109.0,81,37,86,35,28,26,154.0,168.958,1153.49,151.043,20,12
6.0,99,2,2,77,206.0,21,141.5,107,46,113,45,35,30,212.0,233.313,1511.03,207.381,32,13
8.678,77,2,2,60,165.0,20,117.0,88,38,93,36,28,28,170.0,187.327,1252.64,167.006,24,13
6.0,88,2,2,74,190.0,20,139.0,102,50,109,48,40,28,197.0,214.529,1433.88,191.533,26,12
6.048,75,3,4,62,161.0,20,117.5,86,41,93,37,33,24,168.0,181.645,1248.15,161.668,25,12
5.0,105,2,2,83,222.0,25,156.0,117,52,124,50,40,34,229.0,251.558,1649.17,224.006,33,15
9.0,67,2,2,55,147.0,15,108.0,80,37,85,35,28,25,152.0,166.46,1138.47,148.941,20,11
6.0,102,2,2,79,216.0,22,151.0,114,47,121,45,34,35,223.0,245.226,1612.11,218.341,34,16
7.0,81,2,2,67,173.0,18,127.0,92,47,99,43,38,25,180.0,195.529,1292.75,173.792,24,13
6.0,68,2,3,58,149.0,18,111.5,81,41,87,38,33,23,155.0,168.191,1162.96,150.166,20,11
8.921,76,2,2,63,165.0,18,121.0,89,43,95,41,34,26,171.0,186.619,1257.65,166.577,22,12
6.0,100,2,2,74,210.0,21,143.0,110,41,116,39,28,36,216.0,239.02,1566.04,212.784,35,16
6.0,106,2,2,81,222.0,22,153.0,116,47,123,45,34,35,229.0,252.057,1640.17,224.108,36,16
6.521,66,2,4,54,144.0,18,105.0,78,36,83,33,28,24,149.0,163.008,1146.36,145.381,21,12
6.0,99,2,2,77,206.0,21,141.5,107,46,113,45,35,30,212.0,233.313,1511.03,207.381,32,13
6.0,65,2,2,51,139.0,13,99.0,74,30,80,28,22,23,145.0,157.626,1056.41,140.403,23,11
6.0,67,2,2,50,140.0,17,96.0,73,30,77,28,22,23,144.0,159.041,1046.42,141.286,22,11
9.056,67,2,2,54,144.0,14,104.0,77,36,82,34,28,23,149.0,163.041,1094.46,145.286,20,11
6.0,100,2,2,77,208.0,21,142.5,108,46,114,45,35,31,214.0,235.811,1526.05,209.482,32,14
6.0,73,2,2,62,158.0,19,119.0,85,46,92,41,38,23,165.0,178.449,1192.62,158.603,21,13
6.0,105,2,3,81,222.0,22,154.0,117,47,124,45,34,36,229.0,251.777,1766.06,224.177,36,16
5.0,97,2,2,75,206.0,22,144.0,109,46,115,44,34,34,212.0,233.898,1545.01,208.472,31,15
6.362,97,2,3,77,208.0,21,146.5,111,47,117,46,35,34,214.0,235.535,1681.92,210.322,31,14
6.0,104,2,2,80,219.0,22,152.0,115,47,122,45,34,35,226.0,248.641,1626.14,221.224,35,16
9.2,102,2,2,75,215.0,25,147.0,113,43,118,41,28,38,220.0,245.017,1608.09,217.988,34,18
6.344,90,2,2,65,190.0,26,128.0,100,34,105,32,22,35,195.0,216.572,1435.83,193.374,33,14
6.0,64,2,2,48,137.0,17,96.0,73,30,77,27,22,25,141.0,155.918,1049.38,138.948,21,12
8.511,209,3,3,139,430.0,76,277.0,221,63,228,62,28,82,437.0,493.024,3159.1,437.063,77,41
8.585,207,3,3,137,427.0,76,275.0,220,62,227,60,28,83,434.0,489.819,3149.06,434.507,77,41
6.0,107,2,2,81,223.0,22,153.0,116,47,123,45,34,35,230.0,253.346,1639.19,224.882,36,17
8.155,35,0,0,28,71.0,10,50.0,36,19,39,17,16,8,74.0,80.348,489.68,70.745,11,5
7.456,46,0,0,39,94.0,9,68.0,48,25,54,23,22,9,100.0,105.922,646.91,93.265,16,6
6.0,99,2,2,77,206.0,21,141.5,107,46,113,45,35,30,212.0,233.313,1511.03,207.381,32,13
6.146,70,2,3,59,153.0,19,113.5,83,41,89,38,33,24,159.0,172.815,1192.99,154.377,21,11
9.155,68,2,2,56,147.0,15,107.0,79,37,84,35,28,23,152.0,166.167,1121.48,148.396,21,10
6.457,68,2,2,56,152.0,20,114.0,84,39,89,35,28,28,157.0,172.377,1197.5,154.697,21,12
6.0,72,2,3,58,161.0,22,119.0,89,39,94,37,28,31,166.0,183.022,1287.04,163.883,21,15
8.62,39,0,0,34,81.0,12,60.0,42,25,46,23,22,8,85.0,91.178,565.78,80.512,11,5
6.0,69,2,3,57,152.0,19,111.5,83,38,88,37,29,26,157.0,172.108,1197.97,153.923,20,12
8.796,64,2,2,54,141.0,15,105.0,77,37,82,35,28,23,146.0,159.337,1093.42,142.628,19,10
8.092,39,0,0,34,81.0,12,60.0,42,25,46,23,22,8,85.0,91.178,565.78,80.512,11,5
6.542,69,2,3,59,155.0,19,117.5,86,42,92,39,33,27,161.0,175.736,1239.0,157.21,20,13
7.854,41,0,0,39,88.0,12,69.0,47,31,52,29,28,8,93.0,98.593,627.85,87.396,10,5
6.0,74,2,3,55,155.0,19,106.0,81,31,86,29,22,26,160.0,176.227,1177.01,156.465,26,13
6.529,68,2,2,57,151.0,19,114.0,83,41,89,37,32,26,157.0,170.958,1177.51,153.043,20,12
6.793,39,0,0,38,85.0,11,68.0,46,31,51,29,28,8,90.0,95.178,613.82,84.512,9,5
8.523,66,2,2,55,144.0,15,106.0,78,37,83,35,28,23,149.0,162.752,1107.45,145.512,20,10
7.137,43,0,0,40,91.0,13,70.0,48,31,53,29,28,8,96.0,102.009,641.88,90.279,11,5
8.161,44,0,0,38,92.0,11,68.0,48,26,53,24,22,10,97.0,103.716,648.88,91.708,14,6
6.939,69,2,2,51,143.0,17,97.0,74,30,78,28,22,23,147.0,162.456,1060.45,144.17,23,11
6.759,72,2,2,59,157.0,19,116.0,85,41,91,37,32,26,163.0,177.788,1205.57,158.81,22,12
5.47,31,0,0,29,67.0,7,50.0,36,19,40,19,18,7,71.0,75.821,491.63,67.239,10,3
7.252,37,0,0,33,78.0,11,59.0,41,25,45,23,22,8,82.0,87.763,551.75,77.629,10,5
9.0,39,0,0,34,81.0,11,60.0,42,25,46,23,22,8,85.0,91.178,565.78,80.512,11,5
4.301,17,0,2,22,47.0,3,45.0,30,22,34,17,22,8,51.0,52.752,443.33,47.963,5,4
8.62,32,0,0,27,67.0,10,49.0,35,19,38,17,16,8,70.0,75.644,476.63,67.087,10,4
5.62,31,0,0,29,66.0,7,49.0,35,19,39,19,18,6,70.0,74.612,475.63,65.912,10,3
7.854,39,0,0,34,81.0,11,60.0,42,25,46,23,22,8,85.0,91.178,565.78,80.512,11,5
6.0,95,2,2,73,207.0,29,147.5,112,44,118,41,29,39,213.0,235.692,1594.99,210.89,32,17
6.08,96,2,3,75,208.0,28,148.5,112,46,119,43,33,37,215.0,236.423,1607.47,211.115,32,17
8.638,34,0,1,32,75.0,10,59.0,41,25,45,23,22,9,79.0,84.292,572.16,75.069,9,5
6.0,100,2,3,78,220.0,30,157.5,120,45,127,44,29,42,227.0,250.463,1723.56,224.184,34,19
8.357,44,0,0,38,94.0,10,71.0,50,26,56,24,22,12,100.0,106.298,676.9,94.028,14,8
6.054,72,2,3,60,159.0,20,118.5,87,42,93,39,33,27,165.0,180.021,1251.04,160.908,21,13
6.342,91,2,3,70,200.0,28,143.0,109,42,115,38,28,39,206.0,227.499,1667.81,203.974,32,16
9.0,66,2,2,54,142.0,14,103.0,76,36,81,34,28,22,147.0,160.543,1079.44,143.185,20,10
6.0,74,2,2,62,169.0,22,129.5,95,43,101,40,29,33,175.0,191.995,1347.66,172.316,22,16
6.043,69,2,3,59,155.0,19,117.5,86,42,92,39,33,27,161.0,175.736,1239.0,157.21,20,13
8.155,33,0,0,27,68.0,9,49.0,35,19,38,17,16,8,71.0,76.933,475.65,67.861,10,5
8.585,66,2,2,54,142.0,14,103.0,76,36,81,34,28,22,147.0,160.543,1079.44,143.185,20,10
6.0,101,2,3,78,218.0,31,154.5,117,47,124,44,33,39,225.0,247.961,1678.56,221.312,34,18
6.32,70,2,3,59,155.0,19,116.5,85,42,91,39,33,26,161.0,175.397,1221.01,156.697,20,13
8.301,66,2,2,55,144.0,15,106.0,78,37,83,35,28,23,149.0,162.752,1107.45,145.512,20,10
8.086,66,2,2,54,142.0,14,103.0,76,36,81,34,28,22,147.0,160.543,1079.44,143.185,20,10
8.824,66,2,2,55,144.0,15,106.0,78,37,83,35,28,23,149.0,162.752,1107.45,145.512,20,10
8.678,47,1,1,39,99.0,10,74.0,52,27,58,23,22,13,105.0,111.759,726.0,99.098,16,7
8.347,68,2,2,56,147.0,15,107.0,79,37,84,35,28,23,152.0,166.167,1121.48,148.396,21,10
9.046,70,2,2,57,150.0,15,108.0,80,37,85,35,28,23,155.0,169.582,1135.51,151.279,22,10
8.854,70,2,2,57,150.0,15,108.0,80,37,85,35,28,23,155.0,169.582,1135.51,151.279,22,10
8.699,66,2,2,55,144.0,15,106.0,78,37,83,35,28,23,149.0,162.752,1107.45,145.512,20,10
8.886,68,2,2,56,147.0,15,107.0,79,37,84,35,28,23,152.0,166.167,1121.48,148.396,21,10
8.357,66,2,2,55,144.0,15,106.0,78,37,83,35,28,23,149.0,162.752,1107.45,145.512,20,10
8.481,37,0,0,33,78.0,11,59.0,41,25,45,23,22,8,82.0,87.763,551.75,77.629,10,5
8.886,35,0,0,32,75.0,10,58.0,40,25,44,23,22,8,79.0,84.348,537.72,74.745,9,5
8.721,66,2,2,55,144.0,15,106.0,78,37,83,35,28,23,149.0,162.752,1107.45,145.512,20,10
8.569,64,2,2,54,141.0,15,105.0,77,37,82,35,28,23,146.0,159.337,1093.42,142.628,19,10
6.0,73,2,3,60,165.0,21,124.0,92,40,98,38,28,32,171.0,187.52,1326.08,167.985,22,16
6.09,70,2,3,59,156.0,19,117.5,86,42,92,39,33,27,162.0,176.606,1237.01,158.025,20,13
8.488,68,2,2,56,147.0,15,107.0,79,37,84,35,28,23,152.0,166.167,1121.48,148.396,21,10
7.77,39,0,0,37,84.0,11,66.5,45,30,50,27,27,8,89.0,94.178,601.81,83.512,10,5
6.0,74,2,3,62,167.0,21,125.5,93,41,99,40,29,31,173.0,189.437,1337.1,169.766,22,15
8.658,64,2,2,54,141.0,15,105.0,77,37,82,35,28,23,146.0,159.337,1093.42,142.628,19,10
6.0,69,2,3,59,153.0,18,115.5,84,42,90,39,33,25,159.0,172.898,1205.99,154.596,20,12
6.542,92,2,2,70,200.0,28,142.0,108,42,114,38,28,38,206.0,227.778,1541.92,203.904,32,16
6.866,71,2,3,60,159.0,20,120.5,88,43,94,40,33,28,165.0,180.104,1264.04,161.126,20,14
6.0,59,2,3,46,129.0,15,93.0,70,30,74,28,22,24,133.0,146.613,1023.76,130.85,18,12
7.229,43,1,1,36,92.0,11,70.0,49,27,54,23,22,13,97.0,103.929,685.93,92.33,13,7
6.936,69,2,3,59,153.0,18,115.5,84,42,90,39,33,25,159.0,172.898,1205.99,154.596,20,12
6.529,68,2,3,58,150.0,18,112.5,82,41,88,38,33,24,156.0,169.4,1178.96,151.494,20,11
6.138,113,2,3,84,239.0,40,163.5,126,47,133,44,33,42,246.0,272.08,1810.74,242.595,40,18
6.042,70,2,3,55,148.0,18,104.5,78,35,83,32,27,23,153.0,167.606,1128.95,149.05,23,11
6.259,70,2,3,56,155.0,20,114.0,85,38,90,36,28,29,160.0,176.188,1229.0,157.345,20,15
5.94,31,0,0,29,67.0,7,53.0,36,23,41,19,22,7,72.0,75.308,481.65,66.65,10,5
6.097,70,2,3,56,155.0,20,114.0,85,38,90,36,28,29,160.0,176.188,1229.0,157.345,20,15
6.0,98,2,3,74,215.0,30,151.0,117,40,123,40,24,43,221.0,245.257,1689.5,219.628,34,19
8.585,64,2,2,54,141.0,15,105.0,77,37,82,35,28,23,146.0,159.337,1093.42,142.628,19,10
8.509,66,2,2,55,144.0,15,106.0,78,37,83,35,28,23,149.0,162.752,1107.45,145.512,20,10
8.222,66,2,2,55,144.0,15,106.0,78,37,83,35,28,23,149.0,162.752,1107.45,145.512,20,10
6.0,69,2,2,57,154.0,20,115.5,85,40,90,37,29,28,159.0,174.666,1208.53,156.472,20,13
6.0,93,2,2,69,202.0,29,141.0,109,39,114,37,24,40,207.0,230.486,1560.93,206.334,32,17
6.0,95,2,3,73,205.0,28,143.5,110,42,116,41,29,37,211.0,233.134,1584.43,208.341,32,16
6.67,61,2,2,47,131.0,17,93.0,70,30,74,28,22,23,135.0,148.795,1004.33,132.636,19,11
7.0,48,0,0,39,97.0,20,67.5,49,27,54,23,27,10,102.0,109.384,668.91,96.81,16,4
6.167,48,0,0,41,99.0,20,70.0,51,28,56,25,28,10,104.0,111.641,697.92,99.105,16,3
7.149,74,2,2,67,165.0,20,128.0,91,50,98,48,40,24,172.0,185.785,1271.67,166.039,19,12
6.0,72,2,3,61,157.0,19,116.0,85,42,91,40,34,24,163.0,177.007,1310.48,158.006,21,11
6.0,95,2,3,74,202.0,21,141.0,107,45,113,43,34,33,208.0,228.91,1627.87,204.112,31,14
6.5,71,0,0,56,149.0,21,106.0,78,36,84,34,28,22,155.0,169.403,1070.4,149.894,22,13
6.602,64,2,2,52,136.0,15,98.0,72,35,77,33,28,20,141.0,153.709,1021.4,136.646,19,10
5.84,31,0,0,29,68.0,7,54.0,37,23,42,19,22,8,73.0,76.517,497.65,67.978,10,5
6.0,105,2,3,75,214.0,27,140.0,109,40,114,38,28,34,219.0,243.358,1662.0,215.522,37,16
7.276,47,0,0,38,96.0,20,67.5,49,27,54,22,27,11,101.0,108.467,669.9,96.028,16,5
6.0,96,2,2,74,201.0,21,139.0,105,45,111,43,34,31,207.0,227.98,1485.98,202.715,31,14
6.244,49,0,0,41,99.0,20,69.0,50,28,55,25,28,9,104.0,111.301,679.93,98.592,16,3
6.33,63,2,3,52,137.0,15,100.0,74,35,79,33,28,22,142.0,154.639,1163.29,138.043,19,10
6.0,77,2,3,71,173.0,21,135.5,96,54,104,51,45,25,181.0,194.336,1449.64,173.875,20,12
7.022,66,2,2,55,142.0,15,103.5,76,37,81,36,29,21,147.0,160.333,1075.45,142.857,19,10
6.575,59,2,2,51,129.0,12,96.5,70,36,75,35,29,19,134.0,145.38,990.33,129.777,16,9
6.0,79,2,2,73,175.0,20,136.0,96,55,104,53,46,23,183.0,196.532,1334.77,175.588,20,11
6.599,73,2,2,61,156.0,19,114.0,83,42,89,40,34,22,162.0,176.077,1168.59,156.61,21,11
6.0,74,2,2,65,164.0,19,125.5,90,48,97,45,39,25,171.0,184.994,1263.65,165.366,20,12
6.0,80,2,2,65,171.0,20,123.0,91,43,97,41,34,26,177.0,193.449,1285.71,172.344,24,12
6.0,72,2,2,61,155.0,15,114.0,83,42,89,40,34,22,161.0,174.788,1169.57,155.835,21,10
6.0,59,2,2,51,129.0,12,96.5,70,36,75,35,29,19,134.0,145.38,990.33,129.777,16,9
7.347,74,2,3,64,163.0,19,121.5,89,44,95,43,35,25,169.0,183.632,1364.53,164.217,21,11
6.0,74,2,2,67,165.0,20,128.0,91,50,98,48,40,24,172.0,185.785,1271.67,166.039,19,12
6.0,105,2,2,83,222.0,25,156.0,117,52,124,50,40,34,229.0,251.558,1649.17,224.006,33,15
6.529,67,2,2,58,150.0,19,114.5,83,42,89,39,33,25,156.0,169.46,1174.5,151.941,19,11
7.569,75,2,2,64,163.0,19,120.5,88,44,94,43,35,24,169.0,183.911,1238.64,164.148,21,11
6.25,98,2,2,77,208.0,21,145.5,110,47,116,46,35,33,214.0,235.814,1556.03,210.253,31,14
6.0,75,2,2,64,163.0,19,120.5,88,44,94,43,35,24,169.0,183.911,1238.64,164.148,21,11
6.0,96,2,3,74,203.0,21,141.0,107,45,113,43,34,33,209.0,230.199,1626.89,204.886,31,15
6.031,84,2,2,67,176.0,19,124.0,92,43,98,41,34,25,182.0,199.07,1297.77,176.784,26,12
5.983,48,0,0,39,97.0,20,67.5,49,27,54,23,27,10,102.0,109.384,668.91,96.81,16,4
6.483,67,2,3,61,149.0,16,115.5,82,46,89,43,39,21,156.0,167.26,1259.42,149.483,18,10
6.0,98,2,2,75,205.0,21,141.0,107,45,113,43,34,32,211.0,232.605,1516.01,206.926,32,14
6.28,66,2,2,55,142.0,15,103.5,76,37,81,36,29,21,147.0,160.333,1075.45,142.857,19,10
5.662,41,0,0,33,81.0,7,56.0,40,19,45,18,16,7,86.0,91.384,539.79,80.068,15,5
6.0,57,1,1,45,121.0,14,86.0,64,29,68,27,22,19,125.0,137.254,900.18,122.145,18,9
5.699,41,0,0,33,81.0,7,56.0,40,19,45,18,16,7,86.0,91.384,539.79,80.068,15,5
6.0,56,0,0,44,115.0,11,80.0,59,28,63,26,22,15,119.0,130.417,809.08,115.312,18,8
5.98,34,1,1,30,71.0,8,53.5,37,23,41,20,21,7,75.0,79.56,514.75,70.392,10,4
7.387,38,1,1,33,78.0,7,57.5,40,23,45,20,21,7,83.0,87.39,554.82,77.159,13,4
7.092,47,0,0,35,94.0,13,64.0,47,23,51,18,20,12,98.0,106.839,645.89,94.021,17,7
