pXC50,nCsp2,nC,SCBO,nBO,MW,Mv,nSK,nH,RBF,nBT,nBM,Se,nAT,nCsp3,H.,C.,nAB
4.93,21,22,39.5,28,344.86,0.692,25,17,0.089,45,23,41.596,42,1,40.5,52.4,23
7.96,15,27,46.0,37,448.61,0.612,33,32,0.116,69,17,64.767,65,12,49.2,41.5,16
7.14,23,32,57.0,44,524.66,0.641,39,32,0.105,76,24,71.094,71,9,45.1,45.1,22
7.14,21,28,51.0,39,454.56,0.654,34,26,0.077,65,23,60.116,60,7,43.3,46.7,22
9.0,15,25,44.0,35,436.62,0.631,31,28,0.095,63,17,58.749,59,10,47.5,42.4,16
7.21,16,23,45.5,35,402.49,0.653,30,22,0.035,57,21,52.342,52,7,42.3,44.2,21
5.87,20,27,47.0,36,410.55,0.646,31,26,0.048,62,22,56.461,57,7,45.6,47.4,22
8.15,15,23,42.0,33,408.56,0.645,29,24,0.07,57,17,52.982,53,8,45.3,43.4,16
8.4,15,24,43.0,34,406.52,0.629,30,26,0.083,60,17,56.116,56,9,46.4,42.9,16
7.85,15,28,47.0,38,462.64,0.608,34,34,0.125,72,17,67.65,68,13,50.0,41.2,16
5.71,15,22,41.0,32,396.9,0.659,28,21,0.057,53,17,49.345,49,7,42.9,44.9,16
6.44,15,22,41.0,32,396.9,0.659,28,21,0.057,53,17,49.345,49,7,42.9,44.9,16
6.72,15,23,42.0,33,392.49,0.636,29,24,0.053,57,17,53.232,53,8,45.3,43.4,16
8.52,15,25,44.0,35,420.55,0.623,31,28,0.079,63,17,59.0,59,10,47.5,42.4,16
7.01,21,31,54.0,42,496.65,0.635,37,32,0.095,74,23,68.767,69,10,46.4,44.9,22
8.7,15,26,45.0,36,434.58,0.617,32,30,0.091,66,17,61.883,62,11,48.4,41.9,16
5.01,15,24,43.0,34,405.54,0.623,30,27,0.049,61,17,56.891,57,9,47.4,42.1,16
7.17,15,25,44.0,35,420.55,0.623,31,28,0.095,63,17,59.0,59,10,47.5,42.4,16
7.82,15,24,43.0,34,406.52,0.629,30,26,0.067,60,17,56.116,56,9,46.4,42.9,16
6.96,15,25,44.0,35,420.55,0.623,31,28,0.079,63,17,59.0,59,10,47.5,42.4,16
4.91,15,22,41.0,32,378.46,0.643,28,22,0.056,54,17,50.349,50,7,44.0,44.0,16
5.5,13,20,35.0,28,378.88,0.641,26,21,0.082,49,13,47.6,47,7,44.7,42.6,12
5.8,13,19,33.0,26,346.86,0.642,24,20,0.087,46,13,44.203,44,6,45.5,43.2,12
5.1,15,19,34.0,26,344.84,0.66,24,18,0.091,44,14,42.32,42,4,42.9,45.2,12
6.4,13,20,33.0,26,342.9,0.625,24,23,0.082,49,13,46.574,47,7,48.9,42.6,12
5.0,10,16,30.5,24,335.89,0.65,22,18,0.095,42,12,40.102,40,6,45.0,40.0,11
6.8,13,20,34.0,27,360.89,0.633,25,22,0.082,49,13,47.087,47,7,46.8,42.6,12
5.5,13,20,33.0,26,342.9,0.625,24,23,0.082,49,13,46.574,47,7,48.9,42.6,12
5.3,13,19,32.0,25,328.87,0.633,23,21,0.087,46,13,43.691,44,6,47.7,43.2,12
5.432,13,20,37.0,30,411.89,0.644,28,21,0.078,51,13,50.214,49,7,42.9,40.8,12
5.824,13,21,41.0,34,479.89,0.658,32,20,0.074,54,13,54.636,52,8,38.5,40.4,12
5.432,13,21,41.0,34,479.89,0.658,32,20,0.074,54,13,54.636,52,8,38.5,40.4,12
8.174,6,20,27.0,24,301.52,0.559,22,31,0.091,55,6,51.683,53,14,58.5,37.7,6
5.432,13,20,34.0,27,357.92,0.62,25,24,0.078,51,13,48.676,49,7,49.0,40.8,12
5.0,13,19,35.0,28,379.87,0.644,26,20,0.083,48,13,46.818,46,6,43.5,41.3,12
5.415,16,22,40.0,31,379.47,0.643,28,22,0.113,53,15,50.309,50,6,44.0,44.0,12
5.76,13,17,32.0,25,313.81,0.666,22,16,0.024,41,13,38.142,38,4,42.1,44.7,12
8.53,1,19,24.0,23,309.55,0.533,22,35,0.138,58,1,55.778,57,18,61.4,33.3,0
6.272,9,20,29.0,24,315.5,0.574,23,29,0.17,53,8,51.127,52,11,55.8,38.5,6
6.154,9,19,28.0,23,301.47,0.578,22,27,0.16,50,8,48.243,49,10,55.1,38.8,6
6.47,13,19,32.0,25,310.85,0.649,22,19,0.0,44,13,40.48,41,6,46.3,46.3,12
4.864,9,15,24.0,19,245.35,0.6,18,19,0.105,38,8,36.709,37,6,51.4,40.5,6
6.86,15,23,36.0,28,349.51,0.609,26,27,0.127,55,14,52.243,53,8,50.9,43.4,12
4.374,15,23,37.0,29,365.51,0.611,27,27,0.143,56,14,53.571,54,8,50.0,42.6,12
5.903,9,22,31.0,26,343.56,0.567,25,33,0.186,59,8,56.894,58,13,56.9,37.9,6
4.708,9,23,33.0,28,355.57,0.574,26,33,0.131,61,8,57.894,59,14,55.9,39.0,6
5.849,6,18,29.0,26,265.38,0.628,20,19,0.044,45,6,38.382,39,12,48.7,46.2,6
6.244,12,17,26.0,20,255.39,0.6,19,21,0.146,41,12,39.265,40,5,52.5,42.5,12
5.0,15,23,41.0,32,392.55,0.611,29,28,0.1,60,17,56.665,57,8,49.1,40.4,16
7.602,12,17,29.0,22,284.39,0.615,21,20,0.143,42,13,40.811,41,5,48.8,41.5,12
6.587,9,22,31.0,26,343.56,0.567,25,33,0.186,59,8,56.894,58,13,56.9,37.9,6
9.151,7,18,30.0,26,318.43,0.594,23,24,0.1,50,7,47.072,47,11,51.1,38.3,6
9.801,7,19,29.0,25,318.48,0.574,23,28,0.094,53,7,50.512,51,12,54.9,37.3,6
7.433,7,17,29.0,25,303.39,0.608,22,21,0.109,46,7,43.247,43,10,48.8,39.5,6
4.864,9,15,24.0,19,245.35,0.6,18,19,0.105,38,8,36.709,37,6,51.4,40.5,6
6.86,15,23,36.0,28,349.51,0.609,26,27,0.127,55,14,52.243,53,8,50.9,43.4,12
8.622,12,21,32.0,26,307.47,0.605,23,25,0.078,51,12,47.032,48,9,52.1,43.8,12
4.924,6,22,40.0,35,472.49,0.604,32,30,0.062,65,5,63.243,62,16,48.4,35.5,0
5.372,7,20,29.0,25,315.5,0.574,23,29,0.093,54,7,51.127,52,13,55.8,38.5,6
5.704,11,16,26.0,20,274.82,0.621,19,19,0.128,39,12,37.48,38,5,50.0,42.1,12
5.851,9,17,26.0,21,273.41,0.587,20,23,0.136,44,8,42.476,43,8,53.5,39.5,6
6.871,9,22,32.0,27,341.54,0.578,25,31,0.121,58,8,55.01,56,13,55.4,39.3,6
4.984,9,16,25.0,20,259.38,0.593,19,21,0.122,41,8,39.592,40,7,52.5,40.0,6
6.129,9,18,27.0,22,287.44,0.582,21,25,0.128,47,8,45.36,46,9,54.3,39.1,6
6.078,9,22,32.0,27,341.54,0.578,25,31,0.121,58,8,55.01,56,13,55.4,39.3,6
5.113,21,28,45.0,34,411.58,0.63,31,29,0.127,63,20,59.127,60,7,48.3,46.7,18
5.802,9,23,32.0,27,357.59,0.564,26,35,0.194,62,8,59.778,61,14,57.4,37.7,6
7.215,19,31,55.0,43,566.22,0.629,39,36,0.076,79,21,74.709,75,12,48.0,41.3,18
6.549,9,23,32.0,27,357.59,0.564,26,35,0.194,62,8,59.778,61,14,57.4,37.7,6
5.129,15,24,37.0,29,363.54,0.604,27,29,0.155,58,14,55.127,56,9,51.8,42.9,12
5.653,15,23,37.0,29,365.51,0.611,27,27,0.143,56,14,53.571,54,8,50.0,42.6,12
5.933,9,23,33.0,28,355.57,0.574,26,33,0.131,61,8,57.894,59,14,55.9,39.0,6
5.658,9,21,30.0,25,329.53,0.57,24,31,0.179,56,8,54.01,55,12,56.4,38.2,6
6.846,9,21,31.0,26,327.51,0.582,24,29,0.109,55,8,52.127,53,12,54.7,39.6,6
6.047,9,18,27.0,22,287.44,0.582,21,25,0.128,47,8,45.36,46,9,54.3,39.1,6
5.403,15,18,34.5,26,397.77,0.716,24,15,0.146,41,17,39.32,39,3,38.5,46.2,17
5.421,9,17,26.0,21,273.41,0.587,20,23,0.136,44,8,42.476,43,8,53.5,39.5,6
6.435,9,20,29.0,24,315.5,0.574,23,29,0.17,53,8,51.127,52,11,55.8,38.5,6
6.45,7,18,31.0,27,333.45,0.597,24,24,0.039,51,7,48.192,48,11,50.0,37.5,6
7.9,7,23,36.0,32,403.6,0.576,29,34,0.076,66,7,62.61,63,16,54.0,36.5,6
7.4,7,24,35.0,31,384.62,0.569,28,36,0.075,67,7,62.879,64,17,56.3,37.5,6
7.5,7,23,34.0,30,370.59,0.572,27,34,0.063,64,7,59.996,61,16,55.7,37.7,6
6.8,7,22,33.0,29,356.56,0.575,26,32,0.049,61,7,57.112,58,15,55.2,37.9,6
6.3,7,21,33.0,29,358.53,0.581,26,30,0.051,59,7,55.556,56,14,53.6,37.5,6
6.9,7,21,33.0,29,358.53,0.581,26,30,0.068,59,7,55.556,56,14,53.6,37.5,6
7.0,7,22,35.0,31,390.55,0.584,28,31,0.065,62,7,58.952,59,15,52.5,37.3,6
6.7,7,22,35.0,31,390.55,0.584,28,31,0.065,62,7,58.952,59,15,52.5,37.3,6
6.8,7,22,35.0,31,388.56,0.58,28,32,0.079,63,7,59.767,60,15,53.3,36.7,6
6.1,7,22,37.0,31,383.54,0.597,28,29,0.067,60,8,56.774,57,14,50.9,38.6,6
5.8,7,22,39.0,33,436.63,0.592,30,32,0.077,65,9,62.171,62,15,51.6,35.5,6
5.8,7,23,40.0,34,450.66,0.588,31,34,0.088,68,9,65.054,65,16,52.3,35.4,6
6.3,7,23,40.0,34,450.66,0.588,31,34,0.088,68,9,65.054,65,16,52.3,35.4,6
6.7,7,23,36.0,32,402.59,0.577,29,34,0.091,66,7,62.65,63,16,54.0,36.5,6
6.1,7,23,39.0,33,413.57,0.595,30,31,0.094,64,8,60.985,61,15,50.8,37.7,6
4.374,15,23,37.0,29,365.51,0.611,27,27,0.143,56,14,53.571,54,8,50.0,42.6,12
8.571,7,22,33.0,27,357.54,0.58,26,31,0.138,58,8,56.338,57,13,54.4,38.6,6
5.381,21,28,45.0,34,411.58,0.63,31,29,0.127,63,20,59.127,60,7,48.3,46.7,18
5.0,0,42,84.0,84,1153.14,0.578,78,72,0.122,156,0,157.592,150,42,48.0,28.0,0
9.418,7,20,30.0,26,332.51,0.57,24,30,0.107,56,7,53.396,54,13,55.6,37.0,6
5.755,15,23,36.0,28,349.51,0.609,26,27,0.127,55,14,52.243,53,8,50.9,43.4,12
5.161,14,24,41.0,33,407.56,0.611,30,29,0.113,62,14,58.774,59,10,49.2,40.7,12
5.854,7,20,27.0,23,301.52,0.559,22,31,0.148,54,7,51.683,53,13,58.5,37.7,6
6.523,14,27,47.0,39,501.63,0.61,36,33,0.125,72,14,69.778,69,13,47.8,39.1,12
6.119,7,20,33.0,29,396.96,0.591,27,29,0.138,58,7,56.207,56,13,51.8,35.7,6
5.589,7,18,28.0,24,320.48,0.569,23,28,0.154,52,7,50.672,51,11,54.9,35.3,6
5.0,7,19,32.0,28,366.48,0.587,26,27,0.127,55,7,53.512,53,12,50.9,35.8,6
4.553,0,9,12.0,12,174.3,0.514,12,20,0.063,32,0,31.651,32,9,62.5,28.1,0
7.815,12,44,61.0,55,687.18,0.557,50,70,0.136,125,12,117.221,120,32,58.3,36.7,12
6.01,3,10,17.0,13,179.24,0.6,13,13,0.115,26,3,26.058,26,5,50.0,38.5,0
4.863,14,26,48.5,40,532.52,0.631,36,31,0.113,71,17,67.509,67,12,46.3,38.8,17
7.78,14,44,65.0,57,715.14,0.57,52,66,0.122,123,14,116.108,118,30,55.9,37.3,12
6.996,7,16,26.0,22,275.38,0.596,20,21,0.093,43,7,40.92,41,9,51.2,39.0,6
5.0,12,13,24.0,18,228.34,0.674,16,12,0.0,30,12,27.698,28,1,42.9,46.4,12
5.959,1,8,13.0,12,154.24,0.557,11,14,0.077,26,1,24.833,25,7,56.0,32.0,0
5.0,8,13,26.0,20,262.36,0.651,18,14,0.088,34,11,32.236,32,5,43.8,40.6,10
6.0,18,26,44.0,35,434.65,0.645,31,28,0.063,63,18,58.378,59,8,47.5,44.1,18
8.083,19,28,46.0,36,426.6,0.627,32,30,0.106,66,19,61.229,62,9,48.4,45.2,18
4.523,13,14,27.0,20,323.15,0.702,19,11,0.129,31,13,30.84,30,1,36.7,46.7,12
7.046,1,10,18.0,15,193.28,0.584,14,15,0.067,30,2,28.934,29,8,51.7,34.5,0
6.011,1,9,17.0,14,179.25,0.593,13,13,0.074,27,2,26.051,26,7,50.0,34.6,0
7.31,1,10,18.0,15,193.28,0.584,14,15,0.067,30,2,28.934,29,8,51.7,34.5,0
7.7,6,23,41.0,35,495.79,0.586,33,37,0.236,72,11,69.781,70,17,52.9,32.9,10
6.097,1,9,17.0,14,179.25,0.593,13,13,0.074,27,2,26.051,26,7,50.0,34.6,0
8.509,12,22,31.0,25,325.54,0.575,24,31,0.125,56,12,53.683,55,10,56.4,40.0,12
9.0,8,28,48.0,41,593.06,0.596,38,44,0.2,85,12,80.705,82,20,53.7,34.1,10
5.2,1,6,10.0,9,147.23,0.516,10,15,0.167,24,1,25.102,25,5,60.0,24.0,0
4.0,8,24,44.0,37,504.8,0.598,34,36,0.178,73,12,69.672,70,16,51.4,34.3,10
4.0,8,22,42.0,35,476.74,0.606,32,32,0.164,67,12,63.905,64,14,50.0,34.4,10
5.74,10,14,30.0,23,306.37,0.664,21,14,0.081,37,12,35.891,35,4,40.0,40.0,10
4.7,6,10,18.0,15,231.14,0.648,14,12,0.037,27,6,26.153,26,4,46.2,38.5,6
8.854,8,28,48.0,41,560.92,0.585,38,44,0.2,85,12,81.207,82,20,53.7,34.1,10
9.222,8,26,46.0,39,565.0,0.603,36,40,0.19,79,12,74.938,76,18,52.6,34.2,10
8.328,8,27,47.0,40,579.03,0.599,37,42,0.195,82,12,77.821,79,19,53.2,34.2,10
5.959,8,26,46.0,39,532.86,0.591,36,40,0.19,79,12,75.439,76,18,52.6,34.2,10
4.699,8,25,45.0,38,518.83,0.594,35,38,0.184,76,12,72.556,73,17,52.1,34.2,10
8.261,6,20,27.0,24,301.52,0.559,22,31,0.091,55,6,51.683,53,14,58.5,37.7,6
6.53,13,20,31.0,24,292.46,0.605,22,24,0.104,48,13,44.923,46,7,52.2,43.5,12
6.04,12,21,31.0,25,309.49,0.592,23,27,0.115,52,12,48.916,50,9,54.0,42.0,12
4.7,9,14,24.5,19,227.34,0.61,17,17,0.028,36,11,33.491,34,5,50.0,41.2,11
4.523,18,21,46.5,33,443.94,0.691,30,18,0.118,51,24,49.084,48,3,37.5,43.8,21
4.839,4,9,19.5,16,225.37,0.662,14,11,0.0,27,6,24.993,25,5,44.0,36.0,5
6.301,19,22,46.0,34,440.51,0.687,31,18,0.115,52,23,50.232,49,3,36.7,44.9,22
5.0,21,29,53.5,41,497.65,0.634,37,31,0.083,72,24,67.978,68,8,45.6,42.6,23
4.0,6,9,20.0,15,191.28,0.674,13,9,0.0,24,10,22.033,22,3,40.9,40.9,10
5.921,4,9,18.5,15,227.39,0.632,14,13,0.071,28,6,26.876,27,5,48.1,33.3,5
6.0,19,26,47.5,36,428.58,0.631,32,28,0.094,64,22,59.665,60,7,46.7,43.3,21
4.523,8,18,30.0,25,333.48,0.579,24,27,0.135,52,8,50.891,51,10,52.9,35.3,6
7.699,12,21,32.0,26,343.93,0.608,24,26,0.115,52,12,49.24,50,9,52.0,42.0,12
7.377,14,19,30.0,23,279.41,0.619,21,21,0.068,44,13,41.265,42,5,50.0,45.2,12
6.5,15,20,40.0,31,377.5,0.629,28,23,0.056,54,15,51.109,51,5,45.1,39.2,12
10.0,7,18,30.0,26,318.43,0.594,23,24,0.1,50,7,47.072,47,11,51.1,38.3,6
10.097,13,21,35.0,28,337.45,0.624,25,23,0.098,51,13,47.803,48,8,47.9,43.8,12
5.9,12,18,43.0,32,432.58,0.66,29,20,0.115,52,19,49.931,49,6,40.8,36.7,16
5.0,10,25,42.0,35,441.63,0.587,32,35,0.143,70,12,66.752,67,15,52.2,37.3,10
5.0,10,24,41.0,34,427.6,0.591,31,33,0.134,67,12,63.869,64,14,51.6,37.5,10
6.152,6,19,29.0,26,283.42,0.609,21,22,0.083,48,6,42.334,43,13,51.2,44.2,6
5.38,13,21,33.0,26,322.49,0.602,24,26,0.115,52,13,49.134,50,8,52.0,42.0,12
6.48,13,20,32.0,25,326.9,0.623,23,23,0.104,48,13,45.247,46,7,50.0,43.5,12
5.0,9,12,27.5,18,246.25,0.812,17,4,0.0,22,13,22.073,21,0,19.0,57.1,11
4.06,14,20,34.0,26,321.46,0.618,24,23,0.122,49,14,46.469,47,6,48.9,42.6,12
6.34,13,22,33.0,26,320.52,0.594,24,28,0.13,54,13,50.69,52,9,53.8,42.3,12
6.13,13,20,32.0,25,326.9,0.623,23,23,0.104,48,13,45.247,46,7,50.0,43.5,12
5.77,13,21,32.0,25,306.49,0.599,23,26,0.118,51,13,47.807,49,8,53.1,42.9,12
5.62,13,19,30.0,23,278.43,0.612,21,22,0.111,45,13,42.04,43,6,51.2,44.2,12
4.88,14,20,34.0,26,322.44,0.625,24,22,0.146,48,14,45.694,46,6,47.8,43.5,12
5.08,13,19,30.0,23,278.43,0.612,21,22,0.111,45,13,42.04,43,6,51.2,44.2,12
6.21,13,22,33.0,26,320.52,0.594,24,28,0.13,54,13,50.69,52,9,53.8,42.3,12
6.43,14,21,31.0,24,291.47,0.603,22,25,0.102,49,13,45.705,47,7,53.2,44.7,12
6.39,13,24,42.0,34,421.6,0.603,31,31,0.092,65,14,61.65,62,11,50.0,38.7,12
6.89,19,25,40.0,30,354.53,0.63,27,26,0.107,56,19,51.807,53,6,49.1,47.2,18
6.22,13,21,32.0,25,306.49,0.599,23,26,0.098,51,13,47.807,49,8,53.1,42.9,12
6.36,13,21,33.0,26,324.48,0.607,24,25,0.118,51,13,48.32,49,8,51.0,42.9,12
4.83,14,20,34.0,26,322.44,0.625,24,22,0.146,48,14,45.694,46,6,47.8,43.5,12
5.167,10,15,26.0,20,239.35,0.621,18,17,0.054,37,12,34.491,35,5,48.6,42.9,12
7.131,21,40,63.0,51,636.96,0.595,47,52,0.146,103,21,97.596,99,19,52.5,40.4,18
5.0,5,12,18.0,15,190.32,0.571,14,18,0.061,33,6,31.272,32,7,56.3,37.5,6
4.6,13,21,37.0,30,369.48,0.621,27,24,0.111,54,13,51.192,51,8,47.1,41.2,12
5.0,12,22,43.5,34,424.53,0.629,31,25,0.051,59,14,56.614,56,9,44.6,39.3,11
5.749,6,16,23.0,20,227.38,0.587,17,21,0.049,41,6,36.938,38,10,55.3,42.1,6
5.865,6,16,24.0,21,245.37,0.597,18,20,0.049,41,6,37.451,38,10,52.6,42.1,6
5.0,8,16,34.0,27,383.95,0.623,25,22,0.102,49,10,47.516,47,8,46.8,34.0,6
7.208,13,23,36.0,29,368.54,0.593,27,30,0.136,59,13,56.396,57,10,52.6,40.4,12
9.939,19,28,46.0,36,444.62,0.617,33,32,0.132,68,19,64.44,65,9,49.2,43.1,18
4.523,8,21,34.0,29,373.55,0.579,27,31,0.083,60,8,57.658,58,13,53.4,36.2,6
4.523,15,21,44.5,33,425.56,0.645,30,23,0.107,56,20,53.52,53,6,43.4,39.6,17
5.0,13,23,41.0,34,427.58,0.603,31,30,0.063,64,13,61.163,61,10,49.2,37.7,12
5.319,12,21,39.0,31,403.54,0.625,28,25,0.089,56,14,53.418,53,9,47.2,39.6,12
5.0,13,25,42.0,35,438.63,0.593,32,34,0.087,69,13,65.643,66,12,51.5,37.9,12
5.0,13,23,41.0,34,427.58,0.603,31,30,0.063,64,13,61.163,61,10,49.2,37.7,12
5.0,13,24,42.0,35,439.62,0.594,32,33,0.074,68,13,64.861,65,11,50.8,36.9,12
5.0,13,24,44.0,37,477.59,0.61,34,30,0.06,67,13,65.072,64,11,46.9,37.5,12
5.0,19,29,50.0,40,485.69,0.612,36,35,0.067,75,19,70.418,71,10,49.3,40.8,18
5.0,13,24,42.0,35,455.69,0.602,32,33,0.074,68,13,64.61,65,11,50.8,36.9,12
6.208,14,18,35.0,26,341.47,0.649,24,19,0.089,45,17,43.105,43,4,44.2,41.9,16
6.0,16,23,41.0,32,429.96,0.637,30,25,0.088,57,15,55.4,55,7,45.5,41.8,12
4.7,8,12,22.0,17,201.3,0.608,15,15,0.031,32,10,29.607,30,4,50.0,40.0,10
5.538,20,28,56.0,42,477.62,0.653,36,27,0.058,69,27,62.876,63,8,42.9,44.4,26
7.89,14,24,41.0,33,406.58,0.606,30,30,0.063,63,14,59.549,60,10,50.0,40.0,12
7.73,14,24,41.0,33,406.58,0.606,30,30,0.063,63,14,59.549,60,10,50.0,40.0,12
7.91,14,24,41.0,33,406.58,0.606,30,30,0.063,63,14,59.549,60,10,50.0,40.0,12
7.8,14,24,41.0,33,406.58,0.606,30,30,0.063,63,14,59.549,60,10,50.0,40.0,12
5.0,8,19,32.0,27,345.49,0.587,25,27,0.13,54,8,51.891,52,11,51.9,36.5,6
5.0,8,19,33.0,28,379.93,0.603,26,26,0.13,54,8,52.214,52,11,50.0,36.5,6
5.0,7,20,31.0,27,348.51,0.578,25,29,0.125,56,7,53.741,54,13,53.7,37.0,6
5.0,8,23,37.0,32,399.59,0.582,29,33,0.077,65,8,61.541,62,15,53.2,37.1,6
5.509,8,19,32.0,27,345.49,0.587,25,27,0.13,54,8,51.891,52,11,51.9,36.5,6
5.21,0,13,16.0,16,193.37,0.536,14,23,0.051,39,0,35.821,37,13,62.2,35.1,0
5.959,0,15,22.0,22,213.35,0.593,16,19,0.049,41,0,34.054,35,15,54.3,42.9,0
6.382,15,22,42.0,31,378.46,0.643,28,22,0.113,53,19,50.349,50,7,44.0,44.0,16
4.6,0,10,13.0,13,188.33,0.514,13,22,0.086,35,0,34.534,35,10,62.9,28.6,0
4.0,0,10,13.0,13,188.33,0.514,13,22,0.086,35,0,34.534,35,10,62.9,28.6,0
4.91,6,14,21.0,18,236.37,0.564,17,22,0.075,40,6,38.534,39,8,56.4,35.9,6
4.53,6,14,21.0,18,236.37,0.564,17,22,0.075,40,6,38.534,39,8,56.4,35.9,6
8.58,12,20,31.0,25,312.47,0.593,23,26,0.078,51,12,48.301,49,8,53.1,40.8,12
8.83,12,20,31.0,25,312.47,0.593,23,26,0.078,51,12,48.301,49,8,53.1,40.8,12
6.82,12,20,31.0,25,312.47,0.593,23,26,0.078,51,12,48.301,49,8,53.1,40.8,12
4.95,12,21,32.0,26,326.5,0.588,24,28,0.093,54,12,51.185,52,9,53.8,40.4,12
4.77,12,21,32.0,26,326.5,0.588,24,28,0.093,54,12,51.185,52,9,53.8,40.4,12
8.31,12,19,30.0,24,297.43,0.605,22,23,0.085,47,12,44.476,45,7,51.1,42.2,12
8.631,12,19,30.0,24,297.43,0.605,22,23,0.085,47,12,44.476,45,7,51.1,42.2,12
7.15,12,19,30.0,24,297.43,0.605,22,23,0.085,47,12,44.476,45,7,51.1,42.2,12
8.0,4,17,27.0,24,286.47,0.572,21,26,0.08,50,6,46.127,47,13,55.3,36.2,6
5.0,8,13,25.0,19,264.38,0.628,18,16,0.114,35,11,34.12,34,5,47.1,38.2,10
5.87,12,14,30.5,22,288.35,0.688,20,12,0.088,34,16,32.68,32,2,37.5,43.8,15
5.0,8,16,29.0,23,304.45,0.62,21,20,0.07,43,11,40.887,41,8,48.8,39.0,10
5.0,8,12,25.0,19,266.35,0.642,18,14,0.121,33,11,32.564,32,4,43.8,37.5,10
5.0,8,14,27.0,21,276.39,0.638,19,16,0.081,37,11,35.12,35,6,45.7,40.0,10
5.0,8,14,27.0,21,276.39,0.638,19,16,0.081,37,11,35.12,35,6,45.7,40.0,10
5.0,8,15,28.0,22,290.42,0.628,20,18,0.075,40,11,38.003,38,7,47.4,39.5,10
5.0,8,15,29.0,23,306.42,0.63,21,18,0.073,41,11,39.331,39,7,46.2,38.5,10
5.0,8,15,29.0,23,306.42,0.63,21,18,0.073,41,11,39.331,39,7,46.2,38.5,10
5.63,13,15,32.0,23,299.38,0.686,21,13,0.083,36,17,34.454,34,2,38.2,44.1,16
5.89,13,15,32.0,23,299.38,0.686,21,13,0.083,36,17,34.454,34,2,38.2,44.1,16
5.95,12,14,32.0,23,300.37,0.691,21,12,0.086,35,17,33.673,33,2,36.4,42.4,16
5.0,8,13,27.0,21,277.38,0.642,19,15,0.083,36,11,34.338,34,5,44.1,38.2,10
5.0,8,14,28.0,22,291.41,0.632,20,17,0.051,39,11,37.222,37,6,45.9,37.8,10
5.15,8,15,29.0,23,305.44,0.622,21,19,0.071,42,11,40.105,40,7,47.5,37.5,10
5.55,13,14,31.0,22,285.35,0.703,20,11,0.091,33,17,31.571,31,1,35.5,45.2,16
7.251,13,16,34.0,25,346.87,0.684,23,15,0.075,40,17,38.436,38,3,39.5,42.1,16
5.0,15,22,46.5,35,437.57,0.651,31,23,0.069,58,20,54.52,54,7,42.6,40.7,17
5.11,8,13,26.0,20,262.36,0.651,18,14,0.088,34,11,32.236,32,5,43.8,40.6,10
5.0,15,24,49.5,38,463.61,0.65,33,25,0.063,63,20,58.403,58,9,43.1,41.4,17
4.91,16,20,35.0,26,320.42,0.641,24,20,0.13,46,15,43.811,44,4,45.5,45.5,12
4.0,0,10,16.0,15,218.38,0.548,14,20,0.029,35,1,33.727,34,10,58.8,29.4,0
4.0,0,10,16.0,15,218.38,0.548,14,20,0.029,35,1,33.727,34,10,58.8,29.4,0
4.0,0,9,15.0,14,203.34,0.562,13,17,0.032,31,1,29.902,30,9,56.7,30.0,0
4.0,0,10,16.0,15,218.38,0.548,14,20,0.029,35,1,33.727,34,10,58.8,29.4,0
4.0,0,10,16.0,15,218.38,0.548,14,20,0.029,35,1,33.727,34,10,58.8,29.4,0
4.0,0,10,16.0,15,218.38,0.548,14,20,0.029,35,1,33.727,34,10,58.8,29.4,0
4.0,0,9,15.0,14,203.34,0.562,13,17,0.032,31,1,29.902,30,9,56.7,30.0,0
4.33,0,10,16.0,15,218.38,0.548,14,20,0.029,35,1,33.727,34,10,58.8,29.4,0
5.434,15,30,54.5,45,565.74,0.604,41,39,0.131,84,18,80.494,80,15,48.8,37.5,17
7.585,7,19,26.0,22,306.52,0.548,22,32,0.185,54,7,52.952,54,12,59.3,35.2,6
7.83,12,25,43.0,34,437.66,0.614,31,31,0.092,65,14,61.407,62,12,50.0,40.3,12
6.837,13,22,34.0,27,337.5,0.602,25,27,0.13,54,13,51.243,52,9,51.9,42.3,12
7.854,21,39,62.0,50,622.93,0.597,46,50,0.14,100,21,94.712,96,18,52.1,40.6,18
7.523,20,40,60.0,49,607.96,0.588,45,53,0.147,102,20,96.05,98,20,54.1,40.8,18
8.638,21,44,69.0,57,689.04,0.597,51,56,0.097,113,21,105.363,107,23,52.3,41.1,18
7.959,21,42,66.0,54,663.0,0.596,49,54,0.12,108,21,101.479,103,21,52.4,40.8,18
7.509,21,40,63.0,51,636.96,0.595,47,52,0.146,103,21,97.596,99,19,52.5,40.4,18
7.367,21,41,65.0,53,648.97,0.599,48,52,0.114,105,21,98.596,100,20,52.0,41.0,18
7.895,12,26,43.0,34,436.67,0.612,31,32,0.091,66,14,62.189,63,13,50.8,41.3,12
7.735,12,25,43.0,34,437.66,0.614,31,31,0.092,65,14,61.407,62,12,50.0,40.3,12
7.747,13,25,41.0,33,425.64,0.611,30,31,0.094,64,14,60.414,61,12,50.8,41.0,12
10.046,14,26,41.0,33,423.67,0.604,30,33,0.091,66,14,61.97,63,12,52.4,41.3,12
7.346,12,26,43.0,34,436.67,0.612,31,32,0.091,66,14,62.189,63,13,50.8,41.3,12
7.818,13,25,41.0,33,425.64,0.611,30,31,0.094,64,14,60.414,61,12,50.8,41.0,12
9.495,14,26,41.0,33,423.67,0.604,30,33,0.091,66,14,61.97,63,12,52.4,41.3,12
6.824,21,38,63.0,51,622.88,0.609,46,46,0.103,97,21,91.272,92,17,50.0,41.3,18
6.745,21,34,60.0,48,607.73,0.632,44,36,0.095,84,21,81.058,80,13,45.0,42.5,18
7.319,21,42,71.0,59,730.95,0.615,53,49,0.093,108,21,102.461,102,21,48.0,41.2,18
5.91,16,23,40.0,31,358.47,0.648,27,22,0.075,53,15,48.694,49,7,44.9,46.9,12
4.26,16,21,36.0,27,333.47,0.626,25,23,0.1,50,15,47.469,48,5,47.9,43.8,12
5.39,12,39,54.0,48,621.07,0.553,45,64,0.196,112,12,106.57,109,27,58.7,35.8,12
7.036,21,39,67.0,55,690.88,0.618,50,45,0.1,100,21,95.694,95,18,47.4,41.1,18
7.538,21,38,66.0,54,676.85,0.621,49,43,0.103,97,21,92.81,92,17,46.7,41.3,18
7.387,21,38,66.0,54,676.85,0.621,49,43,0.093,97,21,92.81,92,17,46.7,41.3,18
6.319,21,37,62.0,50,608.85,0.612,45,44,0.096,94,21,88.388,89,16,49.4,41.6,18
7.7,7,18,29.0,25,299.46,0.587,22,25,0.04,50,7,46.352,47,11,53.2,38.3,6
6.7,7,17,29.0,25,301.43,0.595,22,23,0.042,48,7,44.796,45,10,51.1,37.8,6
6.2,7,18,30.0,26,315.46,0.589,23,25,0.039,51,7,47.68,48,11,52.1,37.5,6
7.959,21,43,72.0,60,744.98,0.612,54,51,0.099,111,21,105.345,105,22,48.6,41.0,18
4.65,15,19,31.0,23,276.41,0.629,21,20,0.093,43,14,40.156,41,4,48.8,46.3,12
4.92,15,19,31.0,23,276.41,0.629,21,20,0.093,43,14,40.156,41,4,48.8,46.3,12
7.377,21,37,65.0,53,662.82,0.625,48,41,0.096,94,21,89.927,89,16,46.1,41.6,18
7.509,21,42,71.0,59,730.95,0.615,53,49,0.102,108,21,102.461,102,21,48.0,41.2,18
7.4,4,14,23.5,20,281.47,0.577,19,23,0.163,43,6,41.545,42,10,54.8,33.3,5
6.921,21,37,65.0,53,712.17,0.64,48,41,0.096,94,21,89.36,89,16,46.1,41.6,18
6.854,13,20,33.0,26,326.45,0.616,24,23,0.082,49,13,46.763,47,7,48.9,42.6,12
4.398,11,17,30.5,24,314.5,0.614,22,22,0.13,46,12,43.436,44,6,50.0,38.6,11
8.6,6,19,40.0,34,487.67,0.608,32,29,0.254,63,11,62.229,61,13,47.5,31.1,10
7.6,6,19,40.0,34,487.67,0.608,32,29,0.254,63,11,62.229,61,13,47.5,31.1,10
6.1,4,16,29.5,26,373.53,0.58,25,27,0.245,53,6,52.622,52,12,51.9,30.8,5
5.77,16,23,40.0,31,358.47,0.648,27,22,0.075,53,15,48.694,49,7,44.9,46.9,12
6.384,12,20,30.0,24,277.44,0.609,21,23,0.085,47,12,42.821,44,8,52.3,45.5,12
7.1,6,17,37.0,31,443.61,0.617,29,25,0.232,56,11,55.134,54,11,46.3,31.5,10
6.8,9,19,41.0,33,467.63,0.631,31,25,0.276,58,16,57.134,56,10,44.6,33.9,16
4.47,16,20,35.0,26,319.44,0.634,24,21,0.106,47,15,44.585,45,4,46.7,44.4,12
7.99,6,21,30.0,27,346.61,0.573,24,32,0.051,59,6,54.701,56,15,57.1,37.5,6
5.98,6,20,29.0,26,331.57,0.583,23,29,0.055,55,6,50.876,52,14,55.8,38.5,6
6.55,6,21,30.0,27,346.61,0.573,24,32,0.051,59,6,54.701,56,15,57.1,37.5,6
5.64,12,41,56.0,50,649.13,0.551,47,68,0.203,118,12,112.337,115,29,59.1,35.7,12
5.0,15,25,42.0,33,406.57,0.609,30,30,0.111,63,17,59.556,60,10,50.0,41.7,16
5.542,15,26,44.0,35,436.6,0.606,32,32,0.119,67,17,63.767,64,11,50.0,40.6,16
6.01,6,20,32.0,29,309.44,0.614,23,23,0.077,52,6,45.476,46,14,50.0,43.5,6
6.328,6,20,32.0,29,309.44,0.614,23,23,0.077,52,6,45.476,46,14,50.0,43.5,6
5.631,6,21,34.0,31,339.47,0.61,25,25,0.089,56,6,49.687,50,15,50.0,42.0,6
5.529,5,18,30.0,27,280.4,0.622,21,20,0.064,47,6,40.483,41,13,48.8,43.9,6
5.952,5,18,30.0,27,280.4,0.622,21,20,0.064,47,6,40.483,41,13,48.8,43.9,6
6.289,6,19,31.0,28,295.41,0.621,22,21,0.061,49,6,42.592,43,13,48.8,44.2,6
6.181,6,19,31.0,28,295.41,0.621,22,21,0.061,49,6,42.592,43,13,48.8,44.2,6
5.909,6,20,33.0,30,325.44,0.616,24,23,0.075,53,6,46.803,47,14,48.9,42.6,6
5.885,6,19,33.0,30,309.39,0.641,23,19,0.041,49,6,42.036,42,13,45.2,45.2,6
5.09,5,17,29.0,26,266.37,0.631,20,18,0.045,44,6,37.6,38,12,47.4,44.7,6
6.164,6,20,32.0,29,309.44,0.614,23,23,0.077,52,6,45.476,46,14,50.0,43.5,6
6.39,13,20,31.0,24,292.46,0.605,22,24,0.104,48,13,44.923,46,7,52.2,43.5,12
6.59,12,27,37.0,31,412.7,0.559,30,42,0.164,73,12,70.37,72,15,58.3,37.5,12
6.47,6,21,30.0,27,346.61,0.573,24,32,0.051,59,6,54.701,56,15,57.1,37.5,6
4.38,0,9,12.0,12,174.3,0.514,12,20,0.063,32,0,31.651,32,9,62.5,28.1,0
4.34,0,9,12.0,12,174.3,0.514,12,20,0.063,32,0,31.651,32,9,62.5,28.1,0
4.5,0,9,12.0,12,174.3,0.514,12,20,0.063,32,0,31.651,32,9,62.5,28.1,0
5.0,9,13,28.5,19,260.28,0.774,18,6,0.0,25,13,24.956,24,1,25.0,54.2,11
4.0,15,23,39.0,31,399.5,0.62,29,26,0.14,57,14,55.411,55,8,47.3,41.8,12
4.0,15,23,38.0,30,381.51,0.613,28,27,0.14,57,14,54.898,55,8,49.1,41.8,12
4.0,19,25,41.5,31,371.51,0.637,28,25,0.107,56,19,52.36,53,6,47.2,47.2,17
5.241,15,23,39.0,31,381.48,0.632,28,24,0.109,55,14,52.2,52,8,46.2,44.2,12
5.724,15,23,38.0,30,363.49,0.625,27,25,0.109,55,14,51.687,52,8,48.1,44.2,12
4.979,15,24,39.0,31,377.52,0.618,28,27,0.121,58,14,54.571,55,9,49.1,43.6,12
4.939,15,24,38.0,30,379.54,0.606,28,29,0.153,59,14,56.454,57,9,50.9,42.1,12
6.648,8,16,30.0,24,337.91,0.632,22,20,0.045,44,11,41.985,42,8,47.6,38.1,10
6.54,8,15,30.0,24,339.88,0.643,22,18,0.048,42,11,40.429,40,7,45.0,37.5,10
6.512,8,14,27.0,21,311.87,0.632,20,18,0.051,39,11,38.102,38,6,47.4,36.8,10
6.38,8,14,28.0,22,327.87,0.634,21,18,0.125,40,11,39.429,39,6,46.2,35.9,10
6.032,8,17,32.0,26,366.96,0.619,24,23,0.082,49,11,46.971,47,9,48.9,36.2,10
5.851,8,17,31.0,25,351.94,0.624,23,22,0.064,47,11,44.869,45,9,48.9,37.8,10
6.971,14,18,36.0,27,375.91,0.668,25,18,0.089,45,17,43.429,43,4,41.9,41.9,16
6.909,14,17,36.0,27,381.86,0.699,25,14,0.073,41,17,40.243,39,3,35.9,43.6,16
7.112,8,13,27.0,21,295.82,0.665,19,14,0.057,35,11,33.334,33,5,42.4,39.4,10
6.221,13,17,35.0,26,360.9,0.671,24,17,0.07,43,17,41.32,41,4,41.5,41.5,16
7.213,13,17,35.0,26,360.9,0.671,24,17,0.07,43,17,41.32,41,4,41.5,41.5,16
6.681,13,16,34.0,25,346.87,0.684,23,15,0.075,40,17,38.436,38,3,39.5,42.1,16
6.173,13,17,35.0,26,360.9,0.671,24,17,0.07,43,17,41.32,41,4,41.5,41.5,16
6.45,13,16,34.0,25,346.87,0.684,23,15,0.075,40,17,38.436,38,3,39.5,42.1,16
5.862,13,17,35.0,26,360.9,0.671,24,17,0.07,43,17,41.32,41,4,41.5,41.5,16
6.892,13,17,35.0,26,360.9,0.671,24,17,0.093,43,17,41.32,41,4,41.5,41.5,16
4.522,13,17,35.0,26,360.9,0.671,24,17,0.093,43,17,41.32,41,4,41.5,41.5,16
6.072,13,17,35.0,26,360.9,0.671,24,17,0.093,43,17,41.32,41,4,41.5,41.5,16
6.531,12,15,34.0,25,347.86,0.688,23,14,0.077,39,17,37.654,37,3,37.8,40.5,16
6.569,12,15,34.0,25,347.86,0.688,23,14,0.077,39,17,37.654,37,3,37.8,40.5,16
6.091,12,15,34.0,25,347.86,0.688,23,14,0.077,39,17,37.654,37,3,37.8,40.5,16
6.489,12,15,34.0,25,347.86,0.688,23,14,0.077,39,17,37.654,37,3,37.8,40.5,16
7.094,14,18,38.0,29,389.89,0.688,26,16,0.067,45,17,42.873,42,4,38.1,42.9,16
6.969,14,17,34.0,25,345.88,0.679,23,16,0.073,41,17,39.218,39,3,41.0,43.6,16
6.803,14,17,36.0,27,381.86,0.699,25,14,0.073,41,17,40.243,39,3,35.9,43.6,16
6.803,14,17,35.0,26,380.32,0.7,24,15,0.073,41,17,39.542,39,3,38.5,43.6,16
6.982,14,18,35.0,26,359.91,0.667,24,18,0.068,44,17,42.102,42,4,42.9,42.9,16
6.748,14,17,35.0,26,380.32,0.7,24,15,0.073,41,17,39.542,39,3,38.5,43.6,16
6.602,11,14,32.5,24,352.9,0.704,22,13,0.081,37,16,35.629,35,3,37.1,40.0,15
5.759,14,18,38.0,29,413.88,0.694,27,15,0.068,44,17,43.64,42,4,35.7,42.9,16
4.522,14,19,37.0,28,388.96,0.65,26,21,0.082,49,17,47.087,47,5,44.7,40.4,16
5.0,14,17,35.0,26,361.88,0.68,24,16,0.071,42,17,40.545,40,3,40.0,42.5,16
4.522,14,18,36.0,27,375.91,0.668,25,18,0.089,45,17,43.429,43,4,41.9,41.9,16
7.282,8,14,29.0,23,325.85,0.654,21,16,0.051,39,11,37.545,37,6,43.2,37.8,10
5.699,8,13,28.0,22,311.82,0.667,20,14,0.056,36,11,34.662,34,5,41.2,38.2,10
6.832,8,13,26.0,20,297.84,0.642,19,16,0.056,36,11,35.218,35,5,45.7,37.1,10
4.5,6,10,18.0,15,231.14,0.648,14,12,0.037,27,6,26.153,26,4,46.2,38.5,6
7.824,8,22,36.0,31,385.56,0.586,28,31,0.081,62,8,58.658,59,14,52.5,37.3,6
6.495,8,21,36.0,31,387.53,0.592,28,29,0.083,60,8,57.101,57,13,50.9,36.8,6
7.538,8,23,38.0,33,397.57,0.593,29,31,0.078,64,8,59.658,60,15,51.7,38.3,6
5.227,3,13,22.5,18,235.34,0.582,17,19,0.081,37,6,35.869,36,8,52.8,36.1,5
5.961,3,10,18.5,14,194.26,0.594,14,14,0.107,28,6,28.16,28,5,50.0,35.7,5
5.223,9,18,31.5,24,297.41,0.616,22,21,0.089,45,12,42.752,43,7,48.8,41.9,11
5.774,1,13,21.0,18,237.36,0.565,17,21,0.077,39,2,37.752,38,10,55.3,34.2,0
6.166,3,11,19.5,15,209.3,0.576,15,17,0.094,32,6,31.985,32,6,53.1,34.4,5
5.219,1,12,20.0,17,222.32,0.579,16,18,0.086,35,2,33.927,34,9,52.9,35.3,0
4.301,14,25,43.0,35,437.59,0.608,32,31,0.091,66,14,62.985,63,11,49.2,39.7,12
6.699,14,24,41.0,33,408.54,0.616,30,28,0.098,61,14,58.0,58,10,48.3,41.4,12
4.921,13,25,40.0,33,408.59,0.598,30,32,0.108,65,13,61.44,62,12,51.6,40.3,12
6.523,13,23,40.0,33,426.65,0.639,29,26,0.068,59,13,54.614,55,10,47.3,41.8,12
5.347,14,20,34.0,26,322.44,0.625,24,22,0.125,48,14,45.694,46,6,47.8,43.5,12
4.377,15,18,33.0,24,276.36,0.661,21,16,0.05,40,17,36.716,37,3,43.2,48.6,16
4.108,15,19,35.0,26,306.39,0.651,23,18,0.068,44,17,40.927,41,4,43.9,46.3,16
4.155,13,17,37.5,27,324.37,0.66,24,16,0.07,43,18,40.691,40,4,40.0,42.5,15
4.027,14,21,35.0,27,336.54,0.626,24,24,0.098,51,16,47.0,48,7,50.0,43.8,16
5.699,14,22,40.0,32,395.5,0.624,29,25,0.088,57,14,54.334,54,8,46.3,40.7,12
6.699,14,23,40.0,32,394.51,0.622,29,26,0.103,58,14,55.116,55,9,47.3,41.8,12
5.796,14,21,36.0,28,334.45,0.633,25,22,0.08,50,14,46.694,47,7,46.8,44.7,12
4.022,14,19,33.0,25,308.48,0.642,22,20,0.067,45,16,41.232,42,5,47.6,45.2,16
5.854,14,22,37.0,29,348.48,0.625,26,24,0.075,53,14,49.578,50,8,48.0,44.0,12
6.155,13,24,41.0,34,440.68,0.633,30,28,0.065,62,13,57.498,58,11,48.3,41.4,12
4.959,15,25,41.0,33,422.64,0.617,30,30,0.127,63,14,59.305,60,10,50.0,41.7,12
5.52,24,42,63.0,51,651.04,0.582,48,58,0.229,109,24,103.919,106,18,54.7,39.6,24
6.0,14,38,57.0,49,635.0,0.569,46,58,0.178,107,14,102.574,104,24,55.8,36.5,12
5.56,12,40,55.0,49,635.1,0.552,46,66,0.2,115,12,109.453,112,28,58.9,35.7,12
5.0,24,41,62.0,50,637.01,0.585,47,56,0.226,106,24,101.035,103,17,54.4,39.8,24
5.37,14,39,58.0,50,649.03,0.567,47,60,0.182,110,14,105.457,107,25,56.1,36.4,12
6.09,14,40,59.0,51,663.06,0.566,48,62,0.186,113,14,108.341,110,26,56.4,36.4,12
5.0,14,41,60.0,52,677.09,0.564,49,64,0.19,116,14,111.224,113,27,56.6,36.3,12
5.0,26,42,67.0,53,679.0,0.597,50,54,0.215,107,26,102.806,104,16,51.9,40.4,24
6.13,12,38,53.0,47,607.04,0.555,44,62,0.193,109,12,103.686,106,26,58.5,35.8,12
6.762,7,24,32.0,28,373.64,0.552,27,39,0.179,67,7,64.545,66,17,59.1,36.4,6
6.8,20,31,57.5,44,537.8,0.631,39,35,0.089,79,27,73.159,74,11,47.3,41.9,27
5.0,17,19,36.5,27,357.81,0.681,25,16,0.116,43,18,41.804,41,2,39.0,46.3,17
6.54,12,22,32.0,26,324.53,0.581,24,30,0.107,56,12,52.741,54,10,55.6,40.7,12
3.79,24,36,55.0,43,536.82,0.602,40,44,0.172,87,24,82.414,84,12,52.4,42.9,24
6.21,24,37,56.0,44,550.85,0.598,41,46,0.178,90,24,85.297,87,13,52.9,42.5,24
5.93,12,27,39.0,33,406.67,0.577,30,38,0.099,71,12,66.436,68,15,55.9,39.7,12
6.987,13,30,41.0,34,451.82,0.551,33,49,0.193,83,13,79.628,82,17,59.8,36.6,12
4.64,18,27,42.0,33,401.62,0.602,30,33,0.106,66,18,61.727,63,9,52.4,42.9,18
4.95,24,38,57.0,45,566.9,0.588,42,50,0.158,95,24,90.065,92,14,54.3,41.3,24
6.917,13,26,37.0,30,395.7,0.558,29,41,0.169,71,13,68.094,70,13,58.6,37.1,12
5.57,12,29,41.0,35,436.75,0.563,32,44,0.089,79,12,74.087,76,17,57.9,38.2,12
5.01,12,21,32.0,26,324.51,0.589,24,28,0.111,54,12,51.018,52,9,53.8,40.4,12
5.93,12,20,31.0,25,310.48,0.593,23,26,0.118,51,12,48.134,49,8,53.1,40.8,12
10.4,9,19,36.0,30,392.56,0.641,26,22,0.096,52,11,48.342,48,10,45.8,39.6,10
7.157,15,22,35.0,27,335.48,0.615,25,25,0.135,52,14,49.36,50,7,50.0,44.0,12
5.102,7,20,29.0,25,315.5,0.574,23,29,0.093,54,7,51.127,52,13,55.8,38.5,6
8.131,13,21,32.0,25,325.49,0.594,24,27,0.173,52,13,50.243,51,8,52.9,41.2,12
8.195,39,64,115.0,91,1124.54,0.615,83,77,0.173,168,42,159.562,160,25,48.1,40.0,36
5.0,13,18,34.0,26,326.86,0.646,23,19,0.067,45,16,41.8,42,5,45.2,42.9,16
8.201,35,52,91.0,71,900.05,0.609,65,60,0.168,131,34,124.432,125,17,48.0,41.6,28
5.0,13,19,33.0,26,343.89,0.628,24,22,0.083,48,13,45.792,46,6,47.8,41.3,12
6.654,1,11,19.0,16,208.29,0.586,15,16,0.063,32,2,31.043,31,8,51.6,35.5,0
5.77,21,37,61.0,49,592.85,0.611,44,44,0.097,93,21,87.061,88,16,50.0,42.0,18
6.71,12,36,49.0,43,583.02,0.546,42,62,0.276,105,12,101.686,104,24,59.6,34.6,12
7.96,3,22,30.0,28,345.58,0.557,25,35,0.032,63,2,58.778,60,19,58.3,36.7,0
5.74,16,23,40.0,31,358.47,0.648,27,22,0.075,53,15,48.694,49,7,44.9,46.9,12
4.83,16,20,35.0,26,320.42,0.641,24,20,0.13,46,15,43.811,44,4,45.5,45.5,12
4.0,4,10,19.5,16,241.42,0.62,15,15,0.065,31,6,29.76,30,6,50.0,33.3,5
4.33,16,21,36.0,27,333.47,0.626,25,23,0.1,50,15,47.469,48,5,47.9,43.8,12
8.35,13,27,46.0,38,478.71,0.589,35,38,0.118,76,14,72.403,73,14,52.1,37.0,12
4.67,16,20,35.0,26,319.44,0.634,24,21,0.106,47,15,44.585,45,4,46.7,44.4,12
8.7,15,26,45.0,36,450.65,0.625,32,30,0.091,66,17,61.632,62,11,48.4,41.9,16
4.9,16,20,35.0,26,320.42,0.641,24,20,0.13,46,15,43.811,44,4,45.5,45.5,12
5.0,13,18,34.0,26,310.41,0.635,23,19,0.067,45,16,41.989,42,5,45.2,42.9,16
5.0,13,20,35.0,27,320.48,0.612,24,24,0.078,51,16,47.243,48,7,50.0,41.7,16
5.0,13,19,37.0,29,360.42,0.644,26,19,0.063,48,16,45.898,45,6,42.2,42.2,16
4.61,16,20,35.0,26,319.44,0.634,24,21,0.106,47,15,44.585,45,4,46.7,44.4,12
8.337,7,22,30.0,26,345.58,0.557,25,35,0.164,61,7,58.778,60,15,58.3,36.7,6
7.183,7,21,29.0,25,331.55,0.559,24,33,0.155,58,7,55.894,57,14,57.9,36.8,6
6.26,14,18,31.0,24,331.89,0.662,22,18,0.095,42,13,39.782,40,4,45.0,45.0,12
6.68,7,23,31.0,27,359.61,0.554,26,37,0.172,64,7,61.661,63,16,58.7,36.5,6
8.824,7,20,28.0,24,317.52,0.562,23,31,0.145,55,7,53.01,54,13,57.4,37.0,6
5.0,13,19,35.0,27,322.45,0.62,24,22,0.082,49,16,45.687,46,6,47.8,41.3,16
5.0,13,19,35.0,27,338.52,0.631,24,22,0.082,49,16,45.436,46,6,47.8,41.3,16
5.0,19,24,43.0,32,368.52,0.641,28,24,0.071,56,22,51.243,52,5,46.2,46.2,22
5.0,13,21,36.0,28,334.51,0.605,25,26,0.093,54,16,50.127,51,8,51.0,41.2,16
5.0,13,18,34.0,26,310.41,0.635,23,19,0.067,45,16,41.989,42,5,45.2,42.9,16
5.76,1,22,31.0,28,343.56,0.567,25,33,0.0,61,2,56.894,58,19,56.9,37.9,0
8.345,13,23,38.0,31,364.5,0.618,27,26,0.035,57,13,52.629,53,10,49.1,43.4,12
5.081,1,10,15.0,14,183.28,0.556,13,17,0.065,31,1,29.825,30,9,56.7,33.3,0
4.6,10,18,33.0,26,311.42,0.619,23,21,0.064,47,12,43.912,44,8,47.7,40.9,10
6.05,1,22,31.0,28,343.56,0.567,25,33,0.0,61,2,56.894,58,19,56.9,37.9,0
5.012,14,20,36.0,28,320.42,0.641,24,20,0.021,48,16,43.811,44,6,45.5,45.5,16
5.73,19,28,49.0,38,458.63,0.624,34,31,0.116,69,22,64.618,65,9,47.7,43.1,22
5.0,15,20,36.0,27,318.46,0.627,24,22,0.082,49,17,45.36,46,5,47.8,43.5,16
5.247,20,26,43.0,33,404.54,0.637,30,26,0.102,59,19,55.716,56,6,46.4,46.4,18
5.22,15,23,42.0,33,392.49,0.636,29,24,0.07,57,17,53.232,53,8,45.3,43.4,16
5.43,15,22,40.0,31,362.46,0.642,27,22,0.057,53,17,49.022,49,7,44.9,44.9,16
6.76,3,22,30.0,28,345.58,0.557,25,35,0.032,63,2,58.778,60,19,58.3,36.7,0
6.333,15,23,41.0,32,376.49,0.634,28,24,0.054,56,17,51.905,52,8,46.2,44.2,16
5.831,15,23,41.0,32,376.49,0.634,28,24,0.054,56,17,51.905,52,8,46.2,44.2,16
6.62,3,8,15.5,13,168.22,0.588,12,12,0.04,25,5,24.276,24,5,50.0,33.3,5
6.51,19,32,48.0,38,469.72,0.601,35,39,0.13,77,19,72.545,74,13,52.7,43.2,18
7.95,13,21,35.0,28,338.46,0.617,25,24,0.038,52,13,48.745,49,8,49.0,42.9,12
5.585,3,11,18.0,16,211.29,0.574,15,17,0.061,33,2,32.153,32,8,53.1,34.4,0
8.658,12,25,40.0,33,426.68,0.595,30,34,0.09,67,13,63.072,64,13,53.1,39.1,12
4.0,3,14,22.0,20,268.4,0.558,19,24,0.091,44,2,42.905,43,11,55.8,32.6,0
6.18,1,10,15.0,14,183.28,0.556,13,17,0.097,31,1,29.825,30,9,56.7,33.3,0
5.0,6,10,18.0,14,175.26,0.604,13,13,0.074,27,7,25.723,26,4,50.0,38.5,6
6.339,1,15,21.0,20,251.41,0.553,18,25,0.067,45,1,42.36,43,14,58.1,34.9,0
5.638,1,11,20.0,19,316.63,0.629,18,16,0.114,35,1,35.007,34,10,47.1,32.4,0
6.347,7,14,28.0,22,276.32,0.627,20,16,0.105,38,9,36.698,36,7,44.4,38.9,6
8.52,15,26,45.0,36,450.65,0.625,32,30,0.106,66,17,61.632,62,11,48.4,41.9,16
4.456,14,19,33.0,25,292.41,0.631,22,20,0.067,45,16,41.483,42,5,47.6,45.2,16
8.7,15,25,44.0,35,420.55,0.623,31,28,0.095,63,17,59.0,59,10,47.5,42.4,16
6.281,9,18,27.0,22,287.44,0.582,21,25,0.149,47,8,45.36,46,9,54.3,39.1,6
6.964,9,20,30.0,25,313.48,0.586,23,27,0.096,52,8,49.243,50,11,54.0,40.0,6
9.0,15,26,45.0,36,434.58,0.617,32,30,0.106,66,17,61.883,62,11,48.4,41.9,16
4.62,14,19,35.0,27,306.39,0.651,23,18,0.044,45,16,40.927,41,5,43.9,46.3,16
4.885,9,15,24.0,19,245.35,0.6,18,19,0.105,38,8,36.709,37,6,51.4,40.5,6
5.759,15,22,35.0,27,335.48,0.615,25,25,0.135,52,14,49.36,50,7,50.0,44.0,12
6.776,9,21,31.0,26,327.51,0.582,24,29,0.109,55,8,52.127,53,12,54.7,39.6,6
6.022,15,25,38.0,30,377.57,0.599,28,31,0.164,61,14,58.01,59,10,52.5,42.4,12
6.183,9,18,27.0,22,287.44,0.582,21,25,0.149,47,8,45.36,46,9,54.3,39.1,6
6.247,9,24,33.0,28,371.62,0.561,27,37,0.2,65,8,62.661,64,15,57.8,37.5,6
5.491,9,16,25.0,20,259.38,0.593,19,21,0.122,41,8,39.592,40,7,52.5,40.0,6
4.198,10,20,32.5,26,325.5,0.59,24,27,0.132,53,12,50.236,51,10,52.9,39.2,11
4.507,15,20,33.0,25,307.42,0.63,23,21,0.109,46,14,43.592,44,5,47.7,45.5,12
7.208,9,20,30.0,25,313.48,0.586,23,27,0.096,52,8,49.243,50,11,54.0,40.0,6
5.693,9,20,29.0,24,315.5,0.574,23,29,0.17,53,8,51.127,52,11,55.8,38.5,6
5.557,15,24,37.0,29,363.54,0.604,27,29,0.155,58,14,55.127,56,9,51.8,42.9,12
5.673,9,24,33.0,28,371.62,0.561,27,37,0.2,65,8,62.661,64,15,57.8,37.5,6
5.622,15,25,38.0,30,377.57,0.599,28,31,0.164,61,14,58.01,59,10,52.5,42.4,12
5.09,13,22,34.0,27,337.5,0.602,25,27,0.13,54,13,51.243,52,9,51.9,42.3,12
6.21,9,21,30.0,25,329.53,0.57,24,31,0.179,56,8,54.01,55,12,56.4,38.2,6
6.975,5,21,25.0,22,304.6,0.529,22,38,0.25,60,6,57.948,60,16,63.3,35.0,6
8.492,8,24,47.0,40,552.8,0.602,37,36,0.211,76,12,73.654,73,16,49.3,32.9,10
4.0,8,23,43.0,36,490.77,0.602,33,34,0.171,70,12,66.789,67,15,50.7,34.3,10
5.074,15,20,33.0,25,307.42,0.63,23,21,0.109,46,14,43.592,44,5,47.7,45.5,12
6.364,9,19,28.0,23,301.47,0.578,22,27,0.16,50,8,48.243,49,10,55.1,38.8,6
6.242,7,20,28.0,24,317.52,0.562,23,31,0.164,55,7,53.01,54,13,57.4,37.0,6
5.097,7,14,24.0,18,266.77,0.622,18,17,0.114,35,8,35.091,35,5,48.6,40.0,6
5.409,8,18,38.0,31,420.62,0.628,28,24,0.127,55,12,52.371,52,10,46.2,34.6,10
6.305,1,9,17.0,14,179.25,0.593,13,13,0.074,27,2,26.051,26,7,50.0,34.6,0
5.505,13,24,35.0,28,348.58,0.585,26,32,0.117,60,13,56.458,58,11,55.2,41.4,12
5.07,13,21,33.0,26,322.49,0.602,24,26,0.115,52,13,49.134,50,8,52.0,42.0,12
5.7,13,21,33.0,26,338.56,0.611,24,26,0.115,52,13,48.883,50,8,52.0,42.0,12
4.57,14,20,34.0,26,321.46,0.618,24,23,0.122,49,14,46.469,47,6,48.9,42.6,12
5.49,13,21,32.0,25,306.49,0.599,23,26,0.098,51,13,47.807,49,8,53.1,42.9,12
6.19,13,20,32.0,25,310.45,0.613,23,23,0.104,48,13,45.436,46,7,50.0,43.5,12
6.08,13,21,33.0,26,340.93,0.616,24,25,0.118,51,13,48.131,49,8,51.0,42.9,12
6.18,13,21,32.0,25,306.49,0.599,23,26,0.118,51,13,47.807,49,8,53.1,42.9,12
5.85,13,21,32.0,25,306.49,0.599,23,26,0.098,51,13,47.807,49,8,53.1,42.9,12
5.72,13,23,35.0,28,332.53,0.602,25,28,0.089,56,13,51.69,53,10,52.8,43.4,12
5.91,13,22,34.0,27,318.5,0.607,24,26,0.094,53,13,48.807,50,9,52.0,44.0,12
5.13,13,19,30.0,23,278.43,0.612,21,22,0.111,45,13,42.04,43,6,51.2,44.2,12
6.0,13,22,33.0,26,320.52,0.594,24,28,0.111,54,13,50.69,52,9,53.8,42.3,12
4.33,14,20,34.0,26,321.46,0.618,24,23,0.122,49,14,46.469,47,6,48.9,42.6,12
7.222,21,41,64.0,52,650.99,0.592,48,54,0.151,106,21,100.479,102,20,52.9,40.2,18
5.38,13,22,35.0,28,334.5,0.609,25,26,0.093,54,13,50.134,51,9,51.0,43.1,12
5.0,13,23,41.0,34,444.03,0.61,31,30,0.063,64,13,60.974,61,10,49.2,37.7,12
5.0,13,23,41.0,34,444.03,0.61,31,30,0.063,64,13,60.974,61,10,49.2,37.7,12
6.41,12,20,32.0,26,325.51,0.624,23,23,0.061,49,12,45.225,46,8,50.0,43.5,12
7.2,6,15,34.0,28,399.55,0.629,26,21,0.204,49,11,48.04,47,9,44.7,31.9,10
6.06,12,20,32.0,26,325.51,0.624,23,23,0.061,49,12,45.225,46,8,50.0,43.5,12
6.52,12,21,33.0,27,340.55,0.61,24,26,0.057,53,12,49.051,50,9,52.0,42.0,12
7.79,12,21,33.0,27,340.55,0.61,24,26,0.057,53,12,49.051,50,9,52.0,42.0,12
7.47,6,21,30.0,27,346.61,0.573,24,32,0.051,59,6,54.701,56,15,57.1,37.5,6
5.92,6,20,29.0,26,331.57,0.583,23,29,0.055,55,6,50.876,52,14,55.8,38.5,6
6.8,9,19,41.0,33,467.63,0.631,31,25,0.276,58,16,57.134,56,10,44.6,33.9,16
6.03,6,20,29.0,26,331.57,0.583,23,29,0.055,55,6,50.876,52,14,55.8,38.5,6
8.414,7,18,30.0,26,318.43,0.594,23,24,0.1,50,7,47.072,47,11,51.1,38.3,6
7.699,21,41,70.0,58,716.92,0.618,52,47,0.105,105,21,99.577,99,20,47.5,41.4,18
7.62,21,38,66.0,54,726.2,0.636,49,43,0.103,97,21,92.243,92,17,46.7,41.3,18
7.276,21,37,65.0,53,712.17,0.64,48,41,0.096,94,21,89.36,89,16,46.1,41.6,18
6.538,21,37,62.0,50,608.85,0.612,45,44,0.096,94,21,88.388,89,16,49.4,41.6,18
5.04,7,14,25.0,19,281.79,0.616,19,18,0.108,37,8,37.193,37,5,48.6,37.8,6
6.22,6,20,29.0,26,331.57,0.583,23,29,0.055,55,6,50.876,52,14,55.8,38.5,6
7.9,6,21,43.0,37,531.73,0.601,35,33,0.271,70,11,69.323,68,15,48.5,30.9,10
5.0,24,40,61.0,49,622.98,0.587,46,54,0.223,103,24,98.152,100,16,54.0,40.0,24
5.28,0,9,12.0,12,174.3,0.514,12,20,0.063,32,0,31.651,32,9,62.5,28.1,0
4.921,14,20,37.0,29,336.42,0.643,25,20,0.061,49,16,45.138,45,6,44.4,44.4,16
4.167,14,19,33.0,25,308.48,0.642,22,20,0.067,45,16,41.232,42,5,47.6,45.2,16
6.523,13,21,36.0,29,352.47,0.62,26,24,0.075,53,13,49.905,50,8,48.0,42.0,12
4.523,14,17,31.0,23,264.35,0.651,20,16,0.026,39,16,35.716,36,3,44.4,47.2,16
6.523,13,23,38.0,31,380.53,0.608,28,28,0.068,59,13,55.672,56,10,50.0,41.1,12
4.721,13,18,30.0,23,280.4,0.622,21,20,0.093,43,13,40.483,41,5,48.8,43.9,12
6.699,14,25,42.0,34,422.57,0.611,31,30,0.094,64,14,60.883,61,11,49.2,41.0,12
4.745,14,20,35.0,27,322.44,0.625,24,22,0.082,49,16,45.694,46,6,47.8,43.5,16
5.0,7,16,28.0,22,271.37,0.614,20,19,0.073,41,8,38.869,39,7,48.7,41.0,6
6.863,12,19,31.0,25,310.5,0.625,22,22,0.043,47,12,43.116,44,7,50.0,43.2,12
5.21,26,40,65.0,51,650.94,0.603,48,50,0.208,101,26,97.039,98,14,51.0,40.8,24
5.645,7,17,29.0,23,285.4,0.607,21,21,0.068,44,8,41.752,42,8,50.0,40.5,6
5.0,26,41,66.0,52,664.97,0.6,49,52,0.212,104,26,99.923,101,15,51.5,40.6,24
6.101,1,12,20.0,17,222.32,0.579,16,18,0.057,35,2,33.927,34,9,52.9,35.3,0
7.83,24,44,65.0,53,647.04,0.587,48,58,0.117,111,24,103.599,106,20,54.7,41.5,24
5.91,24,37,57.0,45,549.84,0.602,41,45,0.133,90,24,84.356,86,13,52.3,43.0,24
4.0,18,26,41.0,32,386.58,0.612,29,30,0.113,62,18,57.901,59,8,50.8,44.1,18
4.95,24,39,58.0,46,580.93,0.586,43,52,0.163,98,24,92.948,95,15,54.7,41.1,24
7.17,24,42,63.0,51,616.96,0.598,46,52,0.126,103,24,95.948,98,18,53.1,42.9,24
6.229,18,25,43.0,33,400.57,0.623,30,28,0.115,61,19,57.338,58,7,48.3,43.1,18
4.03,0,9,12.0,12,174.3,0.514,12,20,0.063,32,0,31.651,32,9,62.5,28.1,0
4.65,24,36,56.0,44,534.8,0.61,40,42,0.14,86,24,80.53,82,12,51.2,43.9,24
5.04,7,14,25.0,19,281.79,0.616,19,18,0.108,37,8,37.193,37,5,48.6,37.8,6
7.464,12,19,30.0,24,314.89,0.615,22,23,0.085,47,12,44.247,45,7,51.1,42.2,12
7.624,13,18,33.0,26,326.86,0.646,23,19,0.022,45,13,41.8,42,5,45.2,42.9,12
7.82,17,24,44.0,34,404.5,0.643,30,24,0.086,58,18,54.232,54,7,44.4,44.4,16
7.09,13,21,32.0,25,306.49,0.599,23,26,0.098,51,13,47.807,49,8,53.1,42.9,12
4.05,16,21,37.0,28,331.45,0.642,25,21,0.041,49,15,45.585,46,5,45.7,45.7,12
5.261,9,17,30.5,23,282.37,0.633,21,18,0.098,41,12,38.927,39,6,46.2,43.6,11
5.347,13,25,40.0,33,424.66,0.606,30,32,0.123,65,13,61.189,62,12,51.6,40.3,12
5.71,1,22,31.0,28,343.56,0.567,25,33,0.0,61,2,56.894,58,19,56.9,37.9,0
5.437,20,26,41.0,31,368.56,0.623,28,28,0.102,59,19,54.69,56,6,50.0,46.4,18
5.076,10,20,32.5,26,325.5,0.59,24,27,0.132,53,12,50.236,51,10,52.9,39.2,11
7.01,13,19,30.0,23,278.43,0.612,21,22,0.089,45,13,42.04,43,6,51.2,44.2,12
5.0,13,19,35.0,27,322.45,0.62,24,22,0.082,49,16,45.687,46,6,47.8,41.3,16
5.32,12,22,33.0,27,339.55,0.579,25,31,0.103,58,12,54.843,56,10,55.4,39.3,12
7.409,21,37,65.0,53,662.82,0.625,48,41,0.096,94,21,89.927,89,16,46.1,41.6,18
5.854,1,11,16.0,15,197.31,0.551,14,19,0.088,34,1,32.709,33,10,57.6,33.3,0
5.699,12,21,36.0,30,354.46,0.619,26,24,0.037,54,12,50.072,50,9,48.0,42.0,12
5.553,13,19,32.0,25,292.41,0.631,22,20,0.044,45,13,41.483,42,6,47.6,45.2,12
7.733,7,21,29.0,25,331.55,0.559,24,33,0.155,58,7,55.894,57,14,57.9,36.8,6
7.454,14,19,29.0,22,263.41,0.617,20,21,0.07,43,13,39.938,41,5,51.2,46.3,12
4.32,4,10,15.5,13,165.26,0.571,12,15,0.036,28,5,26.614,27,6,55.6,37.0,5
4.25,4,9,14.5,12,151.23,0.579,11,13,0.04,25,5,23.731,24,5,54.2,37.5,5
6.24,6,19,27.0,24,320.57,0.568,22,30,0.074,54,6,50.818,52,13,57.7,36.5,6
4.16,4,9,14.5,12,151.23,0.579,11,13,0.04,25,5,23.731,24,5,54.2,37.5,5
4.06,4,8,13.5,11,137.2,0.589,10,11,0.045,22,5,20.847,21,4,52.4,38.1,5
4.05,4,8,13.5,11,137.2,0.589,10,11,0.045,22,5,20.847,21,4,52.4,38.1,5
4.53,4,9,14.5,12,151.23,0.579,11,13,0.04,25,5,23.731,24,5,54.2,37.5,5
4.1,4,9,14.5,12,151.23,0.579,11,13,0.04,25,5,23.731,24,5,54.2,37.5,5
5.873,22,27,53.0,40,531.94,0.688,37,21,0.131,61,24,60.203,58,5,36.2,46.6,22
8.699,25,29,55.5,41,497.56,0.674,37,24,0.108,65,26,61.847,61,4,39.3,47.5,23
4.23,4,10,15.5,13,165.26,0.571,12,15,0.036,28,5,26.614,27,6,55.6,37.0,5
5.0,12,20,35.0,29,339.42,0.634,25,21,0.04,50,12,46.247,46,8,45.7,43.5,12
4.301,13,25,44.0,35,415.59,0.619,31,29,0.063,64,14,59.44,60,11,48.3,41.7,12
8.0,3,15,25.0,22,327.55,0.531,23,33,0.255,55,3,55.527,56,12,58.9,26.8,0
4.301,13,24,41.0,34,425.02,0.618,30,29,0.063,63,13,58.545,59,11,49.2,40.7,12
4.301,13,24,45.0,36,435.58,0.616,32,29,0.077,65,15,61.094,61,11,47.5,39.3,12
5.18,13,23,42.0,34,405.55,0.62,30,27,0.033,61,14,56.883,57,10,47.4,40.4,12
5.61,13,23,42.0,34,405.55,0.62,30,27,0.033,61,14,56.883,57,10,47.4,40.4,12
4.301,13,25,44.0,37,458.58,0.618,33,29,0.061,66,13,62.643,62,12,46.8,40.3,12
7.528,12,21,34.0,28,370.63,0.622,25,26,0.074,54,12,49.96,51,9,51.0,41.2,12
6.041,4,17,29.0,25,369.59,0.54,26,35,0.25,60,4,60.738,61,13,57.4,27.9,0
6.303,1,14,20.0,19,255.4,0.546,18,25,0.136,44,1,42.687,43,13,58.1,32.6,0
5.808,16,33,59.5,49,586.75,0.621,43,38,0.057,87,16,81.392,81,17,46.9,40.7,11
6.301,12,18,30.0,24,427.31,0.628,23,22,0.174,46,12,44.872,45,6,48.9,40.0,12
4.523,13,23,45.0,36,458.61,0.629,32,27,0.063,63,15,59.581,59,10,45.8,39.0,12
8.041,8,20,36.0,31,387.54,0.589,28,29,0.1,60,8,57.094,57,12,50.9,35.1,6
4.523,13,23,45.0,36,458.61,0.629,32,27,0.063,63,15,59.581,59,10,45.8,39.0,12
4.523,14,25,48.0,40,519.65,0.636,36,28,0.059,68,14,65.265,64,11,43.8,39.1,12
4.523,13,23,45.0,36,458.61,0.629,32,27,0.063,63,15,59.581,59,10,45.8,39.0,12
4.523,14,25,49.0,41,537.64,0.642,37,27,0.059,68,14,65.778,64,11,42.2,39.1,12
4.523,13,23,45.0,36,519.51,0.64,32,27,0.063,63,15,59.298,59,10,45.8,39.0,12
4.523,14,25,49.0,41,537.64,0.642,37,27,0.059,68,14,65.778,64,11,42.2,39.1,12
4.523,14,25,49.0,41,554.09,0.649,37,27,0.059,68,14,65.589,64,11,42.2,39.1,12
4.301,13,25,45.0,38,476.57,0.624,34,28,0.061,66,13,63.156,62,12,45.2,40.3,12
6.613,12,19,33.0,27,329.4,0.632,24,20,0.085,47,12,44.432,44,7,45.5,43.2,12
4.301,13,24,41.0,34,425.02,0.618,30,29,0.063,63,13,58.545,59,11,49.2,40.7,12
4.301,13,25,42.0,35,422.6,0.606,31,31,0.061,66,13,61.618,62,12,50.0,40.3,12
4.301,13,25,42.0,35,422.6,0.606,31,31,0.061,66,13,61.618,62,12,50.0,40.3,12
4.301,13,25,45.0,36,450.03,0.633,32,28,0.063,64,14,59.763,60,11,46.7,41.7,12
8.041,8,20,35.0,30,372.52,0.592,27,28,0.069,58,8,54.992,55,12,50.9,36.4,6
4.301,13,25,45.0,38,476.57,0.624,34,28,0.061,66,13,63.156,62,12,45.2,40.3,12
5.99,12,20,34.0,27,341.51,0.626,24,23,0.06,50,13,46.552,47,8,48.9,42.6,12
6.45,6,20,31.0,27,347.57,0.585,24,29,0.054,56,7,52.203,53,14,54.7,37.7,6
6.35,6,20,31.0,27,347.57,0.585,24,29,0.054,56,7,52.203,53,14,54.7,37.7,6
6.59,6,20,31.0,27,347.57,0.585,24,29,0.054,56,7,52.203,53,14,54.7,37.7,6
5.983,14,39,66.5,56,758.03,0.579,54,59,0.209,115,16,113.639,113,25,52.2,34.5,11
5.0,7,16,27.0,23,292.39,0.598,21,21,0.091,44,7,42.207,42,9,50.0,38.1,6
4.29,4,9,14.5,12,151.23,0.579,11,13,0.04,25,5,23.731,24,5,54.2,37.5,5
4.61,4,10,15.5,13,165.26,0.571,12,15,0.036,28,5,26.614,27,6,55.6,37.0,5
4.301,13,24,46.0,37,470.02,0.63,33,28,0.077,65,15,61.418,61,11,45.9,39.3,12
4.301,13,24,42.0,35,459.46,0.632,31,28,0.063,63,13,58.869,59,11,47.5,40.7,12
7.796,16,21,33.0,25,287.43,0.635,22,21,0.0,46,14,41.938,43,5,48.8,48.8,12
9.469,7,17,27.0,23,289.41,0.59,21,23,0.109,46,7,43.803,44,10,52.3,38.6,6
4.301,13,25,45.0,38,493.02,0.631,34,28,0.061,66,13,62.967,62,12,45.2,40.3,12
4.523,13,23,45.0,36,475.06,0.637,32,27,0.063,63,15,59.392,59,10,45.8,39.0,12
4.301,13,25,45.0,38,476.57,0.624,34,28,0.061,66,13,63.156,62,12,45.2,40.3,12
4.301,13,25,42.0,35,422.6,0.606,31,31,0.061,66,13,61.618,62,12,50.0,40.3,12
6.134,13,25,41.0,34,404.61,0.6,30,32,0.061,66,13,61.105,62,12,51.6,40.3,12
6.395,12,20,34.0,27,341.51,0.626,24,23,0.06,50,13,46.552,47,8,48.9,42.6,12
4.301,13,25,42.0,35,439.05,0.613,31,31,0.061,66,13,61.429,62,12,50.0,40.3,12
4.523,14,15,29.0,21,316.16,0.728,19,10,0.065,31,14,29.404,29,1,34.5,51.7,12
5.82,6,20,31.0,27,347.57,0.585,24,29,0.054,56,7,52.203,53,14,54.7,37.7,6
4.55,4,10,15.5,13,166.27,0.56,12,16,0.034,29,5,27.556,28,6,57.1,35.7,5
5.996,13,19,32.5,25,309.46,0.65,22,19,0.0,44,13,40.458,41,6,46.3,46.3,11
7.1,5,22,34.5,30,423.69,0.566,29,37,0.239,67,7,65.385,66,17,56.1,33.3,5
7.515,6,21,32.0,28,362.61,0.576,25,32,0.05,60,7,56.029,57,15,56.1,36.8,6
6.52,6,21,32.0,28,362.61,0.576,25,32,0.05,60,7,56.029,57,15,56.1,36.8,6
6.83,12,21,35.0,28,356.55,0.612,25,26,0.056,54,13,50.378,51,9,51.0,41.2,12
5.946,15,23,36.0,28,349.51,0.609,26,27,0.145,55,14,52.243,53,8,50.9,43.4,12
6.835,15,21,34.0,26,321.45,0.622,24,23,0.122,49,14,46.476,47,6,48.9,44.7,12
6.585,6,21,32.0,28,362.61,0.576,25,32,0.05,60,7,56.029,57,15,56.1,36.8,6
6.325,15,21,34.0,26,321.45,0.622,24,23,0.122,49,14,46.476,47,6,48.9,44.7,12
5.935,15,23,36.0,28,349.51,0.609,26,27,0.145,55,14,52.243,53,8,50.9,43.4,12
7.5,4,20,30.5,27,381.65,0.559,26,35,0.226,62,6,60.174,61,16,57.4,32.8,5
5.801,14,19,34.0,26,340.47,0.608,25,24,0.2,50,14,48.898,49,5,49.0,38.8,12
9.699,15,26,46.0,37,484.71,0.633,33,30,0.149,67,17,62.876,63,11,47.6,41.3,16
5.29,4,11,16.5,14,180.3,0.555,13,18,0.031,32,5,30.44,31,7,58.1,35.5,5
5.367,7,17,29.0,25,326.4,0.607,23,21,0.087,46,7,44.789,44,10,47.7,38.6,6
8.6,6,19,40.0,34,487.67,0.608,32,29,0.254,63,11,62.229,61,13,47.5,31.1,10
4.67,4,10,15.5,13,166.27,0.56,12,16,0.034,29,5,27.556,28,6,57.1,35.7,5
4.86,4,11,16.5,14,180.3,0.555,13,18,0.031,32,5,30.44,31,7,58.1,35.5,5
5.19,4,10,15.5,13,166.27,0.56,12,16,0.034,29,5,27.556,28,6,57.1,35.7,5
6.415,6,21,32.0,28,362.61,0.576,25,32,0.05,60,7,56.029,57,15,56.1,36.8,6
6.455,15,22,38.0,29,351.45,0.638,26,22,0.098,51,17,47.989,48,7,45.8,45.8,16
5.36,4,11,16.5,14,180.3,0.555,13,18,0.031,32,5,30.44,31,7,58.1,35.5,5
5.93,12,21,35.0,28,356.55,0.612,25,26,0.056,54,13,50.378,51,9,51.0,41.2,12
6.05,3,22,30.0,28,345.58,0.557,25,35,0.032,63,2,58.778,60,19,58.3,36.7,0
7.02,6,19,29.0,25,336.57,0.571,23,30,0.073,55,7,52.145,53,13,56.6,35.8,6
6.0,3,22,30.0,28,345.58,0.557,25,35,0.032,63,2,58.778,60,19,58.3,36.7,0
6.524,12,17,28.0,22,284.46,0.624,20,20,0.095,42,12,39.232,40,5,50.0,42.5,12
5.41,13,20,31.0,24,292.46,0.605,22,24,0.104,48,13,44.923,46,7,52.2,43.5,12
6.43,10,23,34.5,29,354.56,0.58,26,32,0.066,61,11,56.952,58,13,55.2,39.7,11
7.48,10,23,34.5,29,354.56,0.58,26,32,0.066,61,11,56.952,58,13,55.2,39.7,11
5.63,10,23,34.5,29,354.56,0.58,26,32,0.066,61,11,56.952,58,13,55.2,39.7,11
6.26,10,22,33.5,28,339.52,0.589,25,29,0.07,57,11,53.127,54,12,53.7,40.7,11
8.37,10,23,34.5,29,354.56,0.58,26,32,0.066,61,11,56.952,58,13,55.2,39.7,11
7.71,10,23,33.5,28,338.56,0.577,25,32,0.067,60,11,55.625,57,13,56.1,40.4,11
7.19,16,23,37.5,29,348.5,0.616,26,26,0.073,55,17,51.301,52,7,50.0,44.2,17
7.81,10,23,34.5,29,354.56,0.58,26,32,0.066,61,11,56.952,58,13,55.2,39.7,11
5.51,10,22,33.5,28,339.52,0.589,25,29,0.07,57,11,53.127,54,12,53.7,40.7,11
8.4,10,22,33.5,28,339.52,0.589,25,29,0.07,57,11,53.127,54,12,53.7,40.7,11
6.8,16,22,35.5,27,317.46,0.628,24,23,0.08,50,17,46.149,47,6,48.9,46.8,17
7.26,10,22,33.5,28,339.52,0.589,25,29,0.07,57,11,53.127,54,12,53.7,40.7,11
6.21,3,22,30.0,28,345.58,0.557,25,35,0.032,63,2,58.778,60,19,58.3,36.7,0
6.98,16,22,36.5,28,333.46,0.63,25,23,0.078,51,17,47.476,48,6,47.9,45.8,17
7.11,10,22,32.5,27,323.52,0.587,24,29,0.071,56,11,51.8,53,12,54.7,41.5,11
6.191,14,22,42.0,34,444.54,0.612,32,28,0.194,62,14,60.974,60,8,46.7,36.7,12
6.521,15,24,44.0,35,422.52,0.63,31,26,0.082,61,17,57.443,57,9,45.6,42.1,16
7.42,16,23,36.5,28,332.5,0.614,25,26,0.074,54,17,49.974,51,7,51.0,45.1,17
7.85,10,22,33.5,28,339.52,0.589,25,29,0.07,57,11,53.127,54,12,53.7,40.7,11
5.341,6,20,26.0,23,337.63,0.55,23,35,0.207,58,6,56.527,58,14,60.3,34.5,6
6.1,3,22,30.0,28,345.58,0.557,25,35,0.032,63,2,58.778,60,19,58.3,36.7,0
4.0,0,9,12.0,12,174.3,0.514,12,20,0.063,32,0,31.651,32,9,62.5,28.1,0
5.324,14,21,38.0,30,350.45,0.634,26,22,0.038,52,16,48.022,48,7,45.8,43.8,16
4.52,0,11,14.0,14,202.36,0.513,14,24,0.053,38,0,37.418,38,11,63.2,28.9,0
4.59,0,11,14.0,14,202.36,0.513,14,24,0.053,38,0,37.418,38,11,63.2,28.9,0
4.27,0,12,15.0,15,216.39,0.513,15,26,0.049,41,0,40.301,41,12,63.4,29.3,0
4.0,0,10,13.0,13,188.33,0.514,13,22,0.057,35,0,34.534,35,10,62.9,28.6,0
4.0,0,10,13.0,13,188.33,0.514,13,22,0.057,35,0,34.534,35,10,62.9,28.6,0
4.03,0,9,12.0,12,174.3,0.514,12,20,0.063,32,0,31.651,32,9,62.5,28.1,0
4.35,0,10,13.0,13,188.33,0.514,13,22,0.057,35,0,34.534,35,10,62.9,28.6,0
4.0,0,10,13.0,13,188.33,0.514,13,22,0.057,35,0,34.534,35,10,62.9,28.6,0
4.24,0,11,14.0,14,202.36,0.513,14,24,0.053,38,0,37.418,38,11,63.2,28.9,0
4.06,0,11,14.0,14,202.36,0.513,14,24,0.053,38,0,37.418,38,11,63.2,28.9,0
4.51,0,10,13.0,13,188.33,0.514,13,22,0.057,35,0,34.534,35,10,62.9,28.6,0
5.0,14,21,36.5,28,350.51,0.608,26,26,0.093,54,17,51.454,52,7,50.0,40.4,17
7.268,15,23,42.0,33,392.49,0.636,29,24,0.07,57,17,53.232,53,8,45.3,43.4,16
6.3,15,22,41.0,32,378.46,0.643,28,22,0.056,54,17,50.349,50,7,44.0,44.0,16
6.477,15,22,41.0,32,378.46,0.643,28,22,0.074,54,17,50.349,50,7,44.0,44.0,16
5.523,6,14,27.0,22,258.36,0.608,19,18,0.025,40,10,36.92,37,8,48.6,37.8,10
6.6,6,14,23.0,20,286.22,0.632,18,17,0.108,37,6,35.029,35,8,48.6,40.0,6
4.0,0,10,13.0,13,188.33,0.514,13,22,0.057,35,0,34.534,35,10,62.9,28.6,0
4.0,0,9,15.0,14,203.34,0.562,13,17,0.032,31,1,29.902,30,9,56.7,30.0,0
4.0,0,9,15.0,14,203.34,0.562,13,17,0.032,31,1,29.902,30,9,56.7,30.0,0
4.0,0,9,15.0,14,203.34,0.562,13,17,0.032,31,1,29.902,30,9,56.7,30.0,0
4.0,0,9,15.0,14,203.34,0.562,13,17,0.032,31,1,29.902,30,9,56.7,30.0,0
6.444,15,24,43.0,34,406.52,0.629,30,26,0.083,60,17,56.116,56,9,46.4,42.9,16
5.824,15,23,43.0,34,408.49,0.637,30,24,0.086,58,17,54.56,54,8,44.4,42.6,16
5.579,21,28,51.0,39,454.56,0.654,34,26,0.077,65,23,60.116,60,7,43.3,46.7,22
5.003,15,21,39.0,30,348.43,0.651,26,20,0.04,50,17,46.138,46,6,43.5,45.7,16
5.789,15,24,43.0,34,406.52,0.629,30,26,0.083,60,17,56.116,56,9,46.4,42.9,16
5.688,15,24,43.0,34,406.52,0.629,30,26,0.067,60,17,56.116,56,9,46.4,42.9,16
8.276,14,20,30.0,23,277.44,0.609,21,23,0.065,46,13,42.821,44,6,52.3,45.5,12
5.44,15,25,42.0,33,645.35,0.645,31,29,0.177,62,17,59.476,60,10,48.3,41.7,16
7.481,1,9,14.0,13,169.25,0.561,12,15,0.071,28,1,26.942,27,8,55.6,33.3,0
8.548,12,17,28.0,22,284.46,0.624,20,20,0.071,42,12,39.232,40,5,50.0,42.5,12
5.685,12,18,29.0,23,264.4,0.62,20,20,0.0,43,12,39.156,40,6,50.0,45.0,12
5.102,1,9,14.0,13,169.25,0.561,12,15,0.071,28,1,26.942,27,8,55.6,33.3,0
6.497,12,18,28.0,22,266.42,0.603,20,22,0.068,44,12,41.04,42,6,52.4,42.9,12
5.998,19,25,40.0,30,372.58,0.606,28,30,0.067,60,16,56.734,58,6,51.7,43.1,12
6.429,12,17,26.0,20,255.39,0.6,19,21,0.146,41,12,39.265,40,5,52.5,42.5,12
5.07,1,7,10.0,9,146.24,0.515,10,16,0.16,25,1,25.883,26,6,61.5,26.9,0
7.174,3,9,16.5,14,182.25,0.579,13,14,0.071,28,5,27.16,27,6,51.9,33.3,5
7.523,3,10,19.5,15,192.24,0.619,14,12,0.074,27,6,26.276,26,5,46.2,38.5,5
4.959,9,19,31.0,26,331.45,0.596,24,25,0.118,51,8,49.014,49,10,51.0,38.8,6
4.79,8,18,30.0,25,333.49,0.612,23,23,0.104,48,8,45.88,46,10,50.0,39.1,6
6.814,12,17,29.0,23,318.9,0.645,21,19,0.095,42,12,39.556,40,5,47.5,42.5,12
10.155,12,26,40.0,33,425.69,0.594,30,35,0.088,68,13,63.854,65,14,53.8,40.0,12
9.481,14,26,43.0,34,439.67,0.606,31,33,0.09,67,15,63.298,64,12,51.6,40.6,12
7.779,11,17,31.5,25,312.48,0.631,22,20,0.022,45,12,41.552,42,6,47.6,40.5,11
8.043,13,25,43.0,34,441.64,0.612,31,31,0.092,65,15,61.741,62,12,50.0,40.3,12
6.779,13,21,37.0,30,383.56,0.625,27,25,0.109,55,13,51.756,52,8,48.1,40.4,12
7.73,12,25,45.0,35,453.66,0.615,32,31,0.091,66,15,62.734,63,12,49.2,39.7,12
5.46,12,22,39.0,33,437.58,0.624,30,26,0.102,59,12,56.734,56,10,46.4,39.3,12
5.866,12,20,34.0,28,373.99,0.63,25,24,0.077,52,12,48.425,49,8,49.0,40.8,12
4.323,3,8,13.0,11,155.22,0.567,11,13,0.083,24,2,24.058,24,5,54.2,33.3,0
5.04,7,14,25.0,19,281.79,0.616,19,18,0.108,37,8,37.193,37,5,48.6,37.8,6
5.703,13,23,38.0,30,400.01,0.603,28,30,0.15,60,16,57.327,58,10,51.7,39.7,16
5.445,0,19,22.0,22,277.55,0.527,20,35,0.07,57,0,53.123,55,19,63.6,34.5,0
5.487,7,16,24.0,20,260.42,0.571,19,24,0.068,44,7,42.251,43,9,55.8,37.2,6
5.301,1,12,19.0,16,206.32,0.575,15,18,0.059,34,2,32.6,33,9,54.5,36.4,0
8.93,13,21,33.0,26,324.48,0.601,24,26,0.096,52,13,49.301,50,8,52.0,42.0,12
5.673,15,18,34.5,26,381.7,0.704,24,15,0.146,41,17,39.571,39,3,38.5,46.2,17
5.58,12,17,28.0,22,306.25,0.66,20,17,0.051,39,12,36.702,37,5,45.9,45.9,12
5.658,1,14,20.0,19,237.38,0.556,17,23,0.071,42,1,39.476,40,13,57.5,35.0,0
5.317,20,26,40.0,30,371.56,0.616,28,29,0.136,59,19,55.8,57,6,50.9,45.6,18
6.511,7,14,23.0,19,231.32,0.608,17,17,0.083,36,7,33.825,34,7,50.0,41.2,6
6.468,13,17,32.0,25,312.83,0.656,22,17,0.024,42,13,38.916,39,4,43.6,43.6,12
6.214,7,15,24.0,20,245.35,0.6,18,19,0.077,39,7,36.709,37,8,51.4,40.5,6
6.903,12,18,27.0,21,269.42,0.594,20,23,0.136,44,12,42.149,43,6,53.5,41.9,12
5.495,15,18,35.5,27,416.14,0.725,25,14,0.146,41,17,39.895,39,3,35.9,46.2,17
5.2,4,9,13.5,11,154.26,0.544,11,16,0.074,27,5,26.556,27,5,59.3,33.3,5
6.567,12,21,31.0,25,309.49,0.592,23,27,0.115,52,12,48.916,50,9,54.0,42.0,12
5.782,20,26,41.0,31,406.0,0.631,29,28,0.153,59,19,56.123,57,6,49.1,45.6,18
5.796,1,8,11.0,10,160.27,0.515,11,18,0.143,28,1,28.767,29,7,62.1,27.6,0
7.6,13,19,37.0,29,351.45,0.633,26,21,0.04,50,14,47.232,47,6,44.7,40.4,12
