pXC50,nBO,nSK,SCBO,nCsp3,N.,nC,nCsp2,nH,Sv,Se,Sp,Si,nBT,nAT,nN,nHet,MW,RBN,nBM,nAB,Mi,nCsp,nCL,nX,nO,nF,RBF,C.
5.45,30,27,42.5,1,7.0,21,20,16,30.037,43.407,31.387,47.87,46,43,3,6,377.47,4,24,23,1.113,0,0,1,1,1,0.087,48.8
5.4,28,25,39.5,1,10.0,20,19,15,28.074,40.033,29.449,44.428,43,40,4,5,346.84,4,23,23,1.111,0,1,1,0,0,0.093,50.0
5.226,37,33,51.5,3,11.3,24,21,20,35.96,53.778,36.727,59.524,57,53,6,9,440.5,7,28,27,1.123,0,0,0,3,0,0.123,45.3
6.553,46,42,58.5,12,8.6,32,20,39,49.723,80.832,52.586,91.76,85,81,7,10,569.78,11,24,23,1.133,0,0,0,3,0,0.129,39.5
5.4,43,39,55.0,11,6.6,31,20,37,46.68,75.629,49.574,85.763,80,76,5,8,527.73,8,23,22,1.128,0,0,0,3,0,0.1,40.8
4.178,28,25,39.5,1,4.8,22,21,17,29.085,41.596,30.961,46.262,45,42,2,3,344.86,4,23,23,1.101,0,1,1,0,0,0.089,52.4
5.0,27,25,34.0,4,5.1,17,13,14,27.598,40.345,29.404,44.081,41,39,2,8,478.68,6,13,12,1.13,0,1,4,2,2,0.146,43.6
8.301,44,40,60.0,5,6.1,29,24,26,44.664,67.232,46.421,74.017,70,66,4,11,581.11,11,30,28,1.121,0,1,2,4,1,0.157,43.9
7.268,50,44,63.0,16,9.4,34,18,41,52.669,84.487,56.302,96.198,91,85,8,10,613.28,9,26,26,1.132,0,1,1,1,0,0.099,40.0
7.268,47,41,60.0,14,10.1,32,18,38,48.788,78.396,51.921,89.424,85,79,8,9,550.78,6,26,26,1.132,0,0,0,1,0,0.071,40.5
5.771,31,29,41.5,6,5.8,22,14,23,33.191,52.451,34.449,58.485,54,52,3,7,393.48,10,18,17,1.125,2,0,0,4,0,0.185,42.3
5.416,39,36,51.0,7,9.4,26,19,28,41.09,64.705,42.875,72.675,67,64,6,10,511.05,11,23,22,1.136,0,1,2,2,1,0.164,40.6
6.208,40,36,52.0,7,9.7,26,19,26,40.564,62.821,42.114,70.26,66,62,6,10,509.03,9,23,22,1.133,0,1,2,2,1,0.136,41.9
5.301,42,38,54.0,8,9.1,27,19,28,42.805,67.032,44.33,74.884,70,66,6,11,539.06,9,23,22,1.135,0,1,2,3,1,0.129,40.9
5.301,41,37,53.0,8,10.8,26,18,28,41.916,65.738,43.637,73.628,69,65,7,11,522.06,9,23,22,1.133,0,1,1,3,0,0.13,40.0
6.03,35,32,47.0,4,7.7,23,19,20,35.182,53.178,36.034,58.642,55,52,4,9,454.92,8,23,22,1.128,0,1,2,3,1,0.145,44.2
5.65,44,40,56.0,10,9.6,29,19,33,46.165,73.574,48.404,83.003,77,73,7,11,566.14,10,23,22,1.137,0,1,2,2,1,0.13,39.7
6.074,43,39,55.0,9,10.0,28,19,31,44.639,70.69,46.642,79.588,74,70,7,11,552.11,9,23,22,1.137,0,1,2,2,1,0.122,40.0
5.8,24,22,31.5,7,7.0,16,9,21,26.422,42.989,28.426,48.571,45,43,3,6,319.47,2,13,11,1.13,0,0,0,2,0,0.044,37.2
5.8,38,35,50.0,5,12.7,21,16,20,36.846,57.378,36.955,63.377,58,55,7,14,507.55,7,21,18,1.152,0,0,3,3,3,0.121,38.2
5.0,41,37,53.0,9,10.0,28,19,33,43.428,69.854,45.847,79.305,74,70,7,9,499.68,7,23,22,1.133,0,0,0,2,0,0.095,40.0
6.018,40,37,52.0,8,9.0,27,19,30,42.617,67.589,44.637,76.09,70,67,6,10,525.08,11,23,22,1.136,0,1,2,2,1,0.157,40.3
5.0,23,21,30.0,3,3.0,16,13,12,23.906,33.585,25.364,36.446,35,33,1,5,340.64,2,13,12,1.104,0,3,3,1,0,0.057,48.5
5.0,22,20,29.0,3,3.0,16,13,13,23.079,33.262,24.506,36.502,35,33,1,4,306.2,2,13,12,1.106,0,2,2,1,0,0.057,48.5
7.066,50,44,67.5,4,10.1,32,28,25,47.801,70.305,49.086,77.658,75,69,7,12,609.71,7,34,33,1.125,0,0,2,2,2,0.093,46.4
8.319,48,42,65.5,4,10.1,32,28,27,47.034,69.28,49.211,76.979,75,69,7,10,573.73,7,34,33,1.116,0,0,0,2,0,0.093,46.4
7.066,50,44,67.5,4,10.1,32,28,25,47.801,70.305,49.086,77.658,75,69,7,12,609.71,7,34,33,1.125,0,0,2,2,2,0.093,46.4
5.854,49,43,63.5,11,9.0,33,22,35,50.142,77.814,53.256,87.64,84,78,7,10,593.82,8,28,27,1.124,0,0,0,2,0,0.095,42.3
5.886,48,42,62.5,10,9.3,32,22,33,48.615,74.93,51.495,84.225,81,75,7,10,579.79,8,28,27,1.123,0,0,0,2,0,0.099,42.7
6.77,49,43,66.5,4,11.3,32,28,28,48.056,71.381,50.216,79.477,77,71,8,11,588.75,7,34,33,1.119,0,0,0,2,0,0.091,45.1
6.77,49,43,66.5,4,10.0,32,28,27,47.749,70.607,49.665,78.188,76,70,7,11,589.73,8,34,33,1.117,0,0,0,3,0,0.105,45.7
6.432,49,43,66.5,5,9.7,33,28,29,48.561,72.163,50.972,80.394,78,72,7,10,587.76,8,34,33,1.117,0,0,0,2,0,0.103,45.8
7.569,48,43,65.5,4,10.0,32,28,27,47.613,70.861,49.392,78.864,75,70,7,11,595.73,9,34,33,1.127,0,0,2,1,2,0.12,45.7
7.508,52,46,69.5,6,10.5,34,28,30,51.161,76.847,53.16,85.778,82,76,8,12,636.79,8,34,33,1.129,0,0,2,1,2,0.098,44.7
8.143,48,42,65.5,3,10.8,31,28,23,45.559,66.094,46.87,73.034,71,65,7,11,579.68,6,34,33,1.124,0,0,2,1,2,0.085,47.7
6.167,49,43,66.5,5,9.7,33,28,29,48.561,72.163,50.972,80.394,78,72,7,10,587.76,8,34,33,1.117,0,0,0,2,0,0.103,45.8
6.796,48,42,65.5,5,9.9,33,28,29,47.846,70.836,50.517,79.185,77,71,7,9,571.76,7,34,33,1.115,0,0,0,1,0,0.091,46.5
6.64,51,45,68.5,7,10.1,35,28,34,51.921,78.705,55.046,88.513,85,79,8,10,614.84,9,34,33,1.12,0,0,0,1,0,0.106,44.3
6.824,47,42,64.5,5,9.6,33,28,31,48.373,72.72,51.279,81.6,78,73,7,9,573.78,10,34,33,1.118,0,0,0,1,0,0.128,45.2
6.921,47,41,64.5,4,10.3,32,28,27,46.32,67.952,48.756,75.77,74,68,7,9,557.73,7,34,33,1.114,0,0,0,1,0,0.095,47.1
6.62,34,30,48.5,0,8.9,23,23,15,32.976,45.436,34.551,49.558,49,45,4,7,430.94,4,28,27,1.101,0,1,1,1,0,0.082,51.1
5.0,37,32,50.5,5,9.1,26,21,23,36.563,54.789,38.336,61.438,60,55,5,6,421.54,3,27,27,1.117,0,0,0,1,0,0.05,47.3
8.201,41,36,58.5,0,10.7,28,28,20,39.718,56.2,41.466,62.026,61,56,6,8,488.61,6,34,33,1.108,0,0,0,1,0,0.098,50.0
5.222,34,30,49.5,0,13.6,21,21,14,31.852,44.876,32.637,48.989,48,44,6,9,414.48,5,29,27,1.113,0,0,0,2,0,0.104,47.7
4.903,39,34,55.5,0,11.8,25,25,17,37.019,51.64,38.563,56.554,56,51,6,9,485.0,4,32,31,1.109,0,1,1,1,0,0.071,49.0
7.456,42,37,59.5,0,10.7,28,28,19,40.545,56.523,42.324,61.97,61,56,6,9,523.05,6,34,33,1.107,0,1,1,1,0,0.098,50.0
7.509,43,42,53.0,15,3.5,31,16,43,50.319,85.596,52.881,96.474,86,85,3,11,585.77,6,10,0,1.135,0,0,0,8,0,0.07,36.5
4.921,27,25,35.0,7,10.4,18,11,23,29.278,48.116,30.79,54.647,50,48,5,7,341.46,7,16,16,1.138,0,0,0,2,0,0.14,37.5
4.398,29,27,37.0,8,9.6,19,11,25,31.519,52.327,33.006,59.272,54,52,5,8,371.49,8,16,16,1.14,0,0,0,3,0,0.148,36.5
6.495,35,33,48.5,7,8.5,26,16,26,38.642,58.785,41.211,66.11,61,59,5,7,504.47,6,20,17,1.121,3,0,1,1,0,0.098,44.1
4.927,35,33,47.5,5,8.9,24,18,23,37.015,56.836,38.347,63.346,58,56,5,9,467.97,7,20,17,1.131,1,1,2,2,1,0.121,42.9
4.667,32,30,44.5,3,8.3,22,18,18,32.94,48.967,33.818,54.017,50,48,4,8,424.89,6,20,17,1.125,1,1,2,2,1,0.12,45.8
4.627,37,34,49.5,6,8.6,25,18,24,38.545,58.556,40.358,65.113,61,58,5,9,522.44,7,20,17,1.123,1,0,1,3,0,0.115,43.1
4.503,38,35,50.5,6,8.6,25,18,23,38.73,59.163,39.801,65.555,61,58,5,10,495.98,7,20,17,1.13,1,1,2,3,1,0.115,43.1
4.469,39,36,51.5,7,8.2,26,18,25,40.257,62.047,41.563,68.971,64,61,5,10,510.01,7,20,17,1.131,1,1,2,3,1,0.109,42.6
5.358,36,33,48.5,5,9.3,24,18,21,36.489,54.952,37.585,60.931,57,54,5,9,465.95,6,20,17,1.128,1,1,2,2,1,0.105,44.4
5.348,34,32,46.5,4,9.4,23,18,21,35.489,53.952,36.585,59.931,55,53,5,9,453.94,7,20,17,1.131,1,1,2,2,1,0.127,43.4
6.523,30,28,43.5,2,9.3,21,16,15,30.701,43.593,31.853,47.745,45,43,4,7,435.3,4,20,17,1.11,3,0,1,2,0,0.089,48.8
5.527,34,32,46.5,5,8.9,24,18,24,36.83,56.229,38.904,62.904,58,56,5,8,494.43,8,20,17,1.123,1,0,1,2,0,0.138,42.9
6.432,35,33,48.5,7,8.5,26,16,26,38.642,58.785,41.211,66.11,61,59,5,7,504.47,8,20,17,1.121,3,0,1,1,0,0.131,44.1
6.347,33,31,46.5,4,8.0,23,16,19,34.47,50.687,35.83,55.785,52,50,4,8,479.36,7,20,17,1.116,3,0,1,3,0,0.135,46.0
4.82,30,28,42.0,2,7.1,19,16,14,30.571,43.065,32.102,46.398,44,42,3,9,431.95,6,19,16,1.105,1,1,1,3,0,0.136,45.2
5.48,29,28,40.0,3,6.4,20,16,19,31.325,47.76,32.574,52.574,48,47,3,8,397.49,7,16,12,1.119,1,0,0,4,0,0.146,42.6
4.469,38,35,50.5,7,8.2,26,18,26,40.071,61.44,42.12,68.529,64,61,5,9,536.47,8,20,17,1.123,1,0,1,3,0,0.125,42.6
5.8,22,20,31.0,0,6.9,14,14,9,21.792,29.698,22.966,31.838,31,29,2,6,349.22,3,17,16,1.098,0,0,1,2,0,0.097,48.3
4.8,23,23,31.0,4,5.1,15,10,16,25.492,40.102,26.261,43.87,39,39,2,8,336.4,8,10,6,1.125,1,0,0,5,0,0.205,38.5
4.04,22,22,30.0,3,5.6,14,10,14,23.965,37.218,24.5,40.455,36,36,2,8,322.37,7,10,6,1.124,1,0,0,5,0,0.194,38.9
5.34,20,20,29.0,2,6.7,13,9,10,21.196,31.124,21.523,33.415,30,30,2,7,290.32,5,10,6,1.114,2,0,0,4,0,0.167,43.3
5.879,42,38,53.5,12,5.6,29,17,34,45.034,72.047,47.909,80.979,76,72,4,9,534.74,11,22,21,1.125,0,0,0,4,0,0.145,40.3
4.23,15,15,23.0,1,8.7,11,8,8,16.053,23.509,16.205,25.661,23,23,2,4,200.21,1,9,6,1.116,2,0,0,2,0,0.043,47.8
5.674,30,28,43.5,2,9.3,21,16,15,30.701,43.593,31.853,47.745,45,43,4,7,435.3,4,20,17,1.11,3,0,1,2,0,0.089,48.8
5.64,39,36,50.5,10,5.9,27,17,32,42.507,68.163,45.148,76.564,71,68,4,9,508.7,13,22,21,1.126,0,0,0,4,0,0.183,39.7
6.89,25,24,35.0,2,5.0,18,15,16,27.062,40.447,28.352,44.451,41,40,2,6,340.43,6,15,12,1.111,1,0,0,3,0,0.146,45.0
6.745,33,31,46.5,4,9.8,23,16,20,34.776,51.462,36.381,57.074,53,51,5,8,478.38,5,20,17,1.119,3,0,1,2,0,0.094,45.1
5.031,33,31,45.5,4,9.4,23,18,22,35.303,53.345,37.142,59.489,55,53,5,8,480.4,7,20,17,1.122,1,0,1,2,0,0.127,43.4
5.298,28,26,40.0,3,7.0,19,16,17,28.611,43.8,29.165,48.239,45,43,3,7,351.39,7,20,16,1.122,0,0,0,4,0,0.156,44.2
5.034,28,26,40.0,3,7.0,19,16,17,28.611,43.8,29.165,48.239,45,43,3,7,351.39,7,20,16,1.122,0,0,0,4,0,0.156,44.2
4.301,25,24,34.5,4,7.3,16,12,17,26.326,42.127,26.619,46.448,42,41,3,8,331.36,8,15,11,1.133,0,0,0,5,0,0.19,39.0
5.234,24,23,33.5,3,8.1,15,12,14,24.468,38.429,24.341,42.163,38,37,3,8,319.32,7,15,11,1.14,0,0,1,4,1,0.184,40.5
5.321,24,23,33.5,3,8.1,15,12,14,24.912,38.24,25.261,41.768,38,37,3,8,335.77,7,15,11,1.129,0,1,1,4,0,0.184,40.5
4.384,24,23,33.5,3,8.1,15,12,14,24.468,38.429,24.341,42.163,38,37,3,8,319.32,7,15,11,1.14,0,0,1,4,1,0.184,40.5
4.438,24,23,33.5,3,8.1,15,12,14,24.912,38.24,25.261,41.768,38,37,3,8,335.77,7,15,11,1.129,0,1,1,4,0,0.184,40.5
4.348,24,23,33.5,3,8.1,15,12,14,25.109,38.145,25.756,41.665,38,37,3,8,380.22,7,15,11,1.126,0,0,1,4,0,0.184,40.5
4.714,26,25,37.5,3,10.3,15,12,14,26.008,40.789,25.557,44.326,40,39,4,10,346.33,8,17,11,1.137,0,0,0,6,0,0.2,38.5
4.776,24,23,33.5,3,8.1,15,12,14,24.468,38.429,24.341,42.163,38,37,3,8,319.32,7,15,11,1.14,0,0,1,4,1,0.184,40.5
5.0,29,26,39.0,4,16.3,15,11,17,28.115,44.189,28.858,49.112,46,43,7,11,375.46,4,18,16,1.142,0,0,0,3,0,0.087,34.9
4.725,25,24,34.5,4,7.3,16,12,17,26.326,42.127,26.619,46.448,42,41,3,8,331.36,8,15,11,1.133,0,0,0,5,0,0.19,39.0
5.917,35,33,47.5,5,8.9,24,18,23,37.015,56.836,38.347,63.346,58,56,5,9,467.97,8,20,17,1.131,1,1,2,2,1,0.138,42.9
5.333,24,23,33.5,3,8.1,15,12,14,25.109,38.145,25.756,41.665,38,37,3,8,380.22,7,15,11,1.126,0,0,1,4,0,0.184,40.5
4.967,23,22,32.5,3,8.1,15,12,15,24.084,37.916,24.404,41.824,38,37,3,7,301.33,7,15,11,1.13,0,0,0,4,0,0.184,40.5
5.015,24,23,33.5,4,7.5,16,12,17,25.611,40.8,26.165,45.239,41,40,3,7,315.36,7,15,11,1.131,0,0,0,4,0,0.171,40.0
8.5,37,34,47.5,7,8.5,24,17,25,38.257,60.047,39.563,66.971,62,59,5,10,485.99,8,19,17,1.135,0,1,2,3,1,0.129,40.7
5.182,25,23,33.0,2,8.3,16,14,13,25.782,36.658,27.404,40.004,38,36,3,7,366.29,2,14,12,1.111,0,2,2,1,0,0.053,44.4
4.844,25,24,34.5,4,7.3,16,12,17,26.326,42.127,26.619,46.448,42,41,3,8,331.36,8,15,11,1.133,0,0,0,5,0,0.19,39.0
5.001,26,25,35.5,6,6.5,18,12,21,28.665,46.567,29.688,52.069,47,46,3,7,343.42,8,15,11,1.132,0,0,0,4,0,0.17,39.1
5.668,30,28,42.5,3,6.4,21,18,19,31.138,47.683,31.926,52.654,49,47,3,7,377.43,8,21,17,1.12,0,0,0,4,0,0.163,44.7
5.461,32,30,44.5,4,5.9,22,18,21,33.379,51.894,34.142,57.279,53,51,3,8,407.46,10,21,17,1.123,0,0,0,5,0,0.189,43.1
4.398,26,25,37.5,3,10.3,15,12,14,26.008,40.789,25.557,44.326,40,39,4,10,346.33,8,17,11,1.137,0,0,0,6,0,0.2,38.5
5.558,26,24,34.0,5,6.7,19,14,21,28.707,44.662,30.972,50.361,47,45,3,5,339.5,3,14,12,1.119,0,0,0,1,0,0.064,42.2
5.8,21,19,29.5,1,9.4,15,14,13,21.413,32.051,22.279,35.78,34,32,3,4,251.31,3,17,17,1.118,0,0,0,1,0,0.088,46.9
5.058,36,33,48.5,5,9.3,24,18,21,36.489,54.952,37.585,60.931,57,54,5,9,465.95,6,20,17,1.128,1,1,2,2,1,0.105,44.4
6.46,29,27,41.0,2,7.1,19,16,15,29.744,42.742,31.244,46.454,44,42,3,8,397.51,6,19,16,1.106,1,0,0,3,0,0.136,45.2
5.82,29,27,41.0,2,7.1,19,16,15,29.271,42.993,30.051,46.744,44,42,3,8,381.44,6,19,16,1.113,1,0,0,4,0,0.136,45.2
5.0,27,26,39.0,2,5.0,19,15,14,28.25,40.891,29.046,44.245,41,40,2,7,366.42,6,16,12,1.106,2,0,0,4,0,0.146,47.5
5.8,32,29,44.0,2,12.8,20,18,18,31.434,47.894,31.966,53.109,50,47,6,9,390.44,6,23,22,1.13,0,0,0,3,0,0.12,42.6
6.15,25,24,35.0,2,7.7,17,14,15,26.557,39.665,27.597,43.534,40,39,3,7,341.42,6,15,12,1.116,1,0,0,3,0,0.15,43.6
5.4,31,28,42.0,0,8.1,19,19,9,29.022,38.8,29.517,41.268,40,37,3,9,436.28,3,17,12,1.115,0,2,4,1,2,0.075,51.4
6.35,28,27,39.0,2,4.7,19,16,16,29.492,44.102,30.261,47.87,44,43,2,8,384.44,7,16,12,1.113,1,0,0,5,0,0.159,44.2
5.0,27,24,35.5,3,7.5,18,15,16,26.565,40.658,27.193,45.16,43,40,3,6,325.37,4,17,17,1.129,0,0,1,2,1,0.093,45.0
6.636,27,25,35.5,5,6.7,19,14,20,28.618,45.425,29.716,50.99,47,45,3,6,341.42,7,17,17,1.133,0,0,1,2,1,0.149,42.2
7.553,34,31,40.0,13,6.6,22,9,30,36.508,61.531,38.193,69.438,64,61,4,9,430.56,5,9,6,1.138,0,0,0,5,0,0.078,36.1
6.845,24,22,32.5,2,8.3,16,14,14,24.68,36.491,25.847,40.247,38,36,3,6,360.23,4,17,17,1.118,0,0,1,2,0,0.105,44.4
6.668,26,24,34.5,4,7.1,18,14,18,27.733,42.258,29.37,47.077,44,42,3,6,388.29,6,17,17,1.121,0,0,1,2,0,0.136,42.9
7.161,26,24,34.5,4,7.1,18,14,18,28.025,42.098,30.676,46.956,44,42,3,6,435.29,6,17,17,1.118,0,0,1,2,0,0.136,42.9
5.608,32,30,44.0,2,4.5,22,19,14,33.975,44.713,38.046,48.066,46,44,2,8,663.08,4,20,18,1.092,1,2,4,2,0,0.087,50.0
5.6,24,23,35.0,2,5.4,18,14,14,25.82,37.236,27.137,40.827,38,37,2,5,322.41,5,15,12,1.103,2,0,0,2,0,0.132,48.6
5.0,29,27,40.0,3,7.3,17,14,14,28.677,42.898,29.091,46.573,43,41,3,10,413.86,6,19,16,1.136,0,1,3,3,2,0.14,41.5
5.8,31,28,39.0,6,8.7,19,13,18,30.211,47.483,30.353,52.622,49,46,4,9,388.41,4,14,12,1.144,0,0,2,3,2,0.082,41.3
5.0,30,26,43.0,1,17.9,18,17,13,27.917,39.44,28.972,43.654,43,39,7,8,359.45,3,26,26,1.119,0,0,0,0,0,0.07,46.2
5.8,34,32,46.0,7,7.1,22,15,24,35.642,57.207,36.364,63.402,58,56,4,10,440.5,9,20,16,1.132,0,0,0,6,0,0.155,39.3
4.523,48,48,57.0,18,7.2,30,12,49,57.02,98.367,60.415,110.932,97,97,7,18,716.0,22,12,6,1.144,0,0,0,9,0,0.227,30.9
5.0,52,44,69.0,9,5.4,35,26,30,49.508,74.531,51.193,82.438,82,74,4,9,586.69,3,32,30,1.114,0,0,0,5,0,0.037,47.3
5.8,34,32,46.0,3,11.5,20,17,20,34.105,53.76,34.091,59.153,54,52,6,12,440.46,9,21,18,1.138,0,0,0,6,0,0.167,38.5
5.538,26,23,36.0,3,15.4,16,13,16,25.477,39.356,26.296,44.275,42,39,6,7,308.38,2,20,20,1.135,0,0,0,1,0,0.048,41.0
5.8,33,29,45.0,3,10.4,22,19,19,32.697,48.098,34.461,53.527,52,48,5,7,401.53,2,23,22,1.115,0,0,0,1,0,0.038,45.8
5.0,34,32,48.0,1,2.1,23,22,15,34.405,48.625,35.307,51.968,49,47,1,9,516.36,8,23,18,1.106,0,0,2,5,1,0.163,48.9
5.4,45,41,54.5,16,7.2,31,15,42,49.47,82.825,52.557,94.301,87,83,6,10,562.79,10,18,17,1.136,0,0,0,4,0,0.115,37.3
5.0,35,32,47.0,2,10.6,21,19,15,32.757,49.4,32.017,54.176,50,47,5,11,445.41,4,23,22,1.153,0,0,4,2,4,0.08,44.7
4.602,19,18,25.0,4,9.7,11,7,13,20.502,31.531,22.029,34.83,32,31,3,7,283.41,5,11,10,1.124,0,0,0,2,0,0.156,35.5
5.395,48,42,61.0,13,11.5,31,18,36,48.666,78.127,51.103,88.847,84,78,9,11,569.76,5,26,26,1.139,0,0,1,1,1,0.06,39.7
4.204,48,42,61.0,12,10.5,31,19,34,48.67,76.254,51.449,86.19,82,76,8,11,633.63,5,26,26,1.134,0,0,2,1,1,0.061,40.8
5.87,47,41,60.0,11,12.5,29,18,31,46.44,72.683,48.438,81.96,78,72,9,12,576.14,5,26,26,1.138,0,1,2,1,1,0.064,40.3
5.281,47,41,60.0,12,12.0,30,18,34,47.583,75.054,50.262,85.036,81,75,9,11,572.18,5,26,26,1.134,0,1,1,1,0,0.062,40.0
8.009,48,42,61.0,13,11.5,31,18,36,49.11,77.938,52.023,88.451,84,78,9,11,586.21,6,26,26,1.134,0,1,1,1,0,0.071,39.7
7.208,48,42,61.0,13,11.5,31,18,36,49.11,77.938,52.023,88.451,84,78,9,11,586.21,6,26,26,1.134,0,1,1,1,0,0.071,39.7
7.668,50,44,63.0,14,11.0,32,18,38,51.352,82.149,54.239,93.076,88,82,9,12,616.24,9,26,26,1.135,0,1,1,2,0,0.102,39.0
6.401,50,44,63.0,14,11.0,32,18,38,51.352,82.149,54.239,93.076,88,82,9,12,616.24,9,26,26,1.135,0,1,1,2,0,0.102,39.0
7.668,51,45,65.0,13,12.2,32,19,37,51.846,82.367,54.483,93.159,88,82,10,13,629.24,7,27,26,1.136,0,1,1,2,0,0.08,39.0
7.821,48,42,61.0,13,11.5,31,18,36,49.11,77.938,52.023,88.451,84,78,9,11,586.21,6,26,26,1.134,0,1,1,1,0,0.071,39.7
7.86,50,44,63.0,14,11.0,32,18,38,51.352,82.149,54.239,93.076,88,82,9,12,616.24,9,26,26,1.135,0,1,1,2,0,0.102,39.0
6.441,47,41,60.0,11,12.5,29,18,31,46.44,72.683,48.438,81.96,78,72,9,12,576.14,5,26,26,1.138,0,1,2,1,1,0.064,40.3
7.538,47,41,60.0,11,12.5,29,18,31,46.884,72.494,49.358,81.565,78,72,9,12,592.59,5,26,26,1.133,0,2,2,1,0,0.064,40.3
7.812,47,41,60.0,11,12.5,29,18,31,46.884,72.494,49.358,81.565,78,72,9,12,592.59,5,26,26,1.133,0,2,2,1,0,0.064,40.3
6.321,47,41,60.0,12,12.0,30,18,34,47.583,75.054,50.262,85.036,81,75,9,11,572.18,5,26,26,1.134,0,1,1,1,0,0.062,40.0
6.699,46,40,59.0,11,12.5,29,18,32,46.056,72.17,48.5,81.621,78,72,9,11,558.15,5,26,26,1.134,0,1,1,1,0,0.064,40.3
6.469,46,40,59.0,11,12.5,29,18,32,46.056,72.17,48.5,81.621,78,72,9,11,558.15,5,26,26,1.134,0,1,1,1,0,0.064,40.3
6.476,45,39,58.0,10,11.8,28,18,29,44.223,68.512,46.188,76.916,74,68,8,11,545.1,5,26,26,1.131,0,1,1,2,0,0.068,41.2
7.839,46,40,59.0,11,12.5,29,18,32,46.056,72.17,48.5,81.621,78,72,9,11,558.15,5,26,26,1.134,0,1,1,1,0,0.064,40.3
5.0,40,37,51.0,11,8.2,27,16,36,44.362,72.923,47.466,82.766,76,73,6,10,524.76,11,20,18,1.134,0,0,0,3,0,0.145,37.0
5.0,31,28,44.0,1,8.7,22,21,18,31.675,45.996,33.455,51.029,49,46,4,6,386.51,5,24,22,1.109,0,0,0,1,0,0.102,47.8
4.602,24,22,31.5,4,8.3,15,11,14,24.669,36.662,26.0,40.269,38,36,3,7,335.84,4,13,11,1.119,0,1,1,2,0,0.105,41.7
5.4,34,32,45.0,2,8.3,21,19,16,33.422,50.32,33.148,54.906,50,48,4,11,464.86,5,20,18,1.144,0,1,4,3,3,0.1,43.8
8.301,38,35,49.5,7,11.5,24,17,26,39.587,61.76,41.37,69.11,64,61,7,11,540.47,9,20,17,1.133,0,0,1,3,0,0.141,39.3
5.8,24,22,32.5,2,11.4,15,13,13,24.449,35.553,25.79,39.143,37,35,4,7,332.84,4,17,17,1.118,0,1,1,1,0,0.108,42.9
7.62,39,36,50.5,7,11.5,24,17,25,39.773,62.367,40.813,69.552,64,61,7,12,514.01,9,20,17,1.14,0,1,2,3,1,0.141,39.3
6.0,23,23,30.0,8,4.3,18,9,24,28.454,46.654,30.944,52.903,47,47,2,5,332.51,5,9,6,1.126,1,0,0,2,0,0.106,38.3
6.959,34,32,45.5,5,8.9,23,18,24,36.545,56.556,38.358,63.113,58,56,5,9,498.42,10,20,17,1.127,0,0,1,3,0,0.172,41.1
6.174,22,21,28.0,6,5.1,13,7,18,24.018,39.985,25.023,44.285,40,39,2,8,314.4,4,9,6,1.136,0,0,0,5,0,0.1,33.3
5.7,27,26,37.0,3,4.7,19,15,17,29.416,43.654,30.972,47.81,44,43,2,7,388.9,7,15,12,1.112,1,1,1,3,0,0.159,44.2
4.68,25,24,35.0,3,4.8,19,15,18,27.402,42.254,28.466,46.946,43,42,2,5,322.39,3,15,12,1.118,1,0,0,3,0,0.07,45.2
6.475,36,33,45.5,8,11.9,22,14,26,37.862,59.603,40.068,66.923,62,59,7,11,488.07,7,18,17,1.134,0,1,1,2,0,0.113,37.3
5.34,30,28,42.5,2,4.3,22,19,18,31.589,46.331,33.114,50.866,48,46,2,6,390.49,6,20,17,1.106,1,0,0,3,0,0.125,47.8
4.347,21,19,26.0,5,15.6,10,5,13,20.546,33.102,21.085,36.701,34,32,5,9,283.35,2,10,10,1.147,0,0,0,3,0,0.059,31.3
5.54,24,23,34.0,1,5.4,17,15,14,25.063,37.814,25.398,41.325,38,37,2,6,310.33,4,15,12,1.117,1,0,0,4,0,0.105,45.9
6.932,40,37,52.5,6,6.5,27,21,25,40.701,63.53,41.336,70.623,65,62,4,10,510.56,11,24,23,1.139,0,0,3,3,3,0.169,43.5
5.0,28,26,36.0,8,11.5,19,11,26,31.111,51.774,33.103,59.351,54,52,6,7,354.51,8,16,16,1.141,0,0,0,1,0,0.148,36.5
5.75,40,37,53.5,8,5.8,28,20,32,43.507,69.163,46.148,77.564,72,69,4,9,520.71,13,25,23,1.124,0,0,0,4,0,0.181,40.6
6.58,29,26,40.5,1,7.0,21,20,17,29.181,43.145,30.256,47.82,46,43,3,5,343.41,5,23,23,1.112,0,0,0,2,0,0.109,48.8
6.631,39,36,52.5,7,6.1,27,20,30,41.98,66.28,44.387,74.148,69,66,4,9,506.68,13,25,23,1.123,0,0,0,4,0,0.188,40.9
5.8,24,21,34.0,1,8.8,17,16,13,23.413,34.051,24.279,37.78,37,34,3,4,275.33,1,18,16,1.111,0,0,0,1,0,0.027,50.0
6.51,30,27,41.5,2,6.5,22,20,19,30.708,46.029,32.017,51.235,49,46,3,5,357.44,6,23,23,1.114,0,0,0,2,0,0.122,47.8
7.022,40,37,53.5,8,5.8,28,20,32,43.507,69.163,46.148,77.564,72,69,4,9,520.71,14,25,23,1.124,0,0,0,4,0,0.194,40.6
6.385,49,45,64.5,11,6.0,36,24,38,53.034,82.836,56.194,93.122,87,83,5,9,624.24,11,26,23,1.122,1,1,1,3,0,0.126,43.4
6.923,43,39,59.0,4,8.1,27,23,23,43.104,63.316,45.097,69.395,66,62,5,12,584.14,10,30,28,1.119,0,1,2,3,1,0.152,43.5
5.489,34,31,47.0,3,10.4,20,17,17,33.809,49.338,35.358,53.94,51,48,5,11,478.01,7,24,22,1.124,0,1,2,2,1,0.137,41.7
5.914,37,34,50.5,7,8.6,26,16,24,38.83,58.229,40.904,64.904,61,58,5,8,518.45,6,20,17,1.119,3,0,1,2,0,0.098,44.8
7.222,44,39,62.0,4,10.9,28,24,25,43.695,64.472,46.097,71.484,69,64,7,11,555.74,9,34,32,1.117,0,0,0,2,0,0.13,43.8
6.499,42,38,58.0,4,8.1,27,23,24,42.721,62.803,45.159,69.056,66,62,5,11,566.15,10,30,28,1.114,0,1,1,3,0,0.152,43.5
5.0,29,27,38.0,3,9.5,17,14,15,29.154,43.64,29.864,47.653,44,42,4,10,457.71,6,17,16,1.135,0,1,3,3,1,0.136,40.5
5.8,32,29,41.5,6,10.4,20,14,19,31.962,49.069,32.824,54.516,51,48,5,9,415.89,4,18,17,1.136,0,1,2,2,1,0.078,41.7
7.77,41,38,53.0,7,7.9,26,19,25,41.55,64.956,42.199,72.065,66,63,5,12,548.01,9,23,22,1.144,0,1,4,3,3,0.136,41.3
7.959,37,34,48.0,5,9.4,22,17,19,35.97,55.305,35.915,60.82,56,53,5,12,493.91,9,22,22,1.148,0,1,4,3,3,0.161,41.5
5.0,42,35,55.0,9,6.6,28,19,26,40.025,61.109,41.762,68.189,68,61,4,7,466.58,2,25,24,1.118,0,0,0,3,0,0.029,45.9
8.387,42,38,58.0,1,6.9,28,27,20,40.897,59.505,41.489,64.851,62,58,4,10,530.97,8,30,28,1.118,0,1,2,4,1,0.129,48.3
8.456,42,38,58.0,1,6.9,28,27,20,41.369,59.254,42.682,64.562,62,58,4,10,547.04,8,30,28,1.113,0,1,2,3,1,0.129,48.3
7.959,43,39,59.5,1,6.6,30,29,22,42.709,62.062,43.796,68.057,65,61,4,9,541.01,8,31,29,1.116,0,1,2,3,1,0.123,49.2
7.921,43,39,59.5,1,6.6,30,29,22,42.709,62.062,43.796,68.057,65,61,4,9,541.01,8,31,29,1.116,0,1,2,3,1,0.123,49.2
8.244,47,42,65.0,1,7.7,32,31,23,45.73,66.163,46.801,72.555,70,65,5,10,580.05,8,35,34,1.116,0,1,2,3,1,0.114,49.2
8.31,47,42,65.0,1,7.7,32,31,23,46.202,65.912,47.995,72.266,70,65,5,10,596.12,8,35,34,1.112,0,1,2,2,1,0.114,49.2
8.06,49,44,68.0,1,7.2,34,33,25,48.257,70.047,49.563,76.971,74,69,5,10,606.09,9,36,34,1.116,0,1,2,3,1,0.122,49.3
7.854,50,45,69.5,1,6.9,36,35,27,50.069,72.603,51.87,80.176,77,72,5,9,616.13,9,37,35,1.114,0,1,2,2,1,0.117,50.0
7.824,50,45,69.5,1,6.9,36,35,27,50.069,72.603,51.87,80.176,77,72,5,9,616.13,9,37,35,1.114,0,1,2,2,1,0.117,50.0
8.328,50,45,68.5,3,6.8,36,33,29,50.596,74.487,52.631,82.592,79,74,5,9,618.15,10,36,35,1.116,0,1,2,2,1,0.127,48.6
8.699,40,36,55.0,1,7.4,26,25,18,38.37,55.622,38.727,60.436,58,54,4,10,504.93,7,29,28,1.119,0,1,2,4,1,0.121,48.1
8.456,40,36,55.0,1,7.4,26,25,18,38.842,55.371,39.921,60.147,58,54,4,10,521.0,7,29,28,1.114,0,1,2,3,1,0.121,48.1
7.648,44,39,58.0,7,12.1,27,20,27,42.967,67.145,43.961,75.106,71,66,8,12,530.62,8,27,26,1.138,0,0,1,3,1,0.113,40.9
6.0,33,29,43.0,7,13.5,20,13,23,32.794,52.436,34.04,59.229,56,52,7,9,393.5,6,20,20,1.139,0,0,0,2,0,0.107,38.5
6.444,32,28,42.0,7,15.4,20,13,24,32.386,51.883,34.137,59.308,56,52,8,8,376.52,4,20,20,1.141,0,0,0,0,0,0.071,38.5
7.699,30,27,40.0,6,10.4,20,12,21,30.751,48.232,32.029,54.232,51,48,5,7,363.46,6,17,16,1.13,2,0,0,2,0,0.118,41.7
8.155,29,26,39.0,6,12.5,20,12,22,30.343,47.68,32.125,54.311,51,48,6,6,346.48,4,17,16,1.131,2,0,0,0,0,0.078,41.7
8.046,27,24,35.0,6,13.0,18,12,22,28.343,45.68,30.125,52.311,49,46,6,6,322.46,4,16,16,1.137,0,0,0,0,0,0.082,39.1
6.056,23,21,28.0,9,13.3,15,6,24,25.87,44.563,27.887,51.727,47,45,6,6,288.45,4,10,10,1.149,0,0,0,0,0,0.085,33.3
7.699,28,25,36.0,7,12.2,19,12,24,29.87,48.563,31.887,55.727,52,49,6,6,336.49,4,16,16,1.137,0,0,0,0,0,0.077,38.8
8.301,28,25,36.0,7,12.2,19,12,24,29.87,48.563,31.887,55.727,52,49,6,6,336.49,4,16,16,1.137,0,0,0,0,0,0.077,38.8
8.222,28,25,36.0,7,12.2,19,12,24,29.87,48.563,31.887,55.727,52,49,6,6,336.49,4,16,16,1.137,0,0,0,0,0,0.077,38.8
8.222,28,25,36.0,6,13.0,18,12,21,28.726,46.192,30.063,52.651,49,46,6,7,340.45,4,16,16,1.145,0,0,1,0,1,0.082,39.1
8.398,28,25,36.0,6,13.0,18,12,21,29.17,46.003,30.983,52.255,49,46,6,7,356.9,4,16,16,1.136,0,1,1,0,0,0.082,39.1
8.398,28,25,36.0,6,13.0,18,12,21,29.368,45.909,31.478,52.153,49,46,6,7,401.35,4,16,16,1.134,0,0,1,0,0,0.082,39.1
7.469,29,26,37.0,6,13.0,18,12,20,29.998,46.327,31.841,52.199,49,46,6,8,391.34,4,16,16,1.135,0,2,2,0,0,0.082,39.1
8.222,29,26,37.0,6,13.0,18,12,20,29.554,46.516,30.921,52.595,49,46,6,8,374.89,4,16,16,1.143,0,1,2,0,1,0.082,39.1
7.155,30,27,38.0,7,12.0,19,12,23,31.412,50.214,33.199,56.88,53,50,6,8,386.93,5,16,16,1.138,0,1,1,1,0,0.094,38.0
5.0,26,25,32.0,9,0.0,19,10,24,29.61,49.567,30.864,55.239,50,49,0,6,348.43,1,9,6,1.127,0,0,0,6,0,0.02,38.8
5.8,24,21,34.5,1,14.7,16,15,13,23.214,34.043,24.074,38.152,37,34,5,5,275.34,3,21,21,1.122,0,0,0,0,0,0.081,47.1
5.8,24,21,34.5,1,14.7,16,15,13,23.214,34.043,24.074,38.152,37,34,5,5,275.34,3,21,21,1.122,0,0,0,0,0,0.081,47.1
5.8,25,22,35.5,1,16.7,16,15,14,24.236,36.145,25.08,40.651,39,36,6,6,290.36,3,21,21,1.129,0,0,0,0,0,0.077,44.4
5.8,24,21,34.5,1,8.8,17,16,13,23.413,34.051,24.279,37.78,37,34,3,4,275.33,3,21,21,1.111,0,0,0,1,0,0.081,50.0
5.8,19,17,26.5,3,10.0,13,10,13,19.413,30.051,20.279,33.78,32,30,3,4,227.29,3,15,15,1.126,0,0,0,1,0,0.094,43.3
5.8,21,18,31.0,0,18.5,13,13,9,19.161,27.276,19.551,30.322,30,27,5,5,235.27,1,20,20,1.123,0,0,0,0,0,0.033,48.1
5.8,24,21,34.5,0,12.1,16,16,12,23.38,33.018,24.716,36.574,36,33,4,5,292.39,3,21,21,1.108,0,0,0,0,0,0.083,48.5
5.8,25,22,35.5,1,11.1,17,16,14,24.907,35.902,26.478,39.989,39,36,4,5,306.42,4,21,21,1.111,0,0,0,0,0,0.103,47.2
5.8,29,25,39.0,6,13.3,19,13,20,28.816,44.796,30.364,50.896,49,45,6,6,332.45,3,20,20,1.131,0,0,0,0,0,0.061,42.2
5.8,25,22,35.0,3,15.8,16,13,16,24.762,38.029,25.841,43.066,41,38,6,6,292.38,3,20,20,1.133,0,0,0,0,0,0.073,42.1
6.6,33,29,43.5,6,9.8,22,16,22,32.946,51.301,34.273,57.777,55,51,5,7,391.49,5,21,21,1.133,0,0,1,1,1,0.091,43.1
5.187,26,24,35.0,2,7.7,18,16,15,26.677,39.654,27.597,43.894,41,39,3,6,343.81,5,18,18,1.125,0,1,2,1,1,0.122,46.2
5.201,32,29,44.0,1,6.5,23,22,17,32.204,46.538,33.358,51.31,49,46,3,6,405.88,6,24,24,1.115,0,1,2,1,1,0.122,50.0
4.0,32,29,44.0,1,8.9,22,21,16,31.699,45.756,32.603,50.393,48,45,4,7,406.87,6,24,24,1.12,0,1,2,1,1,0.125,48.9
4.444,31,28,42.5,1,7.0,21,20,15,30.865,43.731,32.245,47.814,46,43,3,7,411.91,6,23,23,1.112,0,1,2,1,1,0.13,48.8
4.0,31,28,40.0,5,8.3,21,16,20,31.752,48.523,33.125,54.223,51,48,4,7,398.9,6,18,18,1.13,0,1,2,1,1,0.118,43.8
4.0,33,30,45.0,1,6.4,23,22,17,32.919,47.865,33.813,52.519,50,47,3,7,421.88,7,24,24,1.117,0,1,2,2,1,0.14,48.9
6.854,27,25,36.0,3,7.1,19,16,17,28.204,42.538,29.358,47.31,44,42,3,6,357.84,5,18,18,1.126,0,1,2,1,1,0.114,45.2
5.538,28,26,37.0,4,6.7,20,16,19,29.731,45.422,31.12,50.725,47,45,3,6,371.87,6,18,18,1.127,0,1,2,1,1,0.128,44.4
4.187,33,30,45.0,2,6.1,24,22,19,33.731,49.422,35.12,54.725,52,49,3,6,419.91,6,24,24,1.117,0,1,2,1,1,0.115,49.0
6.131,38,35,48.0,8,8.1,25,17,27,39.784,62.931,41.324,70.386,65,62,5,10,500.02,10,19,18,1.135,0,1,2,3,1,0.154,40.3
5.745,39,36,49.0,9,7.7,26,17,29,41.311,65.814,43.086,73.801,68,65,5,10,514.05,11,19,18,1.135,0,1,2,3,1,0.162,40.0
5.426,41,37,53.0,7,6.2,29,22,28,42.574,65.385,44.625,73.093,69,65,4,8,519.06,8,24,24,1.125,0,1,2,2,1,0.116,44.6
6.824,38,35,49.0,9,6.3,27,16,28,40.574,63.385,42.625,71.093,66,63,4,8,495.04,8,19,18,1.128,2,1,2,2,1,0.121,42.9
6.357,43,39,57.0,7,6.0,31,22,28,44.574,67.385,46.625,75.093,71,67,4,8,543.08,7,25,24,1.121,2,1,2,2,1,0.099,46.3
7.092,41,38,52.0,9,7.2,28,19,31,43.837,69.698,45.847,78.216,72,69,5,10,540.09,10,20,18,1.134,0,1,2,3,1,0.139,40.6
6.721,43,39,56.0,7,5.8,31,24,30,45.101,69.269,47.387,77.509,73,69,4,8,545.1,9,25,24,1.123,0,1,2,2,1,0.123,44.9
7.108,41,38,52.0,8,7.6,27,19,28,42.694,67.327,44.023,75.141,69,66,5,11,544.05,10,20,18,1.138,0,1,3,3,2,0.145,40.9
6.498,40,37,51.0,8,7.6,27,19,29,42.311,66.814,44.086,74.801,69,66,5,10,526.06,10,20,18,1.133,0,1,2,3,1,0.145,40.9
7.721,40,37,51.0,8,7.7,27,19,28,41.979,66.0,43.569,73.931,68,65,5,10,528.05,10,20,18,1.137,0,1,3,2,2,0.147,41.5
7.149,38,36,51.0,5,6.8,24,19,23,39.521,60.862,40.597,66.941,61,59,4,12,537.03,10,22,18,1.135,0,1,3,4,2,0.164,40.7
6.991,40,37,51.0,8,7.7,27,19,28,41.979,66.0,43.569,73.931,68,65,5,10,528.05,8,20,18,1.137,0,1,3,2,2,0.118,41.5
7.131,37,34,48.0,8,6.7,26,16,26,39.048,60.501,40.864,67.678,63,60,4,8,481.01,7,19,18,1.128,2,1,2,2,1,0.111,43.3
5.269,36,33,47.0,7,7.0,25,16,24,37.521,57.618,39.103,64.263,60,57,4,8,466.98,6,19,18,1.127,2,1,2,2,1,0.1,43.9
7.155,40,37,52.0,8,7.8,27,17,27,41.784,64.931,43.324,72.386,67,64,5,10,524.04,9,20,18,1.131,2,1,2,3,1,0.134,42.2
7.022,37,34,48.0,9,6.5,27,16,28,39.86,62.058,42.171,69.884,65,62,4,7,479.04,8,19,18,1.127,2,1,2,1,1,0.123,43.5
7.444,40,37,51.0,11,7.1,29,16,33,43.935,69.927,46.699,79.213,73,70,5,8,522.12,9,19,18,1.132,2,1,2,1,1,0.123,41.4
6.092,39,36,53.0,5,6.5,29,22,26,41.333,62.174,43.409,69.469,65,62,4,7,501.04,9,25,24,1.12,2,1,2,1,1,0.138,46.8
5.0,35,32,43.5,9,6.8,23,14,27,36.65,59.832,37.915,67.153,62,59,4,9,442.54,6,14,11,1.138,0,0,1,4,1,0.097,39.0
5.1,18,16,25.0,0,7.7,13,13,10,17.865,26.065,18.512,28.867,28,26,2,3,210.25,0,13,12,1.11,0,0,0,1,0,0.0,50.0
6.609,43,40,58.5,6,7.1,31,24,30,45.927,70.301,48.148,78.461,73,70,5,9,556.11,11,26,23,1.121,1,1,1,3,0,0.151,44.3
7.194,47,43,64.5,6,8.3,32,25,29,48.609,72.596,51.04,80.464,76,72,6,11,613.19,11,30,27,1.118,1,1,1,3,0,0.145,44.4
5.678,44,41,59.5,7,8.1,32,24,33,47.761,73.96,50.461,83.165,77,74,6,9,569.16,11,26,23,1.124,1,1,1,2,0,0.143,43.2
7.229,47,43,62.5,8,6.7,33,24,32,49.169,75.512,51.364,84.086,79,75,5,10,598.15,11,26,23,1.121,1,1,1,4,0,0.139,44.0
7.538,47,43,62.5,8,6.7,33,24,32,49.641,75.261,52.557,83.797,79,75,5,10,614.22,11,26,23,1.117,1,1,1,3,0,0.139,44.0
5.997,47,43,65.0,4,8.6,32,27,27,48.554,70.462,51.472,77.76,74,70,6,11,627.24,10,31,28,1.111,1,1,1,2,0,0.135,45.7
5.927,48,44,66.0,6,8.0,34,27,31,49.949,75.403,52.154,83.96,79,75,6,10,607.16,11,31,28,1.119,1,1,1,3,0,0.139,45.3
5.831,40,38,52.5,10,6.9,29,18,34,44.981,72.069,47.671,81.292,74,72,5,9,536.13,13,20,17,1.129,1,1,1,3,0,0.176,40.3
6.204,43,40,58.0,7,10.0,29,21,30,45.443,70.621,47.398,79.043,73,70,7,11,560.11,11,25,22,1.129,1,1,1,3,0,0.151,41.4
6.458,41,38,56.5,4,11.3,27,22,24,42.335,62.72,44.307,69.508,65,62,7,11,546.1,9,26,23,1.121,1,1,1,2,0,0.138,43.5
7.208,42,39,57.0,6,7.5,29,22,28,44.115,67.745,45.841,75.256,70,67,5,10,546.07,11,25,22,1.123,1,1,1,4,0,0.157,43.3
5.0,37,34,48.5,7,8.9,23,16,22,36.669,57.865,36.818,64.291,59,56,5,11,473.5,5,20,17,1.148,0,0,3,3,3,0.085,41.1
4.301,37,32,48.0,11,5.1,27,15,27,37.815,58.563,40.063,65.896,64,59,3,5,425.57,2,18,16,1.117,1,0,0,2,0,0.031,45.8
5.959,43,40,58.5,5,10.0,30,24,30,45.728,70.294,47.944,78.833,73,70,7,10,556.12,11,26,23,1.126,1,1,1,2,0,0.151,42.9
6.738,46,43,61.5,8,6.5,33,24,34,49.696,77.396,52.125,86.501,80,77,5,10,600.17,14,26,23,1.123,1,1,1,4,0,0.175,42.9
6.551,44,41,59.5,7,6.8,32,24,32,47.454,73.185,49.909,81.877,76,73,5,9,570.14,12,26,23,1.122,1,1,1,3,0,0.158,43.8
5.092,42,39,57.5,5,9.1,29,23,27,43.895,66.636,45.631,74.129,69,66,6,10,543.07,10,26,23,1.123,1,1,1,3,0,0.145,43.9
6.411,45,42,60.5,6,7.1,31,24,28,46.694,71.327,48.023,79.141,73,70,5,11,592.09,11,26,23,1.131,1,1,3,3,2,0.151,44.3
7.229,46,42,61.5,8,6.8,33,24,32,48.454,74.185,50.909,82.877,78,74,5,9,582.15,11,26,23,1.12,1,1,1,3,0,0.141,44.6
7.745,48,44,66.0,6,6.6,35,28,32,50.454,76.185,52.909,84.877,80,76,5,9,606.17,11,31,28,1.117,1,1,1,3,0,0.138,46.1
7.481,44,41,59.5,6,7.1,31,24,29,46.311,70.814,48.086,78.801,73,70,5,10,574.1,11,26,23,1.126,1,1,2,3,1,0.151,44.3
5.585,41,38,53.5,9,8.7,28,18,31,43.949,69.403,46.154,77.96,72,69,6,10,535.1,9,20,17,1.13,1,1,1,3,0,0.125,40.6
6.767,49,45,64.5,10,6.2,35,24,36,52.222,81.28,54.887,90.916,85,81,5,10,626.21,13,26,23,1.122,1,1,1,4,0,0.153,43.2
5.0,26,23,35.5,7,14.6,17,9,18,26.289,40.912,27.603,46.481,44,41,6,6,306.41,4,16,15,1.134,1,0,0,0,0,0.091,41.5
7.553,47,44,62.5,10,6.1,35,24,38,52.034,81.836,55.194,92.122,85,82,5,9,612.23,13,26,23,1.123,1,1,1,3,0,0.153,42.7
5.977,41,38,56.0,6,10.6,28,21,28,43.202,66.411,45.182,74.418,69,66,7,10,530.08,10,25,22,1.128,1,1,1,2,0,0.145,42.4
7.553,43,40,55.5,12,6.6,31,18,36,47.508,75.952,50.432,85.707,79,76,5,9,562.17,11,20,17,1.128,1,1,1,3,0,0.139,40.8
7.602,47,43,66.5,5,8.2,32,26,30,48.496,73.6,50.637,81.73,77,73,6,11,594.75,10,32,27,1.12,1,0,0,4,0,0.13,43.8
5.678,46,42,61.5,8,6.8,33,24,32,48.454,74.185,50.909,82.877,78,74,5,9,582.15,10,26,23,1.12,1,1,1,3,0,0.128,44.6
6.638,45,41,60.5,8,8.0,33,24,34,47.933,74.636,50.603,84.221,79,75,6,8,546.73,10,26,23,1.123,1,0,0,2,0,0.127,44.0
6.57,43,40,58.5,6,8.7,30,23,29,45.422,69.52,47.392,77.544,72,69,6,10,557.1,11,26,23,1.124,1,1,1,3,0,0.153,43.5
8.097,44,41,59.5,6,7.1,31,24,29,46.755,70.625,49.006,78.405,73,70,5,10,590.55,11,26,23,1.12,1,2,2,3,0,0.151,44.3
7.523,50,45,69.0,4,5.5,34,30,28,50.191,74.116,52.182,81.432,78,73,4,11,643.18,12,36,34,1.116,0,1,2,4,1,0.154,46.6
6.097,39,36,54.0,4,11.7,26,21,24,40.148,60.643,41.659,67.588,63,60,7,10,502.02,8,25,22,1.126,1,1,1,2,0,0.127,43.3
4.886,42,39,57.5,5,8.8,30,24,29,44.707,68.192,46.938,76.335,71,68,6,9,541.1,10,26,23,1.123,1,1,1,2,0,0.141,44.1
6.793,45,42,62.5,6,8.5,32,24,29,47.422,71.52,49.392,79.544,74,71,6,10,581.12,11,27,23,1.12,2,1,1,3,0,0.149,45.1
7.081,40,37,55.0,4,10.0,26,21,23,41.501,60.694,43.949,66.929,63,60,6,11,551.14,9,25,22,1.115,1,1,1,2,0,0.143,43.3
6.987,43,40,58.5,6,8.5,31,24,31,46.234,71.076,48.699,79.75,74,71,6,9,555.13,11,26,23,1.123,1,1,1,2,0,0.149,43.7
7.051,47,43,62.5,8,6.7,33,24,32,49.169,75.512,51.364,84.086,79,75,5,10,598.15,11,26,23,1.121,1,1,1,4,0,0.139,44.0
5.409,42,39,57.5,5,10.4,29,23,28,44.202,67.411,46.182,75.418,70,67,7,10,542.09,10,26,23,1.126,1,1,1,2,0,0.143,43.3
7.824,45,41,62.5,6,8.2,33,26,32,47.406,72.752,49.841,81.806,77,73,6,8,544.71,10,30,27,1.121,1,0,0,2,0,0.13,45.2
6.879,44,41,59.5,7,6.8,32,24,32,47.454,73.185,49.909,81.877,76,73,5,9,570.14,11,26,23,1.122,1,1,1,3,0,0.145,43.8
7.409,42,39,57.5,5,7.5,30,24,28,44.4,67.418,46.387,75.046,70,67,5,9,542.08,10,26,23,1.12,1,1,1,3,0,0.143,44.8
7.081,48,44,66.0,6,7.8,35,28,33,50.761,76.96,53.461,86.165,81,77,6,9,605.19,11,31,28,1.119,1,1,1,2,0,0.136,45.5
6.301,37,34,49.5,2,5.8,24,22,18,35.814,54.105,35.5,59.088,55,52,3,10,469.45,6,24,23,1.136,0,0,3,4,3,0.109,46.2
6.135,44,41,59.5,6,7.1,31,24,29,46.311,70.814,48.086,78.801,73,70,5,10,574.1,11,26,23,1.126,1,1,2,3,1,0.151,44.3
7.215,40,37,56.5,3,6.7,27,23,23,41.227,60.953,42.96,66.847,63,60,4,10,535.06,10,27,23,1.114,1,1,1,4,0,0.159,45.0
6.735,42,39,57.5,5,7.5,30,24,28,44.4,67.418,46.387,75.046,70,67,5,9,542.08,10,26,23,1.12,1,1,1,3,0,0.143,44.8
8.699,43,40,58.5,6,8.7,30,23,29,45.422,69.52,47.392,77.544,72,69,6,10,557.1,11,26,23,1.124,1,1,1,3,0,0.153,43.5
6.81,41,38,56.0,5,10.9,27,21,26,42.862,64.603,45.068,71.923,67,64,7,11,548.12,9,25,22,1.124,1,1,1,2,0,0.134,42.2
7.125,44,40,61.5,5,10.1,31,25,29,45.374,69.087,47.324,77.474,73,69,7,9,531.67,9,30,27,1.123,1,0,0,2,0,0.123,44.9
7.62,44,41,59.5,6,7.1,31,24,29,46.755,70.625,49.006,78.405,73,70,5,10,590.55,11,26,23,1.12,1,2,2,3,0,0.151,44.3
7.108,44,41,59.5,6,7.1,31,24,29,46.311,70.814,48.086,78.801,73,70,5,10,574.1,11,26,23,1.126,1,1,2,3,1,0.151,44.3
4.602,36,32,49.0,5,9.1,25,20,23,36.278,55.116,37.79,61.647,59,55,5,7,425.53,6,24,22,1.121,0,0,0,2,0,0.102,45.5
5.0,25,22,35.5,0,16.1,15,15,9,22.898,31.996,23.108,35.021,34,31,5,7,313.74,2,21,21,1.13,0,1,2,0,1,0.059,48.4
5.0,45,40,63.0,0,6.9,30,30,18,42.398,59.56,43.0,64.542,63,58,4,10,552.59,6,32,28,1.113,0,0,2,3,2,0.095,51.7
6.699,33,29,46.5,1,11.1,22,21,16,31.81,45.462,32.909,50.136,49,45,5,7,401.88,5,27,27,1.114,0,1,1,1,0,0.102,48.9
7.201,34,30,47.5,1,11.1,22,21,15,32.193,45.974,32.847,50.476,49,45,5,8,419.87,5,27,27,1.122,0,1,2,1,1,0.102,48.9
4.301,39,34,50.0,12,6.3,28,15,30,40.364,63.549,42.83,71.81,69,64,4,6,454.62,3,18,16,1.122,1,0,0,2,0,0.043,43.8
5.8,33,30,41.5,7,9.6,21,14,22,34.128,52.832,35.75,59.081,55,52,5,9,450.38,5,17,17,1.136,0,2,3,1,1,0.091,40.4
5.376,23,22,33.5,2,11.8,12,10,12,22.954,35.655,22.989,38.621,35,34,4,10,324.35,5,16,11,1.136,0,0,0,5,0,0.143,35.3
5.322,24,23,34.5,3,10.8,13,10,14,24.481,38.538,24.75,42.036,38,37,4,10,338.38,5,16,11,1.136,0,0,0,5,0,0.132,35.1
5.815,24,23,34.5,2,11.8,12,10,11,23.337,36.167,22.926,38.961,35,34,4,11,342.34,5,16,11,1.146,0,0,1,5,1,0.143,35.3
5.467,24,23,34.5,2,11.8,12,10,11,23.781,35.978,23.847,38.565,35,34,4,11,358.79,5,16,11,1.134,0,1,1,5,0,0.143,35.3
5.445,24,23,34.5,2,11.8,12,10,11,23.979,35.884,24.341,38.463,35,34,4,11,403.24,5,16,11,1.131,0,0,1,5,0,0.143,35.3
5.075,21,20,30.0,1,3.1,14,13,12,21.897,32.974,22.523,35.877,33,32,1,6,293.34,4,15,12,1.121,0,0,1,3,1,0.121,43.8
4.978,22,21,31.0,2,2.9,15,13,14,23.424,35.858,24.284,39.293,36,35,1,6,307.37,4,15,12,1.123,0,0,1,3,1,0.111,42.9
5.154,22,21,31.0,1,3.1,14,13,11,22.28,33.487,22.46,36.217,33,32,1,7,311.33,4,15,12,1.132,0,0,2,3,2,0.121,43.8
5.121,22,21,31.0,1,3.1,14,13,11,22.725,33.298,23.381,35.821,33,32,1,7,327.78,4,15,12,1.119,0,1,2,3,1,0.121,43.8
5.087,22,21,31.0,1,3.1,14,13,11,22.922,33.204,23.875,35.719,33,32,1,7,372.23,4,15,12,1.116,0,0,2,3,1,0.121,43.8
4.884,21,20,30.0,1,3.1,14,13,12,22.341,32.785,23.443,35.482,33,32,1,6,309.79,4,15,12,1.109,0,1,1,3,0,0.121,43.8
4.808,22,21,31.0,2,2.9,15,13,14,23.868,35.669,25.205,38.897,36,35,1,6,323.82,4,15,12,1.111,0,1,1,3,0,0.111,42.9
4.957,22,21,31.0,1,3.1,14,13,11,22.725,33.298,23.381,35.821,33,32,1,7,327.78,4,15,12,1.119,0,1,2,3,1,0.121,43.8
4.875,22,21,31.0,1,3.1,14,13,11,23.169,33.109,24.301,35.426,33,32,1,7,344.23,4,15,12,1.107,0,2,2,3,0,0.121,43.8
4.868,22,21,31.0,1,3.1,14,13,11,23.366,33.015,24.796,35.323,33,32,1,7,388.68,4,15,12,1.104,0,1,2,3,0,0.121,43.8
4.72,21,20,30.0,1,3.1,14,13,12,22.539,32.691,23.938,35.379,33,32,1,6,354.24,4,15,12,1.106,0,0,1,3,0,0.121,43.8
4.692,22,21,31.0,2,2.9,15,13,14,24.066,35.574,25.699,38.795,36,35,1,6,368.27,4,15,12,1.108,0,0,1,3,0,0.111,42.9
4.789,22,21,31.0,1,3.1,14,13,11,22.922,33.204,23.875,35.719,33,32,1,7,372.23,4,15,12,1.116,0,0,2,3,1,0.121,43.8
4.723,22,21,31.0,1,3.1,14,13,11,23.366,33.015,24.796,35.323,33,32,1,7,388.68,4,15,12,1.104,0,1,2,3,0,0.121,43.8
4.703,22,21,31.0,1,3.1,14,13,11,23.564,32.92,25.29,35.221,33,32,1,7,433.13,4,15,12,1.101,0,0,2,3,0,0.121,43.8
4.537,22,21,31.0,2,2.8,15,13,15,23.755,36.673,24.801,40.162,37,36,1,6,305.38,5,15,12,1.116,0,0,0,4,0,0.135,41.7
4.301,23,22,32.0,3,2.6,16,13,17,25.282,39.556,26.563,43.578,40,39,1,6,319.41,5,15,12,1.117,0,0,0,4,0,0.125,41.0
4.63,23,22,32.0,2,2.8,15,13,14,24.139,37.185,24.739,40.502,37,36,1,7,323.37,5,15,12,1.125,0,0,1,4,1,0.135,41.7
4.421,23,22,32.0,2,2.8,15,13,14,24.583,36.996,25.659,40.106,37,36,1,7,339.82,5,15,12,1.114,0,1,1,4,0,0.135,41.7
4.602,23,22,32.0,2,2.8,15,13,14,24.781,36.902,26.154,40.004,37,36,1,7,384.27,5,15,12,1.111,0,0,1,4,0,0.135,41.7
4.58,21,20,30.0,1,3.1,14,13,12,22.539,32.691,23.938,35.379,33,32,1,6,354.24,4,15,12,1.106,0,0,1,3,0,0.121,43.8
4.555,22,21,31.0,2,2.9,15,13,14,24.066,35.574,25.699,38.795,36,35,1,6,368.27,4,15,12,1.108,0,0,1,3,0,0.111,42.9
4.689,22,21,31.0,1,3.1,14,13,11,22.922,33.204,23.875,35.719,33,32,1,7,372.23,4,15,12,1.116,0,0,2,3,1,0.121,43.8
4.63,22,21,31.0,1,3.1,14,13,11,23.366,33.015,24.796,35.323,33,32,1,7,388.68,4,15,12,1.104,0,1,2,3,0,0.121,43.8
4.563,22,21,31.0,1,3.1,14,13,11,23.564,32.92,25.29,35.221,33,32,1,7,433.13,4,15,12,1.101,0,0,2,3,0,0.121,43.8
5.0,41,38,51.0,9,10.1,26,17,31,43.798,69.829,46.017,78.402,72,69,7,12,560.54,8,19,18,1.136,0,2,2,3,0,0.111,37.7
5.8,31,28,42.0,3,6.1,23,20,21,32.235,48.912,33.779,54.651,52,49,3,5,371.47,3,20,18,1.115,0,0,0,2,0,0.058,46.9
5.8,31,28,42.0,3,6.1,23,20,21,32.235,48.912,33.779,54.651,52,49,3,5,371.47,3,20,18,1.115,0,0,0,2,0,0.058,46.9
5.8,30,27,41.0,2,6.5,22,20,19,30.708,46.029,32.017,51.235,49,46,3,5,357.44,3,20,18,1.114,0,0,0,2,0,0.061,47.8
6.0,21,19,29.0,1,13.8,13,12,10,20.404,29.778,20.864,32.938,31,29,4,6,276.72,2,16,16,1.136,0,1,2,0,1,0.065,44.8
6.0,33,29,43.5,6,13.7,21,15,22,33.192,51.105,34.989,57.754,55,51,7,8,407.95,3,21,21,1.132,0,1,1,0,0,0.055,41.2
7.301,31,29,41.5,3,10.6,20,17,18,32.075,48.065,33.228,53.25,49,47,5,9,434.33,6,19,17,1.133,0,2,3,1,1,0.122,42.6
6.301,28,26,37.5,2,10.3,17,15,13,27.714,40.524,28.154,44.131,41,39,4,9,395.24,5,18,17,1.132,0,2,3,2,1,0.122,43.6
5.921,40,36,52.5,7,9.1,28,21,30,42.352,65.618,45.273,74.102,70,66,6,8,498.71,7,24,23,1.123,0,0,0,1,0,0.1,42.4
5.0,40,36,53.0,7,7.5,29,22,31,42.385,66.65,44.836,75.308,71,67,5,7,481.65,6,24,22,1.124,0,0,0,2,0,0.085,43.3
6.237,51,46,63.5,13,4.9,34,21,36,52.097,83.418,53.569,92.987,87,82,4,12,634.74,12,21,17,1.134,0,0,2,6,2,0.138,41.5
5.0,42,38,53.5,9,7.6,27,18,28,42.722,67.265,44.296,75.247,70,66,5,11,543.67,7,22,21,1.14,0,0,3,2,3,0.1,40.9
5.0,37,34,47.5,12,9.1,26,13,32,40.406,65.752,42.841,74.806,69,66,6,8,460.64,6,15,11,1.133,1,0,0,2,0,0.087,39.4
5.0,37,34,49.0,5,6.9,24,19,24,38.115,58.956,39.557,65.112,61,58,4,10,480.59,8,23,22,1.123,0,0,0,5,0,0.131,41.4
5.0,28,25,38.0,4,8.9,20,16,20,29.015,44.803,30.569,50.524,48,45,4,5,332.44,3,18,16,1.123,0,0,0,1,0,0.063,44.4
5.0,29,27,40.5,0,15.4,15,15,12,27.334,41.229,26.966,44.878,41,39,6,12,394.4,4,20,17,1.151,0,0,2,3,2,0.098,38.5
6.553,27,25,37.0,4,12.2,17,11,16,28.487,41.283,31.358,45.833,43,41,5,8,465.35,6,17,16,1.118,2,0,1,1,0,0.14,41.5
6.0,24,22,34.0,1,3.1,14,13,10,23.914,33.211,25.278,35.094,34,32,1,8,400.29,3,16,12,1.097,0,0,1,4,0,0.088,43.8
4.398,23,21,33.0,0,6.7,13,13,9,22.694,31.102,24.068,32.967,32,30,2,8,385.28,2,16,12,1.099,0,0,1,3,0,0.063,43.3
8.081,28,25,39.0,0,10.8,18,18,12,27.089,37.8,28.0,41.167,40,37,4,7,371.24,4,22,22,1.113,0,2,2,1,0,0.1,48.6
7.585,29,26,40.0,1,9.8,19,18,15,28.504,41.687,29.358,45.847,44,41,4,7,366.83,5,22,22,1.118,0,1,1,2,0,0.114,46.3
7.796,27,24,38.0,0,10.8,18,18,13,26.262,37.476,27.142,41.223,40,37,4,6,336.8,4,22,22,1.114,0,1,1,1,0,0.1,48.6
8.032,28,25,39.0,0,10.8,18,18,12,26.645,37.989,27.08,41.562,40,37,4,7,354.79,4,22,22,1.123,0,1,2,1,1,0.1,48.6
7.699,28,25,39.0,0,10.8,18,18,12,26.645,37.989,27.08,41.562,40,37,4,7,354.79,4,22,22,1.123,0,1,2,1,1,0.1,48.6
7.959,28,25,39.0,0,10.8,18,18,12,27.089,37.8,28.0,41.167,40,37,4,7,371.24,4,22,22,1.113,0,2,2,1,0,0.1,48.6
8.097,29,26,42.0,0,13.2,19,18,12,27.757,38.694,28.387,42.306,41,38,5,7,361.81,4,23,22,1.113,1,1,1,1,0,0.098,50.0
8.086,29,26,42.0,0,13.2,19,18,12,27.757,38.694,28.387,42.306,41,38,5,7,361.81,4,23,22,1.113,1,1,1,1,0,0.098,50.0
6.143,29,26,42.0,0,13.2,19,18,12,27.757,38.694,28.387,42.306,41,38,5,7,361.81,4,23,22,1.113,1,1,1,1,0,0.098,50.0
6.921,31,28,42.0,1,10.0,19,18,12,28.939,41.898,28.716,45.657,43,40,4,9,404.8,4,22,22,1.141,0,1,4,1,3,0.093,47.5
7.523,31,28,42.0,1,10.0,19,18,12,28.939,41.898,28.716,45.657,43,40,4,9,404.8,4,22,22,1.141,0,1,4,1,3,0.093,47.5
7.26,32,29,43.0,1,9.8,19,18,12,29.653,43.225,29.171,46.866,44,41,4,10,420.8,5,22,22,1.143,0,1,4,2,3,0.114,46.3
7.387,32,29,43.0,1,9.8,19,18,12,29.653,43.225,29.171,46.866,44,41,4,10,420.8,5,22,22,1.143,0,1,4,2,3,0.114,46.3
8.337,28,25,39.0,1,10.0,19,18,15,27.789,40.36,28.904,44.638,43,40,4,6,350.83,4,22,22,1.116,0,1,1,1,0,0.093,47.5
7.886,29,26,40.0,1,10.0,19,18,14,28.172,40.873,28.841,44.978,43,40,4,7,368.82,5,22,22,1.124,0,1,2,1,1,0.116,47.5
7.658,28,25,39.0,1,12.8,18,17,14,27.283,39.578,28.148,43.721,42,39,5,7,351.82,5,22,22,1.121,0,1,1,1,0,0.119,46.2
7.222,28,25,39.0,2,11.9,19,17,17,27.983,42.138,29.051,47.192,45,42,5,6,331.41,4,22,22,1.124,0,0,0,1,0,0.089,45.2
8.481,29,26,40.0,1,10.0,19,18,14,28.616,40.684,29.762,44.582,43,40,4,7,385.27,4,22,22,1.115,0,2,2,1,0,0.093,47.5
7.959,32,29,43.0,2,9.3,20,18,14,30.465,44.782,30.478,49.072,46,43,4,9,418.83,4,22,22,1.141,0,1,4,1,3,0.087,46.5
7.77,33,30,44.0,2,9.1,20,18,14,31.18,46.109,30.932,50.282,47,44,4,10,434.83,5,22,22,1.143,0,1,4,2,3,0.106,45.5
8.387,31,28,42.0,2,9.1,20,18,16,30.858,44.894,31.977,49.206,47,44,4,8,415.3,6,22,22,1.118,0,2,2,2,0,0.128,45.5
7.921,34,31,45.0,3,8.5,21,18,16,32.707,48.992,32.693,53.697,50,47,4,10,448.86,6,22,22,1.142,0,1,4,2,3,0.12,44.7
7.538,35,32,46.0,3,8.3,21,18,16,33.422,50.32,33.148,54.906,51,48,4,11,464.86,7,22,22,1.144,0,1,4,3,3,0.137,43.8
8.678,34,31,45.0,4,7.8,22,18,20,34.626,51.989,35.955,57.246,54,51,4,9,459.36,9,22,22,1.122,0,2,2,3,0,0.167,43.1
8.292,37,34,48.0,5,7.4,23,18,20,36.475,56.087,36.671,61.737,57,54,4,11,492.92,9,22,22,1.143,0,1,4,3,3,0.158,42.6
8.076,38,35,49.0,5,7.3,23,18,20,37.19,57.414,37.125,62.946,58,55,4,12,508.92,10,22,22,1.144,0,1,4,4,3,0.172,41.8
7.824,37,34,48.0,6,7.1,24,18,22,37.287,57.643,37.978,63.942,59,56,4,10,490.95,9,22,22,1.142,0,1,4,2,3,0.153,42.9
8.114,37,34,48.0,5,9.1,23,18,21,36.782,56.861,37.222,63.025,58,55,5,11,491.94,9,22,22,1.146,0,1,4,2,3,0.155,41.8
8.027,37,34,48.0,5,7.4,23,18,20,36.948,55.836,37.864,61.447,57,54,4,11,508.99,9,22,22,1.138,0,1,4,2,3,0.158,42.6
7.921,38,35,50.0,5,7.3,23,18,20,37.662,57.163,38.318,62.657,58,55,4,12,524.99,9,23,22,1.139,0,1,4,3,3,0.155,41.8
7.921,39,36,52.0,5,7.1,23,18,20,38.377,58.491,38.773,63.866,59,56,4,13,540.99,9,24,22,1.14,0,1,4,4,3,0.153,41.1
7.921,38,35,49.0,6,7.0,24,18,22,38.002,58.971,38.432,65.152,60,57,4,11,506.95,9,22,22,1.143,0,1,4,3,3,0.15,42.1
7.721,39,36,52.0,5,9.1,24,18,19,37.97,57.305,37.915,62.82,58,55,5,12,517.93,9,23,22,1.142,1,1,4,3,3,0.155,43.6
8.367,38,35,50.0,4,9.3,23,19,19,36.97,56.305,36.915,61.82,57,54,5,12,505.92,8,23,22,1.145,0,1,4,3,3,0.14,42.6
8.244,39,36,51.0,5,8.8,24,19,21,38.497,59.189,38.676,65.235,60,57,5,12,519.95,8,23,22,1.144,0,1,4,3,3,0.133,42.1
7.824,40,37,52.0,6,8.3,25,19,23,40.024,62.072,40.438,68.65,63,60,5,12,533.98,8,23,22,1.144,0,1,4,3,3,0.127,41.7
8.553,39,36,51.0,5,8.8,24,19,21,38.497,59.189,38.676,65.235,60,57,5,12,519.95,9,23,22,1.144,0,1,4,3,3,0.15,42.1
5.616,36,33,50.0,1,8.2,23,22,16,34.843,50.738,34.966,55.021,52,49,4,10,466.88,8,26,24,1.123,0,1,2,4,1,0.154,46.9
6.253,34,31,46.0,1,8.2,23,22,18,33.94,49.967,34.818,55.017,52,49,4,8,436.9,7,24,24,1.123,0,1,2,2,1,0.135,46.9
6.87,37,34,50.0,2,7.4,25,23,20,37.182,55.178,38.034,60.642,57,54,4,9,478.94,8,25,24,1.123,0,1,2,3,1,0.14,46.3
7.538,38,35,52.0,1,7.3,26,25,20,38.182,56.178,39.034,61.642,58,55,4,9,490.95,9,26,24,1.121,0,1,2,3,1,0.155,47.3
6.708,43,40,58.0,3,6.3,29,26,24,43.665,65.6,44.466,71.891,67,64,4,11,563.02,12,27,24,1.123,0,1,2,5,1,0.179,45.3
6.66,40,37,53.0,4,6.6,27,23,24,40.95,62.272,42.012,68.682,64,61,4,10,523.0,12,25,24,1.126,0,1,2,4,1,0.188,44.3
7.42,39,36,54.0,2,9.1,26,23,19,38.677,56.396,39.279,61.725,58,55,5,10,503.95,9,26,24,1.122,1,1,2,3,1,0.155,47.3
5.0,46,42,64.0,1,7.9,30,29,21,44.633,64.934,44.949,70.559,67,63,5,12,586.01,10,33,30,1.12,0,1,2,5,1,0.149,47.6
7.377,42,38,57.0,1,11.9,27,26,21,41.005,60.272,41.835,66.512,63,59,7,11,530.0,9,30,30,1.127,0,1,2,2,1,0.143,45.8
5.0,42,38,57.0,2,6.5,30,28,24,42.521,62.618,44.103,69.263,66,62,4,8,527.03,10,30,30,1.117,0,1,2,2,1,0.152,48.4
5.427,45,41,62.0,1,6.2,32,31,24,45.236,65.945,46.557,72.472,69,65,4,9,567.05,10,32,30,1.115,0,1,2,3,1,0.145,49.2
7.102,45,41,61.0,2,6.2,31,29,24,44.95,66.272,46.012,72.682,69,65,4,10,571.04,11,31,30,1.118,0,1,2,4,1,0.159,47.7
6.079,47,43,63.0,2,6.3,31,29,21,45.385,66.483,45.37,72.491,68,64,4,12,609.01,10,31,30,1.133,0,1,5,3,4,0.147,48.4
5.888,46,42,63.0,1,6.2,32,31,23,45.619,66.458,46.495,72.812,69,65,4,10,585.04,10,32,30,1.12,0,1,3,3,2,0.145,49.2
5.909,49,45,66.0,3,5.5,34,31,28,49.719,74.367,50.989,81.722,77,73,4,11,627.11,12,32,30,1.119,0,1,2,5,1,0.156,46.6
5.67,48,44,64.0,2,6.2,31,29,21,46.1,67.811,45.824,73.701,69,65,4,13,625.01,11,31,30,1.134,0,1,5,4,4,0.159,47.7
5.0,49,45,65.0,4,5.5,33,29,28,49.434,74.694,50.443,81.931,77,73,4,12,631.1,13,31,30,1.122,0,1,2,6,1,0.169,45.2
5.77,32,30,42.0,6,10.2,19,11,19,32.864,50.473,33.926,55.645,51,49,5,11,451.95,8,17,16,1.136,2,1,2,3,1,0.157,38.8
7.137,39,36,53.0,5,6.5,29,22,26,41.333,62.174,43.409,69.469,65,62,4,7,501.04,7,25,24,1.12,2,1,2,1,1,0.108,46.8
5.653,44,39,60.5,6,11.9,29,23,28,43.869,67.305,45.569,75.557,72,67,8,10,520.65,11,32,31,1.128,0,0,0,2,0,0.153,43.3
5.0,41,37,53.5,7,9.1,28,21,29,42.263,66.381,44.017,74.731,70,66,6,9,500.63,7,24,23,1.132,0,0,1,2,1,0.1,42.4
4.0,32,30,44.0,2,8.3,20,18,18,32.398,49.56,33.0,54.542,50,48,4,10,432.49,6,21,18,1.136,0,0,2,3,2,0.12,41.7
6.125,35,32,49.0,2,5.9,26,22,19,35.731,51.422,37.12,56.725,54,51,3,6,443.93,5,25,24,1.112,2,1,2,1,1,0.093,51.0
6.658,43,40,59.0,6,5.9,30,22,28,45.476,68.789,47.728,76.223,71,68,4,10,579.14,10,27,24,1.121,2,1,2,3,1,0.141,44.1
7.745,40,37,54.0,6,6.2,30,22,28,42.86,65.058,45.171,72.884,68,65,4,7,515.07,8,25,24,1.121,2,1,2,1,1,0.118,46.2
7.387,42,38,56.0,7,6.1,31,22,28,43.86,66.058,46.171,73.884,70,66,4,7,527.08,7,25,24,1.119,2,1,2,1,1,0.1,47.0
7.387,39,36,53.0,5,6.5,29,22,26,41.333,62.174,43.409,69.469,65,62,4,7,501.04,7,25,24,1.12,2,1,2,1,1,0.108,46.8
7.208,43,39,57.0,7,6.1,31,22,27,44.243,66.57,46.108,74.224,70,66,4,8,545.07,7,25,24,1.125,2,1,3,1,2,0.1,47.0
6.854,41,37,54.5,7,6.3,29,20,26,42.048,63.501,43.864,70.678,67,63,4,8,517.04,7,24,23,1.122,2,1,2,2,1,0.104,46.0
6.745,41,37,54.5,7,6.3,29,20,26,42.52,63.251,45.057,70.389,67,63,4,8,533.11,7,24,23,1.117,2,1,2,1,1,0.104,46.0
6.959,41,37,54.5,7,8.1,28,19,25,42.014,62.469,44.301,69.472,66,62,5,9,534.1,7,24,23,1.121,2,1,2,1,1,0.106,45.2
6.886,42,39,56.0,7,5.8,31,22,30,45.101,69.269,47.387,77.509,72,69,4,8,545.1,10,25,24,1.123,2,1,2,2,1,0.139,44.9
6.921,43,40,58.0,6,5.7,30,24,30,46.003,70.672,48.489,78.638,73,70,4,10,581.16,12,27,24,1.123,0,1,2,3,1,0.164,42.9
7.523,40,37,53.0,6,6.0,30,24,30,43.386,66.941,45.932,75.299,70,67,4,7,517.09,10,25,24,1.124,0,1,2,1,1,0.143,44.8
7.066,41,37,54.0,6,6.2,30,24,28,42.86,65.058,45.171,72.884,69,65,4,7,515.07,10,25,24,1.121,0,1,2,1,1,0.145,46.2
7.215,38,34,49.5,7,8.3,26,19,26,39.159,60.207,41.171,67.422,64,60,5,8,476.02,7,23,23,1.124,0,1,1,2,0,0.109,43.3
7.62,37,33,48.5,6,7.1,25,19,23,37.325,56.549,38.858,62.717,60,56,4,8,462.97,7,23,23,1.12,0,1,1,3,0,0.117,44.6
4.0,30,28,42.0,0,9.5,18,18,14,29.345,43.793,29.477,47.712,44,42,4,10,404.43,5,21,18,1.136,0,0,2,3,2,0.114,42.9
5.196,44,39,60.5,6,13.2,29,23,29,44.175,68.08,46.12,76.846,73,68,9,10,519.67,10,32,31,1.13,0,0,0,1,0,0.137,42.6
5.62,36,32,50.0,4,12.7,24,20,23,36.079,55.109,37.586,62.019,59,55,7,8,425.54,7,27,26,1.128,0,0,0,1,0,0.119,43.6
7.155,37,33,48.5,7,8.3,26,19,27,38.331,59.883,40.313,67.478,64,60,5,7,441.58,7,23,23,1.125,0,0,0,2,0,0.109,43.3
6.086,33,30,45.0,4,7.7,23,19,22,33.971,52.342,35.239,58.358,55,52,4,7,402.49,8,23,22,1.122,0,0,0,3,0,0.145,44.2
7.62,31,28,42.5,2,8.9,21,19,17,31.03,45.571,32.12,50.262,48,45,4,7,392.87,6,23,23,1.117,0,1,1,2,0,0.125,46.7
5.0,37,34,48.5,5,13.7,20,15,17,34.515,53.931,33.483,59.382,54,51,7,14,479.44,6,22,21,1.164,0,0,4,3,4,0.111,39.2
5.0,27,24,35.0,7,10.0,17,9,16,27.143,40.567,28.523,44.997,43,40,4,7,363.27,0,12,10,1.125,1,2,2,1,0,0.0,42.5
6.959,35,31,49.0,3,13.5,23,20,21,34.552,52.225,35.824,58.604,56,52,7,8,411.51,6,27,26,1.127,0,0,0,1,0,0.107,44.2
5.602,42,38,55.0,8,6.3,28,19,26,42.921,64.967,44.693,71.701,68,64,4,10,553.48,8,23,22,1.12,1,2,2,4,0,0.118,43.8
8.699,37,33,48.0,7,8.8,24,17,24,37.819,57.4,40.057,63.926,61,57,5,9,482.05,7,22,22,1.122,0,1,1,2,0,0.115,42.1
5.276,39,37,51.0,8,9.5,22,14,26,40.166,65.396,40.659,72.413,65,63,6,15,540.61,11,20,16,1.149,0,0,2,6,2,0.169,34.9
4.456,24,21,31.5,6,2.6,18,12,17,24.665,37.825,26.006,42.239,41,38,1,3,279.36,1,13,11,1.112,0,0,0,2,0,0.024,47.4
5.291,26,23,35.0,3,7.9,18,15,15,26.127,38.011,27.688,42.116,41,38,3,5,321.43,3,15,12,1.108,0,0,0,1,0,0.073,47.4
5.197,27,24,36.0,3,7.9,18,15,14,26.51,38.523,27.625,42.455,41,38,3,6,339.42,3,15,12,1.117,0,0,1,1,1,0.073,47.4
5.316,27,24,36.0,3,7.9,18,15,14,26.954,38.334,28.546,42.06,41,38,3,6,355.87,3,15,12,1.107,0,1,1,1,0,0.073,47.4
5.516,27,24,36.0,3,7.9,18,15,14,27.152,38.24,29.04,41.957,41,38,3,6,400.32,3,15,12,1.104,0,0,1,1,0,0.073,47.4
5.333,27,24,36.0,4,7.3,19,15,17,27.654,40.894,29.449,45.531,44,41,3,5,335.46,3,15,12,1.111,0,0,0,1,0,0.068,46.3
5.207,28,25,37.0,4,7.1,19,15,17,28.369,42.222,29.904,46.74,45,42,3,6,351.46,4,15,12,1.113,0,0,0,2,0,0.089,45.2
4.978,27,24,36.0,3,7.9,18,15,14,26.51,38.523,27.625,42.455,41,38,3,6,339.42,3,15,12,1.117,0,0,1,1,1,0.073,47.4
4.742,28,25,37.0,3,7.9,18,15,13,26.894,39.036,27.563,42.795,41,38,3,7,357.41,3,15,12,1.126,0,0,2,1,2,0.073,47.4
4.881,28,25,37.0,3,7.9,18,15,13,27.338,38.847,28.483,42.399,41,38,3,7,373.86,3,15,12,1.116,0,1,2,1,1,0.073,47.4
5.205,28,25,37.0,3,7.9,18,15,13,27.535,38.753,28.978,42.297,41,38,3,7,418.31,3,15,12,1.113,0,0,2,1,1,0.073,47.4
4.989,28,25,37.0,4,7.3,19,15,16,28.037,41.407,29.387,45.87,44,41,3,6,353.45,3,15,12,1.119,0,0,1,1,1,0.068,46.3
4.906,29,26,38.0,4,7.1,19,15,16,28.752,42.734,29.841,47.08,45,42,3,7,369.45,4,15,12,1.121,0,0,1,2,1,0.089,45.2
5.152,27,24,36.0,3,7.9,18,15,14,26.954,38.334,28.546,42.06,41,38,3,6,355.87,3,15,12,1.107,0,1,1,1,0,0.073,47.4
4.785,28,25,37.0,3,7.9,18,15,13,27.338,38.847,28.483,42.399,41,38,3,7,373.86,3,15,12,1.116,0,1,2,1,1,0.073,47.4
5.002,28,25,37.0,3,7.9,18,15,13,27.782,38.658,29.404,42.004,41,38,3,7,390.31,3,15,12,1.105,0,2,2,1,0,0.073,47.4
5.416,28,25,37.0,3,7.9,18,15,13,27.98,38.564,29.898,41.901,41,38,3,7,434.76,3,15,12,1.103,0,1,2,1,0,0.073,47.4
5.09,28,25,37.0,4,7.3,19,15,16,28.481,41.218,30.307,45.475,44,41,3,6,369.9,3,15,12,1.109,0,1,1,1,0,0.068,46.3
4.985,29,26,38.0,4,7.1,19,15,16,29.196,42.545,30.762,46.684,45,42,3,7,385.9,4,15,12,1.112,0,1,1,2,0,0.089,45.2
5.312,27,24,36.0,3,7.9,18,15,14,27.152,38.24,29.04,41.957,41,38,3,6,400.32,3,15,12,1.104,0,0,1,1,0,0.073,47.4
5.089,28,25,37.0,3,7.9,18,15,13,27.535,38.753,28.978,42.297,41,38,3,7,418.31,3,15,12,1.113,0,0,2,1,1,0.073,47.4
5.231,28,25,37.0,3,7.9,18,15,13,27.98,38.564,29.898,41.901,41,38,3,7,434.76,3,15,12,1.103,0,1,2,1,0,0.073,47.4
5.438,28,25,37.0,3,7.9,18,15,13,28.177,38.469,30.392,41.799,41,38,3,7,479.21,3,15,12,1.1,0,0,2,1,0,0.073,47.4
5.152,28,25,37.0,4,7.3,19,15,16,28.679,41.123,30.801,45.372,44,41,3,6,414.35,3,15,12,1.107,0,0,1,1,0,0.068,46.3
5.033,29,26,38.0,4,7.1,19,15,16,29.394,42.451,31.256,46.582,45,42,3,7,430.35,4,15,12,1.109,0,0,1,2,0,0.089,45.2
5.65,27,24,36.0,4,7.3,19,15,17,27.654,40.894,29.449,45.531,44,41,3,5,335.46,3,15,12,1.111,0,0,0,1,0,0.068,46.3
5.452,28,25,37.0,4,7.3,19,15,16,28.037,41.407,29.387,45.87,44,41,3,6,353.45,3,15,12,1.119,0,0,1,1,1,0.068,46.3
5.507,28,25,37.0,4,7.3,19,15,16,28.481,41.218,30.307,45.475,44,41,3,6,369.9,3,15,12,1.109,0,1,1,1,0,0.068,46.3
5.971,28,25,37.0,4,7.3,19,15,16,28.679,41.123,30.801,45.372,44,41,3,6,414.35,3,15,12,1.107,0,0,1,1,0,0.068,46.3
5.599,28,25,37.0,5,6.8,20,15,19,29.181,43.778,31.211,48.946,47,44,3,5,349.49,3,15,12,1.112,0,0,0,1,0,0.064,45.5
5.206,29,26,38.0,5,6.7,20,15,19,29.895,45.105,31.665,50.155,48,45,3,6,365.49,4,15,12,1.115,0,0,0,2,0,0.083,44.4
5.385,28,25,37.0,4,7.1,19,15,17,28.369,42.222,29.904,46.74,45,42,3,6,351.46,4,15,12,1.113,0,0,0,2,0,0.089,45.2
5.095,29,26,38.0,4,7.1,19,15,16,28.752,42.734,29.841,47.08,45,42,3,7,369.45,4,15,12,1.121,0,0,1,2,1,0.089,45.2
5.12,29,26,38.0,4,7.1,19,15,16,29.196,42.545,30.762,46.684,45,42,3,7,385.9,4,15,12,1.112,0,1,1,2,0,0.089,45.2
5.561,29,26,38.0,4,7.1,19,15,16,29.394,42.451,31.256,46.582,45,42,3,7,430.35,4,15,12,1.109,0,0,1,2,0,0.089,45.2
5.134,29,26,38.0,5,6.7,20,15,19,29.895,45.105,31.665,50.155,48,45,3,6,365.49,4,15,12,1.115,0,0,0,2,0,0.083,44.4
4.98,30,27,39.0,5,6.5,20,15,19,30.61,46.433,32.12,51.365,49,46,3,7,381.49,5,15,12,1.117,0,0,0,3,0,0.102,43.5
5.8,22,20,28.0,6,10.5,15,9,18,23.488,37.92,24.807,43.109,40,38,4,5,270.37,3,9,6,1.134,0,0,0,1,0,0.075,39.5
4.602,41,38,54.5,6,12.3,21,15,19,38.658,60.545,37.801,66.136,60,57,7,17,557.54,8,24,21,1.16,0,0,4,5,4,0.133,36.8
5.553,27,25,36.0,4,9.8,17,13,16,27.414,42.083,28.057,46.602,43,41,4,8,362.82,6,17,16,1.137,0,1,2,2,1,0.14,41.5
5.8,30,27,42.0,1,11.4,20,19,17,30.17,44.214,31.699,49.112,47,44,5,7,375.49,3,23,22,1.116,0,0,0,1,0,0.064,45.5
5.8,25,23,34.5,2,12.5,17,15,17,25.983,40.138,27.051,45.192,42,40,5,6,307.39,3,18,17,1.13,0,0,0,1,0,0.071,42.5
5.8,30,27,42.0,2,8.5,22,20,20,31.015,46.803,32.569,52.524,50,47,4,5,356.46,4,23,22,1.118,0,0,0,1,0,0.08,46.8
7.398,35,31,49.0,3,11.8,23,20,20,34.246,51.451,35.273,57.315,55,51,6,8,412.49,6,27,26,1.124,0,0,0,2,0,0.109,45.1
5.8,33,31,42.0,8,8.6,22,14,27,35.761,58.538,37.222,65.896,60,58,5,9,425.54,7,15,12,1.136,0,0,0,4,0,0.117,37.9
5.8,32,29,42.5,3,12.5,18,15,11,28.568,42.887,27.222,47.021,43,40,5,11,411.34,3,21,21,1.176,0,0,6,0,6,0.07,45.0
5.8,27,25,36.5,2,10.5,17,15,13,26.111,39.574,25.858,43.713,40,38,4,8,346.34,2,18,17,1.15,0,0,3,1,3,0.05,44.7
5.8,20,19,28.5,1,13.8,11,10,10,19.998,30.116,20.318,32.787,30,29,4,8,278.32,4,14,11,1.131,0,0,0,3,0,0.133,37.9
5.8,34,30,46.0,4,9.8,23,19,21,34.223,50.982,36.222,56.943,55,51,5,7,415.56,2,23,22,1.117,0,0,0,1,0,0.036,45.1
5.8,34,31,46.0,2,12.5,21,19,17,32.681,49.661,32.631,55.125,51,48,6,10,426.44,3,23,22,1.148,0,0,3,1,3,0.059,43.8
5.8,26,24,36.5,3,7.3,17,14,17,27.083,41.549,28.358,45.95,43,41,3,7,343.44,6,19,17,1.121,0,0,0,3,0,0.14,41.5
5.8,30,27,40.0,5,8.2,21,16,22,31.256,49.014,32.784,55.149,52,49,4,6,362.47,4,18,16,1.125,0,0,0,2,0,0.077,42.9
5.8,26,24,36.0,1,5.6,17,16,12,26.475,36.884,27.852,39.715,38,36,2,7,379.28,3,18,16,1.103,0,2,2,2,0,0.079,47.2
6.4,33,29,45.5,4,10.2,22,18,20,32.892,49.167,34.705,55.073,53,49,5,7,405.54,4,25,25,1.124,0,0,1,0,1,0.075,44.9
5.854,36,32,49.0,6,10.3,25,19,26,37.111,57.774,39.103,65.351,62,58,6,7,426.57,8,26,26,1.127,0,0,0,1,0,0.129,43.1
5.8,20,18,30.0,1,14.3,14,12,10,19.666,28.058,20.307,31.239,30,28,4,4,234.28,1,17,16,1.116,1,0,0,0,0,0.033,50.0
5.8,33,30,46.0,1,12.5,21,20,18,32.906,48.643,34.159,53.82,51,48,6,9,418.52,4,24,22,1.121,0,0,0,2,0,0.078,43.8
5.8,36,32,50.5,0,8.2,24,24,17,34.773,49.836,35.847,54.578,53,49,4,8,444.52,4,28,27,1.114,0,0,1,2,1,0.075,49.0
5.8,34,30,45.0,5,12.5,21,16,18,32.297,49.149,32.694,54.785,52,48,6,9,408.45,5,22,22,1.141,0,0,2,1,2,0.096,43.8
5.8,31,28,42.5,4,14.3,20,16,21,31.552,49.225,32.824,55.604,52,49,7,8,375.48,6,22,21,1.135,0,0,0,1,0,0.115,40.8
5.8,25,23,34.5,0,14.7,15,15,11,24.584,35.018,25.244,38.25,36,34,5,8,348.21,3,18,17,1.125,0,2,2,1,0,0.083,44.1
5.8,35,32,46.0,5,7.5,23,18,21,34.933,54.436,35.358,60.583,56,53,4,9,442.48,7,22,22,1.143,0,0,3,2,3,0.125,43.4
5.8,31,28,41.0,6,7.7,22,16,24,32.783,51.898,34.546,58.564,55,52,4,6,376.5,4,18,16,1.126,0,0,0,2,0,0.073,42.3
5.8,40,35,51.0,11,7.4,29,18,33,42.197,67.207,45.143,76.514,73,68,5,6,467.67,6,22,22,1.125,0,0,0,1,0,0.082,42.6
5.8,34,31,48.0,2,9.6,24,20,21,35.223,51.982,37.222,57.943,55,52,5,7,427.57,3,24,22,1.114,2,0,0,1,0,0.055,46.2
5.8,28,24,40.5,1,22.2,16,15,12,25.225,36.582,25.568,40.817,40,36,8,8,316.36,3,25,25,1.134,0,0,0,0,0,0.075,44.4
5.8,37,34,51.0,3,8.8,24,21,23,37.894,57.847,39.347,63.986,60,57,5,10,477.59,8,23,18,1.123,0,0,0,4,0,0.133,42.1
5.8,21,19,28.5,4,11.4,14,10,16,21.961,35.036,23.046,39.694,37,35,4,5,256.34,3,15,15,1.134,0,0,0,1,0,0.081,40.0
5.8,36,32,50.5,0,8.2,24,24,17,34.773,49.836,35.847,54.578,53,49,4,8,444.52,4,28,27,1.114,0,0,1,2,1,0.075,49.0
5.8,33,29,46.0,3,8.2,23,20,20,33.202,48.88,35.216,54.444,53,49,4,6,400.54,6,26,26,1.111,0,0,0,1,0,0.113,46.9
5.8,26,23,34.0,6,14.0,17,11,20,26.816,42.796,28.364,48.896,46,43,6,6,308.43,3,16,16,1.137,0,0,0,0,0,0.065,39.5
5.8,27,24,34.5,7,6.8,19,12,20,27.904,44.098,29.262,49.781,47,44,3,5,325.42,1,13,11,1.131,0,0,1,1,1,0.021,43.2
5.8,30,28,41.0,1,6.5,21,20,18,31.723,46.429,33.523,51.099,48,46,3,7,411.94,5,20,18,1.111,0,1,1,2,0,0.104,45.7
5.8,27,23,36.0,4,13.9,16,12,13,25.116,36.447,26.176,40.282,40,36,5,7,323.41,1,17,16,1.119,0,0,0,1,0,0.025,44.4
5.8,27,25,36.5,1,11.4,16,15,10,24.968,37.203,24.034,40.637,37,35,4,9,350.3,2,18,17,1.161,0,0,4,1,4,0.054,45.7
5.8,28,25,39.5,1,7.7,19,18,14,27.954,39.334,29.546,43.06,42,39,3,6,367.88,4,22,21,1.104,0,1,1,1,0,0.095,48.7
5.8,37,33,51.5,2,10.9,25,23,22,37.245,55.083,39.228,61.441,59,55,6,8,454.6,4,28,27,1.117,0,0,0,1,0,0.068,45.5
5.8,34,30,46.0,4,7.7,24,20,22,34.256,52.014,35.784,58.149,56,52,4,6,398.5,6,23,22,1.118,0,0,0,2,0,0.107,46.2
6.699,36,32,50.0,4,11.1,24,20,22,35.772,54.334,37.034,60.73,58,54,6,8,426.52,7,27,26,1.125,0,0,0,2,0,0.121,44.4
5.8,29,26,41.0,0,12.2,19,19,15,28.643,41.331,29.938,45.697,44,41,5,7,361.46,3,23,22,1.115,0,0,0,1,0,0.068,46.3
5.8,40,36,56.0,4,7.9,28,24,27,41.518,62.96,43.961,70.398,67,63,5,8,497.67,7,30,28,1.117,0,0,0,2,0,0.104,44.4
5.8,42,38,50.0,15,10.5,27,12,38,45.218,76.05,47.83,86.843,80,76,8,11,522.73,7,14,12,1.143,0,0,0,3,0,0.088,35.5
5.8,21,19,29.5,3,12.1,14,11,14,21.434,33.153,22.284,37.279,35,33,4,5,254.32,3,16,15,1.13,0,0,0,1,0,0.086,42.4
6.9,37,33,45.0,11,11.1,24,13,30,38.569,63.156,40.569,72.02,67,63,7,9,451.61,6,14,12,1.143,0,0,1,1,1,0.09,38.1
5.8,22,20,30.0,3,11.1,15,12,16,22.961,36.036,24.046,40.694,38,36,4,5,268.35,4,16,16,1.13,0,0,0,1,0,0.105,41.7
5.8,22,20,30.0,0,17.9,12,12,8,20.418,29.255,20.318,31.685,30,28,5,8,289.7,1,14,12,1.132,0,1,1,2,0,0.033,42.9
5.8,22,19,31.0,0,19.2,12,12,7,19.536,26.796,19.892,29.036,29,26,5,7,269.31,1,17,16,1.117,0,0,0,1,0,0.034,46.2
5.8,32,29,44.0,3,8.0,23,20,21,33.369,50.011,35.188,55.883,53,50,4,6,404.93,7,23,22,1.118,0,1,1,1,0,0.132,46.0
5.8,42,38,50.0,16,9.1,28,12,39,45.723,76.832,48.586,87.76,81,77,7,10,521.74,7,14,12,1.14,0,0,0,3,0,0.086,36.4
5.8,34,30,46.0,4,9.8,23,19,21,34.223,50.982,36.222,56.943,55,51,5,7,415.56,3,23,22,1.117,0,0,0,1,0,0.055,45.1
5.8,29,26,41.0,2,9.5,19,17,16,29.335,42.189,31.341,46.534,45,42,4,7,380.53,3,22,20,1.108,0,0,0,1,0,0.067,45.2
5.8,40,35,51.0,11,7.4,29,18,33,42.197,67.207,45.143,76.514,73,68,5,6,467.67,7,22,22,1.125,0,0,0,1,0,0.096,42.6
5.8,19,17,26.0,0,16.7,11,11,7,17.682,24.825,17.858,26.977,26,24,4,6,246.67,0,13,12,1.124,0,1,1,1,0,0.0,45.8
5.8,30,27,41.5,0,6.8,21,21,17,29.896,44.473,30.71,49.03,47,44,3,6,359.41,4,23,23,1.114,0,0,0,3,0,0.085,47.7
5.8,28,26,38.0,4,4.2,22,18,22,30.74,47.694,32.534,53.567,50,48,2,4,346.46,5,19,18,1.116,0,0,0,2,0,0.1,45.8
5.8,36,32,50.5,1,11.5,24,23,20,35.718,52.2,37.466,58.026,56,52,6,8,440.57,4,28,27,1.116,0,0,0,1,0,0.071,46.2
4.8,18,16,26.0,0,15.4,12,12,10,17.666,26.058,18.307,29.239,28,26,4,4,210.26,1,16,16,1.125,0,0,0,0,0,0.036,46.2
5.8,33,30,45.0,1,8.7,21,20,16,31.684,47.6,31.591,52.207,49,46,4,9,410.41,4,23,22,1.135,0,0,2,3,2,0.082,45.7
6.745,37,33,51.0,5,10.5,25,20,24,37.299,57.218,38.796,64.145,61,57,6,8,440.55,8,27,26,1.125,0,0,0,2,0,0.131,43.9
5.8,27,24,38.0,4,9.5,19,15,18,27.488,41.92,28.807,47.109,45,42,4,5,318.41,2,21,20,1.122,0,0,0,1,0,0.044,45.2
5.8,37,34,49.0,11,7.7,27,15,31,40.385,64.65,42.836,73.308,68,65,5,7,457.63,7,19,16,1.128,1,0,0,2,0,0.103,41.5
5.8,30,26,41.0,3,9.5,20,17,16,28.676,42.363,29.5,46.903,46,42,4,6,344.4,3,19,16,1.117,0,0,0,2,0,0.065,47.6
5.8,38,35,52.0,5,8.6,23,18,23,38.324,59.502,39.256,65.405,61,58,5,12,497.58,8,22,16,1.128,0,0,0,6,0,0.131,39.7
5.8,30,28,39.0,7,9.4,21,14,25,32.805,53.0,34.552,60.062,55,53,5,7,379.51,5,15,12,1.133,0,0,0,2,0,0.091,39.6
5.8,24,20,33.0,3,21.4,11,8,8,21.217,28.724,22.739,31.165,32,28,6,9,320.46,0,18,18,1.113,0,0,0,0,0,0.0,39.3
5.8,31,28,42.5,5,12.0,21,16,22,32.058,50.007,33.58,56.521,53,50,6,7,374.49,5,22,21,1.13,0,0,0,1,0,0.094,42.0
5.8,27,24,38.0,1,10.3,19,18,15,27.074,39.033,28.449,43.428,42,39,4,5,334.83,4,22,22,1.114,0,1,1,0,0,0.095,48.7
5.8,28,25,38.0,5,9.3,19,13,18,28.203,43.247,29.262,48.318,46,43,4,6,334.41,3,17,16,1.124,1,0,0,2,0,0.065,44.2
5.8,28,26,38.0,3,4.4,21,18,19,29.597,45.323,30.711,50.492,47,45,2,5,350.42,6,19,18,1.122,0,0,1,2,1,0.128,46.7
5.8,24,21,31.5,6,13.2,15,9,17,23.983,38.138,25.051,43.192,41,38,5,6,283.37,3,15,15,1.137,0,0,0,1,0,0.073,39.5
5.8,24,22,30.0,8,11.6,15,7,21,25.751,43.232,27.029,49.232,45,43,5,7,303.41,3,11,10,1.145,0,0,0,2,0,0.067,34.9
5.8,33,30,45.0,2,8.5,22,20,17,32.165,48.341,32.381,53.543,50,47,4,8,410.43,3,23,22,1.139,0,0,3,1,3,0.06,46.8
5.8,41,37,56.0,1,9.3,26,25,17,38.756,56.032,38.972,61.301,58,54,5,11,523.55,4,29,28,1.135,0,0,4,1,4,0.069,48.1
5.8,25,22,35.0,4,10.0,18,14,18,25.773,39.592,27.353,44.9,43,40,4,4,290.4,2,20,20,1.122,0,0,0,0,0,0.047,45.0
5.8,42,38,57.5,4,10.8,28,24,27,43.034,65.28,45.211,72.979,69,65,7,10,525.69,6,29,27,1.123,0,0,0,2,0,0.087,43.1
5.8,22,20,30.5,2,12.9,14,11,11,21.735,31.593,22.381,34.807,33,31,4,6,286.74,1,13,11,1.123,1,1,1,1,0,0.03,45.2
5.8,34,31,47.0,2,11.8,22,20,20,34.433,51.527,35.921,57.235,54,51,6,9,432.55,4,24,22,1.122,0,0,0,2,0,0.074,43.1
5.8,28,26,38.0,4,4.2,22,18,22,30.74,47.694,32.534,53.567,50,48,2,4,346.46,5,19,18,1.116,0,0,0,2,0,0.1,45.8
5.8,22,20,31.5,0,9.1,16,16,13,22.413,33.051,23.279,36.78,35,33,3,4,263.32,2,18,17,1.115,0,0,0,1,0,0.057,48.5
5.9,37,33,51.5,1,11.5,24,23,19,36.101,52.712,37.404,58.365,56,52,6,9,458.56,4,28,27,1.122,0,0,1,1,1,0.071,46.2
5.8,19,17,27.0,0,7.4,13,13,10,18.58,27.393,18.966,30.076,29,27,2,4,226.25,1,16,16,1.114,0,0,0,2,0,0.034,48.1
5.8,25,23,34.0,1,5.4,17,16,14,25.535,37.564,26.591,41.036,39,37,2,6,326.4,3,15,12,1.109,0,0,0,3,0,0.077,45.9
5.8,23,21,32.0,1,11.8,15,14,13,23.46,34.382,24.637,38.12,36,34,4,6,345.22,3,17,16,1.121,0,0,1,1,0,0.083,44.1
7.3,52,46,67.0,13,10.6,34,21,39,53.239,85.152,55.836,96.341,91,85,9,12,621.82,6,28,26,1.133,0,0,0,3,0,0.066,40.0
5.8,34,30,47.0,4,9.4,24,20,23,34.563,52.789,36.336,59.438,57,53,5,6,397.52,6,26,26,1.121,0,0,0,1,0,0.105,45.3
5.8,25,23,34.5,5,9.8,17,12,18,26.203,41.247,27.262,46.318,43,41,4,6,310.39,4,17,15,1.13,0,0,0,2,0,0.093,41.5
5.8,21,19,30.0,0,7.1,14,14,9,20.435,28.654,21.097,31.127,30,28,2,5,272.32,2,17,16,1.112,0,0,1,1,1,0.067,50.0
5.8,35,32,46.0,4,5.8,24,20,20,34.912,53.334,35.353,59.085,55,52,3,8,439.47,3,20,18,1.136,0,0,3,2,3,0.055,46.2
6.6,40,37,52.0,7,10.8,24,17,28,42.016,66.047,44.233,73.655,68,65,7,13,590.56,8,21,18,1.133,0,0,1,4,0,0.118,36.9
5.8,28,26,39.0,1,6.7,21,20,19,29.708,45.029,31.017,50.235,47,45,3,5,345.43,4,20,18,1.116,0,0,0,2,0,0.085,46.7
5.8,35,32,47.0,5,11.5,22,17,20,34.539,53.36,34.909,59.41,55,52,6,10,438.48,6,23,22,1.142,0,0,2,2,2,0.109,42.3
5.8,36,32,48.0,5,14.3,23,18,24,36.1,56.211,37.591,63.517,60,56,8,9,428.55,5,23,22,1.134,0,0,0,1,0,0.083,41.1
5.8,32,29,44.5,1,10.6,22,21,18,31.893,47.534,32.75,52.947,50,47,5,7,387.45,3,24,23,1.127,0,0,1,1,1,0.06,46.8
6.5,31,28,42.0,1,14.6,18,17,13,29.071,42.705,29.029,46.899,44,41,6,10,402.82,4,22,22,1.144,0,1,3,1,2,0.091,43.9
5.8,39,35,56.0,1,8.9,28,25,21,39.223,55.982,41.222,61.943,60,56,5,7,475.61,3,30,28,1.106,2,0,0,1,0,0.05,50.0
5.8,33,30,42.5,5,10.4,20,15,18,31.901,49.771,31.841,55.251,51,48,5,10,417.43,3,18,17,1.151,0,0,3,2,3,0.059,41.7
5.8,39,35,54.0,3,6.6,29,26,26,40.31,60.781,42.307,67.979,65,61,4,6,462.59,8,29,28,1.114,0,0,0,2,0,0.123,47.5
5.8,28,25,40.0,1,7.1,21,20,17,28.467,41.818,29.801,46.611,45,42,3,4,327.41,4,23,22,1.11,0,0,0,1,0,0.089,50.0
5.8,32,28,45.5,1,13.0,22,21,18,31.289,45.912,32.603,51.481,50,46,6,6,366.46,4,27,27,1.119,0,0,0,0,0,0.08,47.8
5.8,29,27,40.0,5,8.2,19,14,22,31.158,49.418,32.887,55.278,51,49,4,8,386.52,7,19,16,1.128,0,0,0,3,0,0.137,38.8
5.8,27,24,39.5,2,11.1,19,14,12,25.908,36.269,26.523,39.863,39,36,4,5,312.35,2,19,17,1.107,3,0,0,1,0,0.051,52.8
5.8,24,22,35.0,1,5.9,15,14,12,24.195,34.756,25.477,37.541,36,34,2,7,332.43,3,19,16,1.104,0,0,0,3,0,0.083,44.1
4.8,18,16,26.0,0,15.4,12,12,10,17.666,26.058,18.307,29.239,28,26,4,4,210.26,1,16,16,1.125,0,0,0,0,0,0.036,46.2
5.8,33,30,46.0,1,12.5,21,20,18,32.906,48.643,34.159,53.82,51,48,6,9,418.52,4,24,22,1.121,0,0,0,2,0,0.078,43.8
6.9,50,44,65.0,12,11.1,33,21,37,50.997,80.941,53.62,91.716,87,81,9,11,591.79,5,28,26,1.132,0,0,0,2,0,0.057,40.7
5.8,30,27,40.5,5,4.1,23,18,22,31.74,48.694,33.534,54.567,52,49,2,4,358.47,3,19,17,1.114,0,0,0,2,0,0.058,46.9
5.8,33,29,46.0,3,8.2,23,20,20,33.202,48.88,35.216,54.444,53,49,4,6,400.54,6,26,26,1.111,0,0,0,1,0,0.113,46.9
5.8,34,30,46.5,4,13.0,20,16,16,31.485,47.592,31.387,52.579,50,46,6,10,410.42,4,25,25,1.143,0,0,2,2,2,0.08,43.5
5.8,24,22,33.0,1,5.6,17,16,14,24.82,36.236,26.137,39.827,38,36,2,5,310.4,3,15,12,1.106,0,0,0,2,0,0.079,47.2
5.8,18,17,24.0,1,3.8,11,10,9,18.647,26.771,19.71,28.627,27,26,1,6,267.35,2,9,6,1.101,0,0,0,3,0,0.074,42.3
5.8,19,18,26.0,1,7.7,11,10,8,19.422,27.116,20.33,28.884,27,26,2,7,303.18,2,12,10,1.111,0,2,2,2,0,0.074,42.3
5.8,31,28,43.0,1,13.0,20,19,18,31.191,46.316,32.705,51.61,49,46,6,8,390.51,3,23,22,1.122,0,0,0,1,0,0.061,43.5
5.8,39,35,53.0,6,8.1,28,20,27,40.804,61.632,43.506,69.188,66,62,5,7,481.67,4,24,22,1.116,2,0,0,1,0,0.061,45.2
5.8,40,36,55.0,3,6.6,29,26,25,41.137,61.105,43.165,67.923,65,61,4,7,497.03,8,29,28,1.113,0,1,1,2,0,0.123,47.5
5.8,25,22,33.0,5,10.0,17,12,18,25.488,39.92,26.807,45.109,43,40,4,5,294.39,2,16,16,1.128,0,0,0,1,0,0.047,42.5
5.8,30,28,39.5,2,10.5,17,15,10,27.261,41.112,25.671,44.732,40,38,4,11,400.31,2,18,17,1.177,0,0,6,1,6,0.05,44.7
5.8,35,31,51.0,0,10.9,21,21,15,33.26,47.062,34.494,51.036,50,46,5,10,449.55,5,29,26,1.109,0,0,0,3,0,0.1,45.7
5.8,22,20,31.0,0,11.5,13,12,6,20.09,27.378,19.761,28.898,28,26,3,7,287.67,0,11,6,1.111,1,1,1,3,0,0.0,50.0
5.8,21,19,30.0,0,10.3,14,14,10,20.714,29.491,21.375,32.309,31,29,3,5,271.72,2,17,16,1.114,0,1,1,1,0,0.065,48.3
5.8,21,19,29.0,2,6.1,15,13,14,22.106,32.909,23.682,36.617,35,33,2,4,270.38,4,16,16,1.11,0,0,0,1,0,0.114,45.5
5.8,28,26,39.0,4,8.7,18,14,20,29.632,46.534,31.125,51.863,48,46,4,8,372.49,6,19,16,1.127,0,0,0,3,0,0.125,39.1
5.8,31,28,43.0,1,10.9,21,20,18,31.535,46.251,33.165,51.449,49,46,5,7,436.34,3,23,22,1.118,0,0,1,1,0,0.061,45.7
5.8,26,24,36.0,2,4.8,20,18,18,27.687,41.927,29.012,46.737,44,42,2,4,318.4,5,19,18,1.113,0,0,0,2,0,0.114,47.6
5.8,21,19,30.0,0,7.1,14,14,9,20.435,28.654,21.097,31.127,30,28,2,5,272.32,2,17,16,1.112,0,0,1,1,1,0.067,50.0
5.8,27,25,34.0,7,12.2,18,11,24,29.584,48.891,31.341,55.936,51,49,6,7,340.48,5,13,12,1.142,0,0,0,1,0,0.098,36.7
5.8,29,26,41.0,0,7.7,20,20,13,27.706,39.96,27.915,43.875,42,39,3,6,349.36,3,23,22,1.125,0,0,2,1,2,0.071,51.3
5.8,29,26,40.5,2,11.6,19,17,17,28.697,43.465,29.506,48.402,46,43,5,7,347.41,5,22,21,1.126,0,0,0,2,0,0.109,44.2
5.8,19,17,26.0,1,4.5,11,10,5,18.071,23.036,19.057,23.868,24,22,1,6,330.59,0,12,10,1.085,0,1,2,2,0,0.0,50.0
5.8,31,28,42.0,4,8.2,22,18,21,32.369,49.011,34.188,54.883,52,49,4,6,392.92,6,22,22,1.12,0,1,1,1,0,0.115,44.9
5.8,31,28,43.0,3,8.0,23,20,22,32.542,49.687,34.33,55.939,53,50,4,5,370.49,7,23,22,1.119,0,0,0,1,0,0.132,46.0
5.8,27,25,37.0,3,4.4,21,18,20,29.214,44.811,30.773,50.152,47,45,2,4,332.43,5,19,18,1.114,0,0,0,2,0,0.106,46.7
5.8,26,23,36.5,1,16.7,16,15,13,25.552,36.214,27.739,40.371,39,36,6,7,416.25,3,21,21,1.121,0,0,1,0,0,0.077,44.4
6.0,30,28,41.0,1,6.5,21,20,18,31.279,46.618,32.603,51.495,48,46,3,7,395.49,5,20,18,1.119,0,0,1,2,1,0.104,45.7
5.8,23,22,32.0,2,14.7,14,11,12,23.471,35.022,23.841,38.515,35,34,5,8,317.76,3,14,12,1.133,1,1,1,2,0,0.086,41.2
5.959,31,28,39.5,7,7.8,21,14,23,32.611,51.222,34.404,57.508,54,51,4,7,398.93,5,17,17,1.128,0,1,1,2,0,0.093,41.2
5.8,29,26,41.0,0,22.2,14,14,10,26.502,37.505,27.011,40.66,39,36,8,12,386.46,5,22,20,1.129,0,0,0,2,0,0.128,38.9
5.8,28,24,38.5,4,12.2,19,15,17,27.268,40.811,28.597,45.983,45,41,5,5,315.41,4,21,21,1.122,0,0,0,0,0,0.089,46.3
5.8,37,34,49.0,4,6.9,25,21,24,37.928,58.88,38.909,65.192,61,58,4,9,460.53,6,21,18,1.124,0,0,0,5,0,0.098,43.1
5.8,19,18,24.0,4,15.6,10,6,14,20.487,32.651,22.404,36.707,33,32,5,8,363.19,4,10,10,1.147,0,0,1,2,0,0.121,31.3
5.8,23,21,32.5,0,16.1,14,14,10,21.786,32.0,21.705,35.286,33,31,5,7,283.29,2,18,17,1.138,0,0,1,1,1,0.061,45.2
4.602,43,38,60.0,4,9.4,30,26,26,42.826,64.101,44.557,71.561,69,64,6,8,502.62,9,33,32,1.118,0,0,0,2,0,0.13,46.9
5.8,22,20,31.0,0,7.1,14,14,8,20.819,29.167,21.034,31.466,30,28,2,6,290.31,2,17,16,1.124,0,0,2,1,2,0.067,50.0
5.8,25,23,34.0,1,8.8,16,15,11,24.783,35.025,25.449,37.878,36,34,3,7,348.2,5,15,12,1.114,0,2,2,2,0,0.139,47.1
5.8,17,15,24.5,0,28.6,8,8,6,15.316,21.687,15.682,23.91,23,21,6,7,218.27,0,15,15,1.139,0,0,0,0,0,0.0,38.1
5.8,21,18,31.0,0,14.3,14,14,10,19.666,28.058,20.307,31.239,31,28,4,4,234.28,1,20,20,1.116,0,0,0,0,0,0.032,50.0
5.8,30,27,42.0,0,9.5,20,20,15,30.174,42.342,32.046,46.455,45,42,4,7,439.36,3,23,22,1.106,0,0,1,1,0,0.067,47.6
5.8,28,26,38.0,3,6.4,21,18,21,30.235,46.912,31.779,52.651,49,47,3,5,347.45,6,19,18,1.12,0,0,0,2,0,0.122,44.7
5.8,31,28,43.0,2,8.3,22,20,20,32.202,47.88,34.216,53.444,51,48,4,6,388.53,3,23,22,1.113,0,0,0,1,0,0.059,45.8
7.252,39,35,50.5,7,6.6,27,20,26,40.048,61.501,41.864,68.678,65,61,4,8,493.02,7,23,23,1.126,0,1,2,2,1,0.108,44.3
5.8,23,21,31.0,5,7.5,17,12,19,24.993,39.702,26.563,45.026,42,40,3,4,281.39,3,16,16,1.126,0,0,0,1,0,0.071,42.5
5.8,26,24,35.5,1,14.7,15,14,10,24.079,35.909,23.341,39.381,36,34,5,9,333.3,2,18,17,1.158,0,0,3,1,3,0.056,44.1
6.0,34,30,46.5,4,13.0,20,16,16,31.485,47.592,31.387,52.579,50,46,6,10,410.42,4,25,25,1.143,0,0,2,2,2,0.08,43.5
4.8,14,13,20.0,1,13.6,9,8,9,14.359,22.284,14.756,24.95,23,22,3,4,175.21,1,11,10,1.134,0,0,0,1,0,0.043,40.9
6.886,36,32,50.0,4,12.7,24,20,23,36.079,55.109,37.586,62.019,59,55,7,8,425.54,6,27,26,1.128,0,0,0,1,0,0.102,43.6
5.8,34,31,47.0,2,11.8,22,20,20,33.96,51.778,34.728,57.524,54,51,6,9,416.48,5,24,22,1.128,0,0,0,3,0,0.093,43.1
5.8,30,27,41.5,4,12.8,20,16,20,30.531,47.123,31.819,53.106,50,47,6,7,360.46,6,22,21,1.13,0,0,0,1,0,0.12,42.6
5.8,19,17,26.0,0,16.7,11,11,7,18.171,24.571,19.659,26.754,26,24,4,6,338.12,0,13,12,1.115,0,0,1,1,0,0.0,45.8
4.8,19,17,27.5,0,12.5,11,11,7,17.735,24.804,18.097,26.664,26,24,3,6,245.28,2,16,15,1.111,0,0,0,2,0,0.077,45.8
5.8,21,19,29.5,1,10.3,13,12,10,20.457,29.756,21.102,32.625,31,29,3,6,275.33,2,16,15,1.125,0,0,1,1,1,0.065,44.8
5.8,35,31,46.5,7,12.5,23,16,25,35.606,55.992,37.347,63.434,60,56,7,8,415.55,4,22,21,1.133,0,0,0,1,0,0.067,41.1
5.9,34,32,46.0,3,11.3,20,17,21,34.772,54.578,35.529,60.409,55,53,6,12,460.54,8,21,18,1.14,0,0,1,4,1,0.145,37.7
7.5,26,23,34.5,5,7.5,16,11,17,26.083,40.549,27.358,44.95,43,40,3,7,331.43,4,14,11,1.124,0,0,0,3,0,0.093,40.0
5.8,30,26,42.0,1,9.5,21,20,16,28.961,42.036,30.046,46.694,46,42,4,5,340.41,3,23,22,1.112,0,0,0,1,0,0.065,50.0
5.8,33,30,45.0,2,8.2,22,20,19,32.828,49.971,33.415,55.283,52,49,4,8,406.45,4,23,22,1.128,0,0,1,3,1,0.077,44.9
5.8,28,26,37.5,2,10.3,17,15,13,26.826,40.902,26.313,44.922,41,39,4,9,362.34,3,18,17,1.152,0,0,3,2,3,0.073,43.6
5.8,27,25,36.0,2,8.1,17,15,12,25.805,38.8,25.307,42.424,39,37,3,8,347.32,5,15,12,1.147,0,0,3,2,3,0.128,45.9
5.8,30,27,42.0,3,8.2,23,20,22,31.827,48.36,33.875,54.73,52,49,4,4,354.49,5,23,22,1.117,0,0,0,0,0,0.096,46.9
5.8,29,26,40.0,1,10.5,18,17,12,27.804,39.127,28.455,42.376,41,38,4,8,387.24,5,19,16,1.115,0,2,2,2,0,0.122,47.4
5.8,36,33,50.0,4,8.6,26,20,25,38.277,57.749,40.745,64.773,61,58,5,7,455.63,3,24,22,1.117,2,0,0,1,0,0.049,44.8
5.8,29,26,40.5,3,11.1,20,17,19,29.509,45.022,30.813,50.607,48,45,5,6,345.44,4,22,21,1.125,0,0,0,1,0,0.083,44.4
5.8,36,33,50.0,4,8.6,26,20,25,38.277,57.749,40.745,64.773,61,58,5,7,455.63,4,24,22,1.117,2,0,0,1,0,0.066,44.8
5.8,25,23,34.0,3,13.9,15,12,13,24.222,37.28,24.165,41.456,38,36,5,8,317.33,4,17,16,1.152,0,0,2,1,2,0.105,41.7
5.8,30,28,39.5,2,10.5,17,15,10,27.261,41.112,25.671,44.732,40,38,4,11,400.31,2,18,17,1.177,0,0,6,1,6,0.05,44.7
5.8,33,30,46.0,1,12.5,21,20,18,32.906,48.643,34.159,53.82,51,48,6,9,418.52,4,24,22,1.121,0,0,0,2,0,0.078,43.8
6.5,28,25,39.5,1,7.1,21,20,17,28.467,41.818,29.801,46.611,45,42,3,4,327.41,5,23,23,1.11,0,0,0,1,0,0.111,50.0
6.3,39,35,53.5,2,10.7,25,23,21,38.343,56.923,39.62,62.99,60,56,6,10,488.59,6,28,27,1.125,0,0,1,2,1,0.1,44.6
5.8,28,25,37.5,2,10.3,18,16,14,27.172,39.873,27.841,43.978,42,39,4,7,356.81,2,18,17,1.128,0,1,2,1,1,0.048,46.2
5.8,24,22,33.0,1,8.8,16,15,12,23.955,34.702,24.591,37.934,36,34,3,6,313.76,5,15,12,1.116,0,1,1,2,0,0.139,47.1
5.8,27,25,36.5,1,11.4,16,15,10,25.412,37.014,24.955,40.242,37,35,4,9,366.75,2,18,17,1.15,0,1,4,1,3,0.054,45.7
5.8,29,25,41.5,2,12.5,19,17,15,27.928,40.003,29.483,44.488,44,40,5,6,345.46,3,25,25,1.112,0,0,0,0,0,0.068,47.5
5.8,29,27,38.0,4,12.2,16,11,14,28.143,42.887,27.966,46.559,43,41,5,11,391.8,0,14,12,1.136,1,1,1,5,0,0.0,39.0
5.8,31,28,43.0,1,9.5,20,19,14,31.001,42.665,32.904,46.399,45,42,4,8,473.8,4,23,22,1.105,0,1,2,1,0,0.089,47.6
7.5,42,35,55.0,9,6.6,28,19,26,40.025,61.109,41.762,68.189,68,61,4,7,466.58,2,25,24,1.118,0,0,0,3,0,0.029,45.9
5.8,50,45,63.0,10,3.7,35,25,37,52.023,82.618,54.142,92.019,87,82,3,10,611.75,11,25,24,1.122,0,0,0,7,0,0.126,42.7
5.8,39,35,49.5,9,9.2,26,17,30,40.594,65.196,42.534,73.6,69,65,6,9,474.62,6,19,17,1.132,0,0,0,3,0,0.087,40.0
5.8,25,23,34.5,0,14.7,15,15,11,24.14,35.207,24.324,38.645,36,34,5,8,331.76,3,18,17,1.137,0,1,2,1,1,0.083,44.1
5.8,36,33,47.0,4,13.2,22,18,20,35.229,54.647,35.398,61.038,56,53,7,11,455.49,4,20,18,1.152,0,0,3,1,3,0.071,41.5
5.8,22,20,31.5,0,16.1,14,14,11,21.402,31.487,21.767,34.947,33,31,5,6,265.3,2,18,17,1.127,0,0,0,1,0,0.061,45.2
8.0,52,46,70.0,6,10.1,36,30,33,52.118,79.141,54.336,88.933,85,79,8,10,612.77,8,35,34,1.126,0,0,1,1,1,0.094,45.6
5.8,24,22,33.0,1,11.8,15,14,12,24.089,34.8,25.0,38.167,36,34,4,7,335.21,3,17,16,1.123,0,2,2,1,0,0.083,44.1
6.0,37,34,46.5,9,5.2,24,15,24,37.395,59.756,37.784,66.334,61,58,3,10,475.51,7,18,17,1.144,0,0,3,4,3,0.115,41.4
5.8,29,26,40.0,3,6.7,21,18,19,30.181,44.778,32.211,49.946,48,45,3,5,361.5,6,22,22,1.11,0,0,0,1,0,0.125,46.7
5.8,33,29,45.0,3,10.4,22,19,19,32.697,48.098,34.461,53.527,52,48,5,7,401.53,2,23,22,1.115,0,0,0,1,0,0.038,45.8
5.8,24,22,33.0,1,8.8,16,15,12,23.511,34.891,23.671,38.329,36,34,3,6,297.31,5,15,12,1.127,0,0,1,2,1,0.139,47.1
5.8,40,36,54.0,6,7.9,28,20,27,41.518,62.96,43.961,70.398,67,63,5,8,497.67,4,24,22,1.117,2,0,0,2,0,0.06,44.4
5.8,37,33,51.5,2,10.9,25,23,22,37.245,55.083,39.228,61.441,59,55,6,8,454.6,4,28,27,1.117,0,0,0,1,0,0.068,45.5
6.9,34,31,47.0,1,10.2,22,21,18,34.239,49.749,35.773,54.681,52,49,5,9,451.97,4,24,22,1.116,0,1,1,2,0,0.077,44.9
5.8,21,19,28.5,2,6.9,13,11,10,20.009,30.047,19.875,32.495,31,29,2,6,258.25,2,13,11,1.121,0,0,0,4,0,0.065,44.8
5.8,20,18,27.5,0,12.0,12,12,7,19.504,25.676,21.273,27.615,27,25,3,6,371.57,1,13,11,1.105,0,1,2,1,0,0.037,48.0
5.8,28,26,37.5,2,10.3,17,15,13,26.826,40.902,26.313,44.922,41,39,4,9,362.34,3,18,17,1.152,0,0,3,2,3,0.073,43.6
5.8,21,19,30.0,0,10.3,14,14,10,20.714,29.491,21.375,32.309,31,29,3,5,271.72,2,17,16,1.114,0,1,1,1,0,0.065,48.3
5.8,24,22,32.5,3,10.8,16,13,15,24.789,37.36,25.904,41.638,39,37,4,6,314.8,5,17,17,1.125,0,1,1,1,0,0.128,43.2
6.0,34,29,46.5,4,10.6,22,18,18,32.365,47.283,33.944,52.658,52,47,5,7,403.52,4,25,25,1.12,0,0,1,0,1,0.077,46.8
5.8,29,26,41.0,1,7.0,21,20,17,29.181,43.145,30.256,47.82,46,43,3,5,343.41,4,23,22,1.112,0,0,0,2,0,0.087,48.8
5.8,27,24,39.0,0,7.7,20,20,15,26.94,38.934,28.04,43.196,42,39,3,4,313.38,3,23,22,1.108,0,0,0,1,0,0.071,51.3
6.5,31,29,41.0,6,1.9,23,17,23,34.142,52.334,36.222,57.997,54,52,1,6,432.37,7,18,16,1.115,0,2,2,3,0,0.13,44.2
5.8,20,18,28.0,0,11.5,12,12,8,19.374,26.684,20.261,28.814,28,26,3,6,277.75,2,16,16,1.108,0,1,1,1,0,0.071,46.2
5.8,25,24,35.0,1,14.7,14,12,10,24.374,35.793,23.989,38.519,35,34,5,10,347.74,4,15,12,1.133,1,1,1,4,0,0.114,41.2
5.8,38,35,52.0,6,7.8,28,20,29,41.33,63.516,44.267,71.603,67,64,5,7,483.69,5,24,22,1.119,2,0,0,1,0,0.075,43.8
5.8,38,34,46.0,11,10.2,23,12,25,37.503,60.523,38.131,67.995,63,59,6,11,474.54,6,14,12,1.152,0,0,3,2,3,0.095,39.0
5.8,26,23,37.0,1,7.9,19,18,15,26.412,37.683,28.233,41.906,41,38,3,4,317.44,4,22,22,1.103,0,0,0,0,0,0.098,50.0
5.8,31,28,40.5,6,13.2,21,15,25,32.891,52.665,34.893,60.225,56,53,7,7,375.53,5,18,17,1.136,0,0,0,0,0,0.089,39.6
5.8,25,23,34.5,1,11.1,16,15,13,25.174,36.709,26.091,40.33,38,36,4,7,373.23,3,18,17,1.12,0,0,1,2,0,0.079,44.4
5.8,32,29,45.0,2,10.0,23,21,21,33.036,49.905,34.574,56.023,53,50,5,6,383.49,6,24,22,1.12,0,0,0,1,0,0.113,46.0
5.8,30,27,42.0,1,11.4,20,19,17,29.697,44.465,30.506,49.402,47,44,5,7,359.42,3,23,22,1.123,0,0,0,2,0,0.064,45.5
5.8,43,39,58.0,4,4.5,29,25,27,43.862,66.949,45.529,73.654,70,66,3,10,545.66,7,27,24,1.116,0,0,0,6,0,0.1,43.9
5.8,44,39,57.0,11,9.7,29,18,33,45.143,72.181,47.302,81.514,77,72,7,10,527.69,8,26,26,1.132,0,0,0,3,0,0.104,40.3
5.8,21,19,29.5,0,14.8,13,13,8,20.321,27.705,21.023,30.127,29,27,4,6,291.15,2,17,17,1.116,0,2,2,0,0,0.069,48.1
5.8,23,22,32.0,3,13.5,15,11,15,24.171,37.582,24.745,41.986,38,37,5,7,297.35,5,14,12,1.135,1,0,0,2,0,0.132,40.5
5.8,31,28,43.0,2,8.5,22,20,19,31.398,47.316,32.506,52.864,50,47,4,6,374.45,4,23,22,1.125,0,0,1,1,1,0.08,46.8
5.8,30,27,41.5,3,8.5,21,18,20,31.202,46.88,33.216,52.444,50,47,4,6,376.52,5,22,21,1.116,0,0,0,1,0,0.1,44.7
5.8,26,23,36.5,3,12.5,18,15,17,26.268,39.811,27.597,44.983,43,40,5,5,303.4,3,21,21,1.125,0,0,0,0,0,0.07,45.0
5.8,30,27,42.0,1,11.4,20,19,17,29.697,44.465,30.506,49.402,47,44,5,7,359.42,3,23,22,1.123,0,0,0,2,0,0.064,45.5
5.8,26,24,35.5,3,7.3,18,15,17,27.369,41.222,28.904,45.74,43,41,3,6,339.45,5,18,17,1.116,0,0,0,2,0,0.116,43.9
5.8,34,31,42.5,9,8.6,22,13,27,35.761,58.538,37.222,65.896,61,58,5,9,425.54,8,17,17,1.136,0,0,0,4,0,0.131,37.9
5.8,37,34,48.0,9,9.5,25,16,29,39.263,63.381,41.017,71.731,66,63,6,9,464.6,9,22,22,1.139,0,0,1,2,1,0.136,39.7
5.8,20,18,26.5,3,6.9,13,10,11,20.406,29.349,21.779,32.146,31,29,2,5,278.78,1,12,11,1.108,0,1,1,1,0,0.032,44.8
5.8,30,27,41.5,0,7.0,21,21,16,30.009,43.469,31.114,47.764,46,43,3,6,377.85,4,23,23,1.111,0,1,1,2,0,0.087,48.8
6.0,37,32,53.0,1,14.3,23,22,17,34.686,49.534,35.949,54.694,54,49,7,9,439.54,4,31,30,1.116,0,0,0,1,0,0.074,46.9
5.8,32,29,44.0,1,10.6,21,20,18,31.608,47.862,32.205,53.156,50,47,5,8,391.44,4,23,22,1.131,0,0,1,2,1,0.08,44.7
5.8,25,23,34.0,3,7.9,17,14,15,25.233,38.843,25.676,43.29,40,38,3,6,315.35,4,17,16,1.139,0,0,2,1,2,0.1,44.7
5.8,47,42,62.0,8,5.4,34,25,32,48.32,74.087,50.5,82.644,79,74,4,8,560.7,8,26,24,1.117,1,0,0,4,0,0.101,45.9
5.8,33,30,46.5,2,7.7,25,23,22,34.542,51.687,36.33,57.939,55,52,4,5,394.51,6,25,23,1.114,0,0,0,1,0,0.109,48.1
5.8,19,17,27.0,0,12.0,12,12,8,18.659,25.356,19.807,27.605,27,25,3,5,261.75,2,16,16,1.104,0,1,1,0,0,0.074,48.0
5.8,21,20,27.0,6,7.7,15,9,19,23.708,39.029,25.017,44.235,40,39,3,5,273.37,3,9,6,1.134,0,0,0,2,0,0.075,38.5
5.8,26,24,34.0,4,9.5,17,13,18,27.39,42.323,28.909,47.238,44,42,4,7,342.46,5,14,12,1.125,0,0,0,2,0,0.114,40.5
5.8,33,29,46.5,1,13.0,22,21,17,31.673,46.425,32.54,51.821,50,46,6,7,384.45,4,27,27,1.127,0,0,1,0,1,0.08,47.8
5.8,37,33,47.0,9,10.3,24,15,25,37.209,58.614,38.495,65.9,62,58,6,9,448.55,4,16,12,1.136,0,0,1,2,1,0.065,41.4
5.8,35,32,47.5,4,13.2,21,17,21,35.169,53.956,36.381,59.943,56,53,7,11,451.56,7,23,21,1.131,0,0,0,3,0,0.125,39.6
5.8,28,25,39.5,1,13.2,17,16,13,27.303,38.524,28.824,42.202,41,38,5,8,367.49,3,22,21,1.111,0,0,0,1,0,0.073,44.7
5.8,27,24,35.0,6,11.9,17,11,18,27.337,42.345,28.671,47.551,45,42,5,7,343.85,3,16,16,1.132,0,1,1,1,0,0.067,40.5
5.8,32,29,43.5,5,11.8,21,16,22,32.772,51.334,34.034,57.73,54,51,6,8,390.49,7,22,21,1.132,0,0,0,2,0,0.13,41.2
5.8,27,24,35.5,6,9.1,18,12,20,28.202,43.88,30.216,49.444,47,44,4,6,340.49,3,16,15,1.124,0,0,0,1,0,0.064,40.9
5.8,29,26,40.5,2,7.0,20,18,17,29.369,43.222,30.904,47.74,46,43,3,6,363.47,5,22,21,1.11,0,0,0,2,0,0.109,46.5
6.7,31,29,44.0,1,13.6,18,16,15,31.119,45.316,32.205,49.456,46,44,6,11,475.36,7,21,18,1.124,1,0,1,3,0,0.152,40.9
5.8,44,39,57.0,10,10.1,28,18,30,44.443,69.621,46.398,78.043,74,69,7,11,548.1,8,26,26,1.131,0,1,1,3,0,0.108,40.6
5.8,33,30,44.0,6,11.3,22,16,23,33.968,53.403,35.279,60.276,56,53,6,8,406.51,6,22,22,1.137,0,0,1,1,1,0.107,41.5
5.8,34,30,46.0,3,8.0,23,20,20,33.444,50.458,34.478,55.943,54,50,4,7,400.47,6,23,22,1.119,0,0,0,3,0,0.111,46.0
5.8,29,27,40.5,3,6.4,20,17,20,31.447,47.218,33.779,52.412,49,47,3,7,446.4,8,20,17,1.115,0,0,1,2,0,0.163,42.6
5.8,33,30,45.0,1,8.9,21,20,15,31.825,46.534,32.267,51.048,48,45,4,9,428.47,3,23,22,1.134,0,0,3,1,3,0.063,46.7
5.8,38,34,53.0,1,9.3,26,25,20,37.607,54.494,39.159,60.282,58,54,5,8,469.58,4,29,28,1.116,0,0,1,1,1,0.069,48.1
5.8,29,26,39.5,2,8.3,17,15,10,26.465,37.993,26.193,40.929,39,36,3,9,377.37,3,21,21,1.137,0,0,3,2,3,0.077,47.2
5.8,29,26,42.0,0,12.2,18,18,15,28.358,41.658,29.392,45.906,44,41,5,8,365.45,4,24,22,1.12,0,0,0,2,0,0.091,43.9
5.8,31,29,42.0,2,6.1,22,20,20,33.25,49.313,35.284,54.515,51,49,3,7,425.97,5,20,18,1.113,0,1,1,2,0,0.098,44.9
5.8,32,28,46.0,0,11.1,22,22,17,31.455,44.887,33.245,49.903,49,45,5,6,383.51,3,27,26,1.109,0,0,0,0,0,0.061,48.9
5.8,39,34,50.0,10,7.7,28,18,31,40.67,64.323,43.381,73.099,70,65,5,6,453.64,7,22,22,1.125,0,0,0,1,0,0.1,43.1
5.8,40,36,54.5,2,10.7,25,23,20,38.726,57.436,39.557,63.33,60,56,6,11,506.58,5,28,27,1.131,0,0,2,2,2,0.083,44.6
5.8,31,28,44.0,1,8.7,22,21,18,31.675,45.996,33.455,51.029,49,46,4,6,386.51,5,24,22,1.109,0,0,0,1,0,0.102,47.8
5.8,28,25,38.0,1,5.3,19,18,13,27.648,38.56,28.994,41.771,41,38,2,6,368.86,2,19,18,1.099,0,1,1,2,0,0.049,50.0
5.8,32,29,45.0,0,13.3,20,20,16,31.379,45.76,32.398,50.405,48,45,6,9,404.49,4,24,22,1.12,0,0,0,2,0,0.083,44.4
5.8,31,28,43.0,2,11.1,20,18,17,30.412,45.793,30.96,50.611,48,45,5,8,375.42,4,20,16,1.125,0,0,0,3,0,0.083,44.4
5.8,40,36,54.5,2,14.5,24,22,19,37.723,56.865,37.642,63.121,59,55,8,12,492.51,4,28,27,1.148,0,0,3,1,3,0.068,43.6
6.1,32,30,44.0,2,12.0,19,17,20,32.862,51.182,33.83,56.654,52,50,6,11,428.52,8,21,18,1.133,0,0,0,4,0,0.154,38.0
5.8,22,20,29.5,3,8.6,15,12,15,22.655,35.262,23.495,39.405,37,35,3,5,269.33,3,13,11,1.126,0,0,0,2,0,0.081,42.9
4.8,14,12,19.5,1,10.0,10,9,8,13.623,19.854,14.296,22.242,22,20,2,2,156.2,0,11,11,1.112,0,0,0,0,0,0.0,50.0
5.8,21,19,29.5,1,13.3,14,13,11,20.576,30.454,21.006,33.994,32,30,4,5,254.29,2,17,17,1.133,0,0,1,0,1,0.063,46.7
5.8,26,23,36.5,2,15.4,17,15,16,25.762,39.029,26.841,44.066,42,39,6,6,304.39,3,21,21,1.13,0,0,0,0,0,0.071,43.6
4.8,18,16,26.0,0,7.7,13,13,10,17.865,26.065,18.512,28.867,28,26,2,3,210.25,1,16,16,1.11,0,0,0,1,0,0.036,50.0
5.8,21,19,31.5,1,10.7,14,12,9,20.074,28.611,20.21,31.159,30,28,3,5,251.26,1,17,15,1.113,1,0,0,2,0,0.033,50.0
5.8,26,24,36.0,2,7.0,20,18,19,27.993,42.702,29.563,48.026,45,43,3,4,317.42,5,19,18,1.117,0,0,0,1,0,0.111,46.5
5.8,19,17,27.0,0,11.1,13,13,10,19.197,27.069,20.415,29.997,29,27,3,4,288.16,1,16,16,1.111,0,0,1,0,0,0.034,48.1
5.8,20,18,29.0,0,14.3,13,13,10,19.381,28.385,19.762,31.448,30,28,4,5,238.27,2,17,16,1.123,0,0,0,1,0,0.067,46.4
5.9,39,35,53.5,4,8.1,29,25,27,40.617,61.556,42.858,69.268,66,62,5,6,461.61,7,26,23,1.117,0,0,0,1,0,0.106,46.8
5.8,33,30,46.0,0,15.2,20,20,16,31.597,47.298,31.693,52.323,49,46,7,10,405.43,4,24,22,1.137,0,0,1,2,1,0.082,43.5
5.8,32,29,44.0,2,8.3,22,20,19,32.113,48.643,32.961,54.073,51,48,4,7,390.45,4,23,22,1.127,0,0,1,2,1,0.078,45.8
5.8,31,29,39.5,8,7.1,22,14,27,34.22,56.178,36.006,63.734,58,56,4,7,398.53,7,14,11,1.138,0,0,1,2,1,0.121,39.3
5.8,22,20,30.5,2,8.6,16,14,15,22.94,34.934,24.04,39.196,37,35,3,4,265.34,4,17,17,1.12,0,0,0,1,0,0.108,45.7
5.8,32,29,43.0,4,8.2,22,18,20,33.197,49.334,35.046,54.827,52,49,4,7,427.36,6,22,22,1.119,0,2,2,1,0,0.115,44.9
5.8,39,34,50.0,10,7.7,28,18,31,40.67,64.323,43.381,73.099,70,65,5,6,453.64,7,22,22,1.125,0,0,0,1,0,0.1,43.1
5.8,30,28,40.0,3,18.2,15,12,16,28.852,45.985,28.364,50.694,46,44,8,13,388.39,6,18,16,1.152,0,0,0,5,0,0.13,34.1
5.8,30,28,40.0,4,4.1,22,18,21,31.839,49.534,32.926,55.117,51,49,2,6,380.45,6,19,18,1.125,0,0,1,3,1,0.118,44.9
5.8,32,30,42.0,7,10.0,20,12,20,33.008,51.211,33.796,56.595,52,50,5,10,429.9,6,15,12,1.132,1,1,1,4,0,0.115,40.0
5.8,32,29,43.0,5,12.0,21,16,21,32.441,50.52,33.517,56.861,53,50,6,8,392.48,6,22,22,1.137,0,0,1,1,1,0.113,42.0
8.4,49,43,67.5,4,10.0,33,29,27,48.034,70.28,50.211,77.979,76,70,7,10,585.74,8,35,33,1.114,0,0,0,2,0,0.105,47.1
5.8,32,28,41.0,4,7.0,20,16,15,30.135,44.247,30.779,48.42,47,43,3,8,399.45,4,15,12,1.126,0,0,2,2,2,0.085,46.5
6.0,27,24,35.0,6,11.9,17,11,18,27.337,42.345,28.671,47.551,45,42,5,7,343.85,3,16,16,1.132,0,1,1,1,0,0.067,40.5
5.8,34,31,45.0,6,11.3,22,16,22,34.351,53.916,35.216,60.615,56,53,6,9,424.5,6,22,22,1.144,0,0,2,1,2,0.107,41.5
5.8,40,36,54.5,6,7.7,29,23,29,41.858,64.767,44.074,72.893,69,65,5,7,479.63,9,28,27,1.121,0,0,0,2,0,0.13,44.6
5.8,37,33,48.0,9,10.0,25,16,27,38.021,60.17,39.802,68.106,64,60,6,8,446.58,8,22,22,1.135,0,0,1,1,1,0.125,41.7
5.8,27,25,37.0,3,6.5,21,18,21,29.52,45.585,31.324,51.441,48,46,3,4,331.45,7,19,18,1.118,0,0,0,1,0,0.146,45.7
5.8,30,27,42.0,2,6.5,22,20,19,31.181,45.778,33.211,50.946,49,46,3,5,373.51,3,23,22,1.108,0,0,0,1,0,0.061,47.8
5.8,33,31,44.0,2,8.3,21,19,17,32.594,49.996,32.29,54.962,50,48,4,10,430.42,5,20,18,1.145,0,0,3,3,3,0.1,43.8
5.8,17,15,24.0,0,10.0,10,10,5,15.354,20.949,15.301,22.19,22,20,2,5,220.62,0,12,10,1.109,0,1,1,2,0,0.0,50.0
5.8,25,23,35.0,3,9.8,16,13,18,26.39,41.323,27.909,46.238,43,41,4,7,330.45,5,18,16,1.128,0,0,0,2,0,0.116,39.0
5.8,29,26,40.0,2,9.5,19,17,16,28.391,42.691,28.955,47.113,45,42,4,7,348.39,4,19,16,1.122,0,0,0,3,0,0.089,45.2
5.8,18,16,26.0,0,8.0,13,13,9,18.175,24.967,19.409,27.499,27,25,2,3,273.14,1,16,16,1.1,0,0,1,0,0,0.037,52.0
5.8,33,30,43.0,6,17.6,18,12,21,32.498,52.2,32.983,58.604,54,51,9,12,411.48,7,18,16,1.149,0,0,0,3,0,0.13,35.3
5.8,34,31,43.0,9,12.5,21,12,25,34.899,56.901,35.983,64.529,59,56,7,10,429.53,7,17,16,1.152,0,0,2,1,2,0.119,37.5
5.8,33,29,45.0,2,6.4,24,22,18,32.821,47.025,34.421,51.97,51,47,3,5,399.9,3,21,18,1.106,0,1,1,1,0,0.059,51.1
5.8,23,21,31.0,3,10.8,15,12,16,23.676,37.363,24.5,41.903,39,37,4,6,284.35,5,16,16,1.133,0,0,0,2,0,0.128,40.5
5.8,22,20,32.0,1,16.1,13,12,11,21.117,31.814,21.222,35.156,33,31,5,7,269.29,3,18,16,1.134,0,0,0,2,0,0.091,41.9
5.8,28,25,38.0,2,7.5,18,16,15,27.557,40.665,28.597,44.534,43,40,3,7,353.43,3,18,16,1.113,0,0,0,3,0,0.07,45.0
5.8,30,27,43.0,1,11.4,19,18,17,29.885,44.542,31.154,49.322,47,44,5,8,379.48,5,24,22,1.121,0,0,0,2,0,0.106,43.2
5.8,31,28,43.0,3,6.1,23,20,21,32.235,48.912,33.779,54.651,52,49,3,5,371.47,7,23,22,1.115,0,0,0,2,0,0.135,46.9
6.8,34,32,45.0,4,9.3,20,16,22,35.437,55.498,36.659,61.139,56,54,5,12,479.99,9,20,18,1.132,0,1,1,5,0,0.161,37.0
5.8,33,30,46.0,0,10.9,21,21,16,31.796,47.305,31.898,51.951,49,46,5,9,405.42,4,24,22,1.129,0,0,1,3,1,0.082,45.7
5.8,29,27,39.0,4,6.0,22,18,23,31.762,49.796,33.54,56.066,52,50,3,5,361.48,9,19,18,1.121,0,0,0,2,0,0.173,44.0
5.8,37,33,48.0,8,10.5,24,16,24,36.878,57.8,37.978,65.031,61,57,6,9,450.54,7,22,22,1.141,0,0,2,1,2,0.115,42.1
5.8,18,16,26.0,0,8.0,13,13,9,18.175,24.967,19.409,27.499,27,25,2,3,273.14,1,16,16,1.1,0,0,1,0,0,0.037,52.0
5.8,25,23,36.0,1,8.6,17,15,12,25.153,35.607,26.085,38.831,37,35,3,6,370.22,3,18,16,1.109,1,0,1,2,0,0.081,48.6
5.8,38,35,54.0,3,8.6,25,20,23,39.367,58.596,41.54,64.697,61,58,5,10,505.67,5,26,22,1.115,2,0,0,3,0,0.082,43.1
5.8,40,36,55.0,3,6.6,29,26,25,40.693,61.294,42.245,68.319,65,61,4,7,480.58,8,29,28,1.12,0,0,1,2,1,0.123,47.5
5.8,19,18,23.0,8,7.7,14,6,21,22.52,38.585,24.324,44.441,40,39,3,4,247.38,3,7,6,1.14,0,0,0,1,0,0.075,35.9
5.8,26,24,35.5,1,14.7,15,14,10,24.079,35.909,23.341,39.381,36,34,5,9,333.3,2,18,17,1.158,0,0,3,1,3,0.056,44.1
5.8,32,28,44.0,2,11.1,21,19,17,31.17,45.214,32.699,50.112,49,45,5,7,387.5,2,23,22,1.114,0,0,0,1,0,0.041,46.7
5.8,26,23,36.5,0,12.5,15,15,9,24.11,33.113,24.722,35.522,35,32,4,8,344.8,3,21,21,1.11,0,1,1,2,0,0.086,46.9
5.8,24,22,33.0,2,8.1,17,15,15,24.655,37.262,25.495,41.405,39,37,3,5,293.35,3,15,12,1.119,0,0,0,2,0,0.077,45.9
5.9,33,30,45.5,3,10.0,22,19,20,34.248,50.211,36.574,55.784,53,50,5,8,482.44,7,23,21,1.116,0,0,1,1,0,0.132,44.0
5.1,15,13,20.5,1,10.0,10,9,7,14.648,20.084,15.648,22.084,22,20,2,3,235.09,0,11,11,1.104,0,0,1,0,0,0.0,50.0
6.854,30,28,38.0,8,11.3,19,11,25,33.615,52.92,37.409,59.992,55,53,6,9,512.47,8,16,16,1.132,0,0,1,1,0,0.145,35.8
5.8,29,26,39.0,1,12.5,18,17,14,27.998,40.905,28.602,44.93,43,40,5,8,367.82,1,19,18,1.123,0,1,1,2,0,0.023,45.0
5.8,31,28,43.0,1,7.0,20,19,15,29.799,44.244,29.858,48.033,46,43,3,8,377.38,3,21,18,1.117,0,0,0,5,0,0.065,46.5
5.8,26,23,34.0,6,14.0,17,11,20,26.816,42.796,28.364,48.896,46,43,6,6,308.43,3,16,16,1.137,0,0,0,0,0,0.065,39.5
6.4,26,23,38.5,0,14.7,17,16,11,24.875,34.236,25.96,37.657,37,34,5,6,317.4,2,22,21,1.108,1,0,0,0,0,0.054,50.0
5.8,29,26,40.5,3,13.6,19,16,18,29.004,44.24,30.057,49.69,47,44,6,7,346.43,4,22,21,1.129,0,0,0,1,0,0.085,43.2
5.8,37,32,50.5,5,9.1,26,21,23,36.563,54.789,38.336,61.438,60,55,5,6,421.54,3,27,27,1.117,0,0,0,1,0,0.05,47.3
5.8,20,18,29.0,0,3.7,14,14,9,19.745,27.367,20.608,29.498,29,27,1,4,255.31,2,17,16,1.093,0,0,0,2,0,0.069,51.9
5.8,33,30,44.0,5,12.0,21,16,20,32.824,51.032,33.455,57.2,53,50,6,9,410.47,5,22,22,1.144,0,0,2,1,2,0.094,42.0
5.8,34,30,44.5,7,12.0,21,14,20,32.824,51.032,33.455,57.2,54,50,6,9,410.47,4,21,21,1.144,0,0,2,1,2,0.074,42.0
5.8,33,30,45.0,3,4.0,24,21,20,33.643,50.465,34.682,55.571,53,50,2,6,400.46,5,21,18,1.111,0,0,0,4,0,0.094,48.0
5.8,20,18,25.0,6,15.6,11,5,14,20.773,32.323,22.949,36.498,34,32,5,7,359.2,1,10,10,1.141,0,0,1,1,0,0.029,34.4
5.8,22,20,30.0,4,8.1,16,12,17,23.467,36.818,24.801,41.611,39,37,3,4,267.36,5,16,16,1.125,0,0,0,1,0,0.128,43.2
5.8,24,21,31.5,6,2.6,18,12,17,24.665,37.825,26.006,42.239,41,38,1,3,279.36,1,13,11,1.112,0,0,0,2,0,0.024,47.4
4.8,15,14,20.5,2,16.7,8,6,10,15.568,24.462,16.409,27.368,25,24,4,6,210.29,1,10,9,1.14,0,0,0,1,0,0.04,33.3
5.8,28,26,38.0,3,4.4,21,18,19,30.041,45.134,31.631,50.096,47,45,2,5,366.87,6,19,18,1.113,0,1,1,2,0,0.128,46.7
5.8,29,26,41.0,0,7.7,20,20,13,27.706,39.96,27.915,43.875,42,39,3,6,349.36,3,23,22,1.125,0,0,2,1,2,0.071,51.3
5.8,19,18,26.0,2,10.3,11,9,11,19.503,29.898,20.074,32.704,30,29,3,7,265.32,3,12,10,1.128,0,0,0,3,0,0.1,37.9
5.8,27,24,37.5,2,7.3,20,18,17,27.467,40.818,28.801,45.611,44,41,3,4,315.4,3,19,17,1.112,0,0,0,1,0,0.068,48.8
5.8,26,23,34.5,5,10.3,16,11,16,25.391,39.691,25.955,44.113,42,39,4,7,312.36,2,16,15,1.131,0,0,0,3,0,0.048,41.0
5.8,32,29,43.5,5,5.8,23,18,23,33.949,51.872,36.188,57.986,55,52,3,6,405.56,5,22,21,1.115,0,0,0,2,0,0.091,44.2
5.8,24,22,34.0,2,10.5,15,13,16,24.863,38.44,26.148,42.823,40,38,4,7,316.42,4,18,16,1.127,0,0,0,2,0,0.1,39.5
7.9,41,36,52.0,11,8.6,29,18,34,43.218,69.309,46.148,79.012,75,70,6,7,482.69,5,22,22,1.129,0,0,0,1,0,0.067,41.4
5.8,33,30,45.0,1,10.9,21,20,16,31.659,47.56,31.625,52.626,49,46,5,9,411.42,3,23,22,1.144,0,0,3,1,3,0.061,45.7
5.8,29,26,41.0,1,7.0,21,20,17,29.181,43.145,30.256,47.82,46,43,3,5,343.41,4,23,22,1.112,0,0,0,2,0,0.087,48.8
5.8,34,30,49.0,2,6.1,23,21,19,34.082,49.182,36.313,54.075,53,49,3,7,433.59,3,28,26,1.104,0,0,0,2,0,0.057,46.9
5.8,26,23,34.0,6,12.2,17,11,18,26.622,41.018,28.216,46.342,44,41,5,6,327.85,3,16,16,1.13,0,1,1,0,0,0.068,41.5
5.8,32,29,44.0,2,10.4,21,19,19,31.939,48.676,32.722,54.026,51,48,5,8,389.45,6,23,22,1.126,0,0,0,3,0,0.118,43.8
5.8,26,24,35.0,3,10.0,17,14,16,27.143,40.567,28.523,44.997,42,40,4,7,363.27,5,17,16,1.125,0,2,2,1,0,0.119,42.5
5.8,34,31,45.0,5,9.8,22,17,20,33.713,52.327,34.148,58.457,54,51,5,9,427.47,6,22,22,1.146,0,0,3,1,3,0.111,43.1
5.8,27,25,37.0,3,4.4,21,18,20,29.214,44.811,30.773,50.152,47,45,2,4,332.43,6,19,18,1.114,0,0,0,2,0,0.128,46.7
5.8,34,31,46.0,1,11.4,20,19,13,31.703,46.265,31.449,50.471,47,44,5,11,447.45,3,23,22,1.147,0,0,4,1,4,0.064,45.5
5.8,16,15,22.0,0,9.5,9,9,6,16.378,21.811,17.608,23.157,22,21,2,6,305.59,1,11,10,1.103,0,1,2,1,0,0.045,42.9
4.699,26,24,34.0,6,11.4,17,11,20,27.864,44.229,29.432,49.967,46,44,5,7,345.87,6,16,16,1.136,0,1,1,1,0,0.13,38.6
5.8,32,29,44.0,3,6.8,20,16,15,30.986,45.32,31.506,48.953,47,44,3,9,409.45,5,16,10,1.113,1,0,0,5,0,0.106,45.5
5.8,20,18,29.0,0,7.1,14,14,10,20.052,28.142,21.159,30.787,30,28,2,4,254.33,2,17,16,1.1,0,0,0,1,0,0.067,50.0
6.4,29,26,41.0,1,14.3,19,18,16,28.477,42.356,29.296,47.275,45,42,6,7,344.41,5,23,22,1.126,0,0,0,1,0,0.111,45.2
5.8,19,17,26.0,1,6.9,14,13,12,19.392,28.949,20.273,32.282,31,29,2,3,224.28,0,13,12,1.113,0,0,0,1,0,0.0,48.3
5.8,28,26,39.5,1,13.9,17,15,10,26.079,37.909,25.341,41.381,38,36,5,9,357.32,2,19,17,1.149,1,0,3,1,3,0.053,47.2
8.801,47,41,61.5,8,5.5,34,26,32,47.605,72.76,50.046,81.434,79,73,4,7,544.7,9,29,29,1.116,0,0,0,3,0,0.114,46.6
5.8,25,23,31.5,6,10.0,15,9,17,25.745,40.898,26.574,45.472,42,40,4,8,336.81,3,12,11,1.137,0,1,1,3,0,0.071,37.5
5.8,25,23,35.0,0,14.7,14,14,11,24.019,35.218,24.324,38.285,36,34,5,9,329.37,3,18,16,1.126,0,0,0,3,0,0.083,41.2
5.8,23,21,32.0,0,7.1,14,14,7,21.844,29.396,22.387,31.308,30,28,2,7,369.2,2,17,16,1.118,0,0,3,1,2,0.067,50.0
5.8,34,30,48.5,1,12.5,23,22,18,33.004,48.24,34.057,53.69,52,48,6,7,394.47,5,28,27,1.119,0,0,0,1,0,0.096,47.9
5.8,22,20,30.0,3,11.1,15,12,16,22.961,36.036,24.046,40.694,38,36,4,5,268.35,5,16,16,1.13,0,0,0,1,0,0.132,41.7
5.8,25,23,36.0,2,5.4,16,14,14,25.722,37.64,27.239,40.956,39,37,2,7,346.46,4,19,16,1.107,0,0,0,3,0,0.103,43.2
5.8,17,16,22.0,4,13.3,10,6,14,18.622,30.229,19.932,34.199,31,30,4,6,238.35,5,10,10,1.14,0,0,0,1,0,0.161,33.3
5.8,31,28,42.0,5,7.7,23,18,24,33.068,51.571,35.091,58.355,55,52,4,5,372.51,7,22,22,1.122,0,0,0,1,0,0.127,44.2
5.8,31,28,43.0,2,10.6,21,19,19,31.697,47.098,33.461,52.527,50,47,5,7,389.52,3,23,22,1.118,0,0,0,1,0,0.06,44.7
5.8,26,24,37.0,2,7.9,18,15,14,26.68,38.491,27.847,42.247,40,38,3,6,384.25,3,18,16,1.112,1,0,1,2,0,0.075,47.4
5.8,25,23,34.0,1,5.4,17,16,14,25.535,37.564,26.591,41.036,39,37,2,6,326.4,3,15,12,1.109,0,0,0,3,0,0.077,45.9
5.8,36,31,48.0,3,13.3,21,18,14,31.959,46.709,31.625,51.164,50,45,6,10,420.41,2,23,22,1.137,0,0,2,2,2,0.04,46.7
5.8,36,33,50.0,2,9.3,23,21,21,36.368,54.963,37.585,60.571,57,54,5,10,463.56,7,23,18,1.122,0,0,0,4,0,0.123,42.6
5.8,20,18,29.0,1,6.7,15,14,12,20.392,29.949,21.273,33.282,32,30,2,3,236.29,2,17,16,1.109,0,0,0,1,0,0.063,50.0
5.8,54,52,73.0,4,19.6,32,28,40,57.61,93.207,59.387,105.955,94,92,18,20,708.9,12,28,18,1.152,0,0,0,2,0,0.128,34.8
5.8,33,30,45.0,1,7.0,21,20,13,31.187,44.945,31.199,48.89,46,43,3,9,431.44,3,23,22,1.137,0,0,4,1,4,0.065,48.8
5.9,40,36,54.0,2,5.2,28,26,22,39.575,58.963,40.387,64.824,62,58,3,8,483.53,5,26,24,1.118,0,0,1,4,1,0.081,48.3
5.8,28,26,37.0,6,11.4,18,11,18,29.052,44.673,30.125,49.761,46,44,5,8,371.86,4,14,12,1.131,1,1,1,2,0,0.087,40.9
5.8,32,30,42.0,2,13.6,18,16,14,30.696,46.429,30.182,50.863,46,44,6,12,438.83,5,19,18,1.156,0,1,4,2,3,0.109,40.9
5.8,38,35,52.0,6,7.8,28,20,29,41.33,63.516,44.267,71.603,67,64,5,7,483.69,6,24,22,1.119,2,0,0,1,0,0.09,43.8
5.8,22,20,27.0,5,15.6,10,5,12,21.39,33.422,22.551,36.711,34,32,5,10,393.17,2,10,10,1.147,0,0,1,4,0,0.059,31.3
5.8,43,39,58.5,5,10.3,29,24,29,44.561,68.163,46.972,76.394,72,68,7,10,539.72,6,29,27,1.123,0,0,0,2,0,0.083,42.6
4.8,14,12,19.0,2,10.0,9,7,8,13.81,19.931,14.943,22.162,22,20,2,3,176.26,0,10,10,1.108,0,0,0,0,0,0.0,45.0
6.0,41,36,56.5,3,6.7,29,26,24,40.498,60.225,42.0,66.773,65,60,4,7,476.57,7,29,27,1.113,0,0,0,3,0,0.108,48.3
5.8,20,18,27.0,0,8.7,11,11,5,18.925,24.007,20.091,24.927,25,23,2,7,341.22,0,10,6,1.084,0,0,1,2,0,0.0,47.8
5.8,57,50,75.0,7,6.1,39,32,32,55.303,83.283,56.625,92.367,89,82,5,11,675.76,8,35,34,1.126,0,0,3,3,3,0.09,47.6
5.8,38,34,49.5,9,11.5,25,15,27,38.847,61.203,40.563,69.059,65,61,7,9,457.59,6,19,17,1.132,1,0,0,2,0,0.092,41.0
5.8,28,26,37.0,2,5.9,16,14,8,25.405,36.985,24.307,39.655,36,34,2,10,390.33,2,17,16,1.166,0,0,6,1,6,0.056,47.1
5.8,20,18,28.0,1,13.8,13,12,11,19.576,29.454,20.006,32.994,31,29,4,5,242.28,1,16,16,1.138,0,0,1,0,1,0.032,44.8
5.8,26,23,37.0,1,13.2,18,17,15,25.741,37.927,26.836,42.568,41,38,5,5,301.38,4,22,22,1.12,0,0,0,0,0,0.098,47.4
5.8,22,21,32.5,1,15.6,14,11,11,22.117,32.814,22.222,36.156,33,32,5,7,281.3,3,14,11,1.13,2,0,0,2,0,0.091,43.8
5.8,38,33,48.0,12,6.3,27,13,30,39.836,62.298,43.023,70.52,68,63,4,6,458.68,6,17,16,1.119,2,0,0,1,0,0.088,42.9
5.8,20,18,27.5,1,10.3,13,12,11,19.601,29.494,19.972,32.575,31,29,3,5,241.27,2,13,11,1.123,0,0,0,2,0,0.065,44.8
5.8,20,18,27.5,2,6.3,15,13,14,20.918,31.833,22.034,35.697,34,32,2,3,238.31,1,13,11,1.116,0,0,0,1,0,0.029,46.9
5.8,30,27,41.0,4,8.2,22,18,22,31.542,48.687,33.33,54.939,52,49,4,5,358.48,6,22,22,1.121,0,0,0,1,0,0.115,44.9
5.8,23,21,29.0,8,9.3,16,8,22,25.542,42.687,27.33,48.939,45,43,4,5,286.42,3,11,10,1.138,0,0,0,1,0,0.067,37.2
5.8,26,24,36.0,0,6.1,16,16,9,25.776,34.324,26.949,36.243,35,33,2,8,399.69,3,18,16,1.098,0,3,3,2,0,0.086,48.5
5.8,18,17,24.0,1,3.8,11,10,9,18.175,27.022,18.517,28.917,27,26,1,6,251.28,2,9,6,1.112,0,0,0,4,0,0.074,42.3
5.8,18,16,25.0,0,12.0,12,12,9,17.359,25.284,17.756,27.95,27,25,3,4,211.24,1,13,12,1.118,0,0,0,1,0,0.037,48.0
5.8,21,19,27.5,4,9.1,14,10,14,21.767,33.258,22.898,37.14,35,33,3,5,275.76,3,12,11,1.125,0,1,1,1,0,0.086,42.4
5.8,23,21,30.5,4,5.7,15,11,14,23.063,35.814,23.398,39.325,37,35,2,6,286.31,3,13,11,1.124,0,0,0,4,0,0.081,42.9
5.8,35,31,49.5,1,12.5,23,22,17,33.387,48.752,33.995,54.03,52,48,6,8,412.46,5,28,27,1.126,0,0,1,1,1,0.096,47.9
6.2,35,31,49.5,3,10.2,21,18,18,33.982,50.014,35.5,54.996,53,49,5,10,455.58,4,27,25,1.122,0,0,1,2,1,0.075,42.9
6.1,27,25,36.0,3,7.1,18,15,17,27.611,42.8,28.165,47.239,44,42,3,7,339.38,5,15,12,1.125,0,0,0,4,0,0.114,42.9
5.8,26,24,35.5,1,14.7,15,14,10,24.079,35.909,23.341,39.381,36,34,5,9,333.3,2,18,17,1.158,0,0,3,1,3,0.056,44.1
5.8,32,29,43.0,4,5.8,24,20,23,33.762,51.796,35.54,58.066,55,52,3,5,385.5,3,20,18,1.117,0,0,0,2,0,0.055,46.2
5.8,27,26,38.0,3,11.6,16,12,17,28.314,44.196,29.063,48.74,44,43,5,10,375.45,6,16,12,1.133,1,0,0,4,0,0.136,37.2
6.3,34,30,46.5,4,10.2,22,18,19,33.275,49.68,34.642,55.413,53,49,5,8,423.53,4,25,25,1.131,0,0,2,0,2,0.075,44.9
5.8,34,31,46.5,1,10.6,22,21,16,32.659,48.56,32.625,53.626,50,47,5,9,423.43,3,24,23,1.141,0,0,3,1,3,0.06,46.8
5.8,25,23,33.5,5,10.0,17,11,17,25.871,40.432,26.745,45.449,42,40,4,6,312.38,2,13,11,1.136,1,0,1,1,1,0.048,42.5
5.8,42,39,56.0,7,8.2,30,23,34,46.12,72.712,49.25,82.141,76,73,6,9,542.77,10,25,22,1.125,0,0,0,2,0,0.132,41.1
5.8,24,22,32.5,3,7.9,17,14,16,24.85,38.331,25.739,42.95,40,38,3,5,297.36,5,17,17,1.13,0,0,1,1,1,0.125,44.7
5.8,27,25,37.0,3,6.8,20,17,19,28.708,44.029,30.017,49.235,46,44,3,5,333.42,5,19,18,1.119,0,0,0,2,0,0.109,45.5
5.8,23,21,33.0,1,11.4,14,13,14,23.336,35.556,24.387,39.408,37,35,4,7,302.39,3,18,16,1.126,0,0,0,2,0,0.081,40.0
5.8,28,26,38.0,3,4.4,21,18,19,29.597,45.323,30.711,50.492,47,45,2,5,350.42,5,19,18,1.122,0,0,1,2,1,0.106,46.7
5.8,38,34,52.5,4,10.3,26,22,24,38.299,58.218,39.796,65.145,62,58,6,8,452.56,7,28,27,1.123,0,0,0,2,0,0.113,44.8
5.8,41,37,49.0,16,8.0,28,12,38,44.702,74.73,47.58,85.261,79,75,6,9,506.72,7,14,12,1.137,0,0,0,3,0,0.089,37.3
5.8,27,24,35.5,7,6.7,19,12,21,28.707,44.662,30.972,50.361,48,45,3,5,339.5,4,16,15,1.119,0,0,0,1,0,0.083,42.2
5.8,21,19,28.0,4,6.1,14,10,14,21.348,33.487,21.943,37.116,35,33,2,5,258.3,3,12,10,1.125,0,0,0,3,0,0.086,42.4
5.8,36,33,48.0,5,7.5,23,18,20,36.341,54.316,37.409,59.456,56,53,4,10,487.37,7,20,16,1.122,0,2,2,4,0,0.125,43.4
5.9,35,32,48.0,2,9.6,23,21,20,35.321,52.822,36.614,58.492,55,52,5,9,449.55,4,24,22,1.125,0,0,1,2,1,0.073,44.2
5.8,34,31,45.0,6,11.1,22,16,23,34.682,54.731,35.733,61.485,57,54,6,9,422.51,7,22,22,1.139,0,0,1,2,1,0.123,40.7
5.8,30,27,42.0,1,11.4,20,19,17,29.697,44.465,30.506,49.402,47,44,5,7,359.42,3,23,22,1.123,0,0,0,2,0,0.064,45.5
5.8,38,34,49.0,7,8.3,25,18,26,38.874,60.534,40.625,67.631,64,60,5,9,480.01,6,19,16,1.127,0,1,1,3,0,0.094,41.7
5.8,24,23,31.0,7,6.8,17,10,21,26.95,44.24,28.233,49.86,45,44,3,6,315.41,4,10,6,1.133,0,0,0,3,0,0.089,38.6
5.8,32,30,42.0,6,6.9,24,18,28,35.837,57.665,38.069,65.394,60,58,4,6,404.56,9,19,18,1.127,0,0,0,2,0,0.15,41.4
5.8,32,29,41.0,8,12.5,21,13,27,34.133,55.876,36.108,63.85,59,56,7,8,393.55,7,17,16,1.14,0,0,0,1,0,0.119,37.5
5.8,25,23,35.5,2,10.3,16,14,16,25.863,39.44,27.148,43.823,41,39,4,7,328.43,3,19,17,1.124,0,0,0,2,0,0.073,41.0
6.5,28,25,38.0,1,9.8,19,18,16,27.676,41.363,28.5,45.903,44,41,4,6,332.39,3,19,18,1.12,0,0,0,2,0,0.068,46.3
5.8,26,23,34.0,6,12.2,17,11,18,26.622,41.018,28.216,46.342,44,41,5,6,327.85,3,16,16,1.13,0,1,1,0,0,0.068,41.5
5.8,22,20,28.0,4,0.0,14,10,9,20.455,30.822,19.744,33.139,31,29,0,6,282.23,0,9,6,1.143,0,0,3,3,3,0.0,48.3
5.8,19,18,27.5,1,14.3,12,10,10,19.568,28.462,20.409,31.368,29,28,4,6,258.33,2,13,11,1.12,1,0,0,1,0,0.069,42.9
5.8,26,25,35.0,3,9.5,15,12,17,27.647,43.302,28.676,47.601,43,42,4,10,384.88,6,15,12,1.133,0,1,1,4,0,0.14,35.7
8.4,50,44,68.5,3,10.4,32,29,23,47.274,68.421,48.324,75.243,73,67,7,12,607.69,7,35,33,1.123,0,0,2,2,2,0.096,47.8
6.0,30,27,42.0,2,9.1,20,18,17,30.058,44.509,31.392,49.369,47,44,4,7,380.48,3,22,20,1.122,0,0,1,1,1,0.064,45.5
5.8,25,23,36.0,1,6.1,17,15,10,25.234,33.673,26.636,36.09,35,33,2,6,361.26,2,18,16,1.094,1,2,2,1,0,0.057,51.5
5.8,19,17,27.0,1,7.4,13,12,10,19.052,27.142,20.159,29.787,29,27,2,4,242.32,1,16,16,1.103,0,0,0,1,0,0.034,48.1
5.8,30,27,42.0,1,6.8,21,20,17,29.896,44.473,30.71,49.03,47,44,3,6,359.41,4,23,22,1.114,0,0,0,3,0,0.085,47.7
5.8,31,28,43.5,6,10.2,23,14,21,32.321,48.578,34.12,54.813,52,49,5,5,367.49,4,19,17,1.119,3,0,0,0,0,0.077,46.9
5.8,25,23,33.5,4,4.9,18,14,18,26.402,41.254,27.466,45.946,43,41,2,5,310.38,4,14,11,1.121,0,0,0,3,0,0.093,43.9
5.8,41,36,52.0,12,7.0,30,18,35,43.724,70.09,46.904,79.929,76,71,5,6,481.7,6,22,22,1.126,0,0,0,1,0,0.079,42.3
5.8,29,27,39.0,5,3.9,23,18,24,32.267,50.578,34.296,56.983,53,51,2,4,360.49,7,19,18,1.117,0,0,0,2,0,0.132,45.1
5.8,27,23,36.0,4,10.8,17,13,14,25.622,37.229,26.932,41.199,41,37,4,6,322.42,1,17,16,1.113,0,0,0,1,0,0.024,45.9
6.678,31,29,39.0,9,10.7,20,11,27,35.142,55.803,39.171,63.407,58,56,6,9,526.5,10,16,16,1.132,0,0,1,1,0,0.172,35.7
5.0,27,26,33.0,9,0.0,19,10,24,30.325,50.894,31.318,56.448,51,50,0,7,364.43,1,9,6,1.129,0,0,0,7,0,0.02,38.0
4.585,31,28,42.0,3,4.3,21,18,18,30.831,46.909,31.375,51.365,49,46,2,7,378.41,5,19,16,1.117,0,0,0,5,0,0.102,45.7
6.444,28,26,38.0,4,12.2,17,11,15,28.87,41.796,31.296,46.172,43,41,5,9,483.34,6,17,16,1.126,2,0,2,1,1,0.14,41.5
5.097,26,24,34.0,6,11.4,17,11,20,28.061,44.134,29.927,49.864,46,44,5,7,390.32,6,16,16,1.133,0,0,1,1,0,0.13,38.6
7.0,29,27,37.0,7,12.0,18,11,23,32.088,50.036,35.648,56.577,52,50,6,9,498.44,8,16,16,1.132,0,0,1,1,0,0.154,36.0
8.721,25,23,36.5,0,11.8,17,15,11,24.933,34.498,25.875,37.705,36,34,4,6,367.22,3,19,17,1.109,2,0,1,1,0,0.083,50.0
6.333,36,34,47.5,9,7.9,26,15,29,39.881,63.16,42.177,71.382,65,63,5,8,482.05,10,19,17,1.133,2,1,2,1,1,0.154,41.3
7.367,28,26,39.5,1,10.5,18,15,12,27.36,39.316,27.534,42.772,40,38,4,8,370.79,3,19,17,1.126,2,1,2,2,1,0.075,47.4
6.495,36,34,47.5,9,9.7,25,14,28,39.376,62.378,41.421,70.465,64,62,6,9,483.04,10,19,17,1.137,2,1,2,1,1,0.156,40.3
7.699,30,28,41.5,4,11.1,20,14,17,30.72,45.858,31.608,50.891,47,45,5,8,397.87,5,19,17,1.131,2,1,2,1,1,0.106,44.4
6.58,32,30,43.5,5,12.0,21,14,20,33.268,50.843,34.375,56.805,52,50,6,9,426.92,6,19,17,1.136,2,1,2,1,1,0.115,42.0
7.622,34,31,45.5,5,12.2,21,14,18,33.456,50.287,34.068,55.599,52,49,6,10,440.9,4,19,17,1.135,2,1,2,2,1,0.077,42.9
6.643,34,31,45.5,5,10.0,22,15,19,33.962,51.069,34.824,56.516,53,50,5,9,439.91,4,19,17,1.13,2,1,2,2,1,0.075,44.0
6.013,42,39,56.5,7,8.8,29,21,29,44.422,68.52,46.392,76.544,71,68,6,10,545.09,11,25,23,1.126,1,1,1,3,0,0.155,42.6
6.009,46,42,60.5,10,8.0,32,21,33,48.475,75.287,50.915,84.375,79,75,6,10,585.16,11,25,23,1.125,1,1,1,3,0,0.139,42.7
7.65,37,34,50.5,2,13.0,23,21,20,36.809,55.203,37.591,60.967,57,54,7,11,477.95,9,25,23,1.129,0,1,1,3,0,0.158,42.6
9.097,36,33,47.5,7,12.5,23,14,23,36.817,56.829,38.142,63.718,59,56,7,10,467.98,5,19,17,1.138,2,1,2,1,1,0.085,41.1
7.62,27,25,38.5,1,13.9,17,14,11,26.14,37.207,26.324,40.645,38,36,5,8,355.78,3,19,17,1.129,2,1,2,1,1,0.079,47.2
6.77,29,27,40.5,3,11.9,19,14,15,29.193,42.974,29.847,47.476,44,42,5,8,383.84,4,19,17,1.13,2,1,2,1,1,0.091,45.2
8.301,35,32,46.5,6,11.5,22,14,20,34.983,53.171,35.83,59.014,55,52,6,10,454.93,5,19,17,1.135,2,1,2,2,1,0.091,42.3
8.379,35,32,46.5,6,9.4,23,15,21,35.489,53.952,36.585,59.931,56,53,5,9,453.94,5,19,17,1.131,2,1,2,2,1,0.089,43.4
7.328,35,32,48.5,2,6.1,24,20,17,34.634,50.193,35.267,54.728,52,49,3,8,449.89,6,24,23,1.117,2,1,2,3,1,0.115,49.0
7.886,36,33,50.0,2,7.8,25,21,18,35.94,51.967,36.818,57.017,54,51,4,8,460.92,6,25,24,1.118,2,1,2,2,1,0.111,49.0
7.041,35,32,49.0,1,8.0,25,22,18,35.226,50.64,36.364,55.808,53,50,4,7,444.92,5,25,24,1.116,2,1,2,1,1,0.094,50.0
9.228,35,32,46.5,6,11.5,22,14,20,35.181,53.076,36.324,58.912,55,52,6,10,499.38,5,19,17,1.133,2,0,2,2,1,0.091,42.3
8.638,37,34,49.0,6,8.3,25,19,26,38.874,60.534,40.625,67.631,63,60,5,9,480.01,8,23,22,1.127,0,1,1,3,0,0.127,41.7
8.886,35,31,47.0,3,10.2,22,19,18,33.767,50.0,34.58,54.97,53,49,5,9,435.9,6,23,22,1.122,0,1,1,3,0,0.113,44.9
7.745,35,31,47.0,3,10.2,22,19,18,33.767,50.0,34.58,54.97,53,49,5,9,435.9,6,23,22,1.122,0,1,1,3,0,0.113,44.9
7.553,35,31,47.0,3,10.2,22,19,18,33.767,50.0,34.58,54.97,53,49,5,9,435.9,6,23,22,1.122,0,1,1,3,0,0.113,44.9
6.886,35,31,47.0,3,10.2,22,19,18,33.767,50.0,34.58,54.97,53,49,5,9,435.9,6,23,22,1.122,0,1,1,3,0,0.113,44.9
6.824,35,31,47.0,3,10.2,22,19,18,33.767,50.0,34.58,54.97,53,49,5,9,435.9,6,23,22,1.122,0,1,1,3,0,0.113,44.9
8.602,35,31,47.0,3,10.2,22,19,18,33.767,50.0,34.58,54.97,53,49,5,9,435.9,6,23,22,1.122,0,1,1,3,0,0.113,44.9
8.824,35,31,47.0,3,10.2,22,19,18,33.767,50.0,34.58,54.97,53,49,5,9,435.9,6,23,22,1.122,0,1,1,3,0,0.113,44.9
8.796,35,31,47.0,3,10.2,22,19,18,33.767,50.0,34.58,54.97,53,49,5,9,435.9,6,23,22,1.122,0,1,1,3,0,0.113,44.9
8.602,34,30,47.0,2,10.4,22,20,18,33.052,48.673,34.125,53.761,52,48,5,8,419.9,6,26,26,1.12,0,1,1,2,0,0.115,45.8
8.222,34,30,47.0,2,8.5,22,20,17,33.217,47.647,34.767,52.182,51,47,4,8,436.95,6,26,26,1.11,0,1,1,2,0,0.118,46.8
8.77,34,30,47.0,2,12.8,21,19,17,32.546,47.891,33.37,52.844,51,47,6,9,420.89,6,26,26,1.124,0,1,1,2,0,0.118,44.7
8.678,35,31,48.0,3,12.0,22,19,19,34.073,50.774,35.131,56.259,54,50,6,9,434.92,6,26,26,1.125,0,1,1,2,0,0.111,44.0
8.678,34,30,47.0,2,10.9,21,19,16,32.712,46.865,34.012,51.266,50,46,5,9,437.94,6,26,26,1.114,0,1,1,2,0,0.12,45.7
8.796,37,33,51.0,3,11.5,23,20,19,36.26,52.851,37.779,58.179,56,52,6,10,479.0,7,27,26,1.119,0,1,1,2,0,0.125,44.2
8.658,40,36,54.0,5,10.2,25,20,23,40.029,59.945,41.756,66.219,63,59,6,11,523.06,8,27,26,1.122,0,1,1,3,0,0.127,42.4
8.481,41,37,55.0,6,9.7,26,20,25,41.555,62.829,43.517,69.634,66,62,6,11,537.09,9,27,26,1.123,0,1,1,3,0,0.136,41.9
8.699,43,39,59.0,6,9.4,26,20,25,43.457,65.233,45.619,71.763,68,64,6,13,585.16,9,29,26,1.121,0,1,1,4,0,0.132,40.6
8.215,40,36,54.0,6,9.8,26,20,25,40.841,61.502,43.063,68.425,65,61,6,10,521.09,8,27,26,1.122,0,1,1,2,0,0.123,42.6
9.036,42,37,56.0,6,11.5,26,20,24,41.335,61.72,43.307,68.508,66,61,7,11,534.09,8,27,26,1.123,0,1,1,2,0,0.121,42.6
9.009,40,36,54.0,5,11.7,25,20,24,40.335,60.72,42.307,67.508,64,60,7,11,522.08,8,27,26,1.125,0,1,1,2,0,0.125,41.7
7.26,34,31,48.0,1,8.5,24,21,16,33.699,47.756,34.603,52.393,50,47,4,7,430.89,5,25,24,1.115,2,1,2,1,1,0.1,51.1
6.796,35,32,48.5,2,8.3,23,19,16,34.601,49.16,35.705,53.522,51,48,4,9,466.95,6,24,23,1.115,2,1,2,2,1,0.118,47.9
8.689,35,32,46.5,7,11.1,23,14,22,35.795,54.727,37.137,61.22,57,54,6,9,452.96,5,19,17,1.134,2,1,2,1,1,0.088,42.6
7.357,35,32,49.0,1,8.0,25,22,18,35.226,50.64,36.364,55.808,53,50,4,7,444.92,5,25,24,1.116,2,1,2,1,1,0.094,50.0
7.18,33,30,46.5,1,11.1,22,19,15,32.193,45.974,32.847,50.476,48,45,5,8,419.87,5,24,23,1.122,2,1,2,1,1,0.104,48.9
4.64,25,23,34.0,1,8.3,17,16,13,25.151,36.771,25.835,40.479,38,36,3,6,329.78,5,18,18,1.124,0,1,2,1,1,0.132,47.2
7.229,38,35,53.0,2,9.3,26,22,19,37.962,55.069,38.824,60.516,57,54,5,9,487.95,6,26,24,1.121,2,1,2,2,1,0.105,48.1
7.886,38,35,53.0,2,7.3,27,23,20,38.467,55.851,39.58,61.433,58,55,4,8,486.96,6,26,24,1.117,2,1,2,2,1,0.103,49.1
5.42,27,25,38.0,1,7.9,19,16,13,27.151,38.771,27.835,42.479,40,38,3,6,353.8,5,19,18,1.118,2,1,2,1,1,0.125,50.0
7.444,35,32,49.0,1,8.0,25,22,18,35.226,50.64,36.364,55.808,53,50,4,7,444.92,5,25,24,1.116,2,1,2,1,1,0.094,50.0
7.42,36,33,50.0,2,9.6,25,21,19,36.247,52.742,37.37,58.306,55,52,5,8,459.94,6,25,24,1.121,2,1,2,1,1,0.109,48.1
8.046,45,42,62.0,5,8.8,29,22,26,46.18,69.552,47.671,76.598,71,68,6,13,609.13,10,28,24,1.126,2,1,2,4,1,0.141,42.6
7.538,44,41,60.0,5,6.0,31,24,26,45.477,68.156,46.773,75.097,70,67,4,10,573.06,11,27,24,1.121,2,1,2,4,1,0.157,46.3
5.752,27,25,36.5,2,12.5,17,15,15,27.835,40.691,29.262,44.978,42,40,5,8,420.72,4,18,17,1.124,0,1,2,1,0,0.095,42.5
5.187,33,29,44.5,2,8.7,22,20,17,32.03,46.571,33.12,51.262,50,46,4,7,404.88,5,23,23,1.114,0,1,1,2,0,0.1,47.8
5.319,35,31,46.5,4,7.7,24,20,21,35.282,52.243,37.137,57.99,56,52,4,7,477.39,5,23,23,1.115,0,0,1,2,0,0.089,46.2
5.0,36,32,47.5,5,7.3,25,20,23,36.611,55.222,38.404,61.508,59,55,4,7,446.97,5,23,23,1.118,0,1,1,2,0,0.085,45.5
5.0,35,32,44.5,7,9.3,22,15,22,35.843,55.16,37.205,61.29,57,54,5,10,478.39,5,18,17,1.135,0,2,3,2,1,0.088,40.7
5.524,32,29,44.5,3,7.5,25,22,24,34.354,52.243,36.637,59.145,56,53,4,4,380.53,6,24,23,1.116,0,0,0,0,0,0.107,47.2
7.284,39,36,54.0,3,6.9,28,23,22,39.994,58.734,41.341,64.848,61,58,4,8,500.99,7,26,24,1.118,2,1,2,2,1,0.115,48.3
5.8,23,21,29.5,2,10.7,12,10,7,20.578,30.356,19.642,32.538,30,28,3,9,317.67,0,12,11,1.162,0,1,4,2,3,0.0,42.9
7.495,38,35,53.0,2,7.3,27,23,20,38.467,55.851,39.58,61.433,58,55,4,8,486.96,6,26,24,1.117,2,1,2,2,1,0.103,49.1
7.222,34,31,48.0,1,10.9,23,20,15,33.193,46.974,33.847,51.476,49,46,5,8,431.88,5,25,24,1.119,2,1,2,1,1,0.102,50.0
5.8,24,23,34.0,1,15.2,14,12,10,23.659,34.465,23.534,37.309,34,33,5,9,331.74,4,15,12,1.131,1,1,1,3,0,0.118,42.4
4.638,28,26,37.5,3,11.6,18,15,17,29.164,43.669,30.529,48.495,45,43,5,8,390.3,4,18,17,1.128,0,2,2,1,0,0.089,41.9
5.678,27,25,36.5,3,11.6,18,15,18,28.337,43.345,29.671,48.551,45,43,5,7,355.86,4,18,17,1.129,0,1,1,1,0,0.089,41.9
7.347,39,36,55.0,2,7.1,26,22,20,39.369,57.254,40.682,62.562,59,56,4,10,523.02,7,27,24,1.117,2,1,2,3,1,0.119,46.4
4.215,29,26,37.0,6,4.2,21,15,22,30.455,48.022,31.989,53.777,51,48,2,5,350.45,1,14,12,1.12,0,0,0,3,0,0.02,43.8
5.684,22,20,30.5,2,11.1,16,14,16,23.246,35.709,24.591,40.484,38,36,4,4,264.36,3,17,17,1.125,0,0,0,0,0,0.079,44.4
5.854,16,16,22.0,3,14.3,10,6,12,17.622,28.596,17.977,32.073,28,28,4,6,220.26,3,8,6,1.145,1,0,0,2,0,0.107,35.7
4.928,28,26,37.5,4,10.9,19,15,20,29.864,46.229,31.432,51.967,48,46,5,7,369.89,4,18,17,1.13,0,1,1,1,0,0.083,41.3
6.051,22,20,30.5,1,12.1,15,14,13,22.547,33.149,23.688,37.013,35,33,4,5,284.77,3,17,17,1.122,0,1,1,0,0,0.086,45.5
4.509,19,18,27.0,0,3.6,12,12,10,19.814,28.902,20.682,31.067,29,28,1,6,283.75,3,14,12,1.11,0,1,1,3,0,0.103,42.9
5.8,23,22,32.0,3,13.5,15,11,15,24.171,37.582,24.745,41.986,38,37,5,7,297.35,5,14,12,1.135,1,0,0,2,0,0.132,40.5
5.162,30,28,40.5,4,12.8,19,15,19,31.073,47.774,32.131,53.259,49,47,6,9,398.89,5,19,17,1.133,0,1,1,2,0,0.102,40.4
5.854,20,19,29.0,1,12.9,14,12,12,20.908,31.269,21.523,34.863,32,31,4,5,252.3,2,14,12,1.125,1,0,0,1,0,0.063,45.2
6.167,30,28,40.5,3,13.6,18,15,16,30.374,45.214,31.227,49.788,46,44,6,10,419.3,5,19,17,1.132,0,2,2,2,0,0.109,40.9
5.87,27,25,36.5,2,12.5,17,15,15,27.638,40.785,28.767,45.08,42,40,5,8,376.27,4,18,17,1.127,0,2,2,1,0,0.095,42.5
4.914,29,27,39.5,3,13.6,18,15,17,29.546,44.891,30.37,49.844,46,44,6,9,384.86,5,19,17,1.133,0,1,1,2,0,0.109,40.9
7.337,36,33,46.5,7,8.6,24,17,25,37.542,58.72,39.108,65.761,61,58,5,9,469.99,7,19,17,1.134,0,1,2,2,1,0.115,41.4
5.827,27,26,36.0,5,8.7,18,12,20,29.159,46.785,29.932,52.152,47,46,4,8,356.42,7,14,12,1.134,1,0,0,4,0,0.149,39.1
4.745,23,21,30.0,3,5.4,16,13,16,23.875,37.371,24.705,41.531,39,37,2,5,284.34,3,13,12,1.122,0,0,0,3,0,0.077,43.2
5.268,29,27,39.5,2,14.6,17,15,14,28.847,42.331,29.466,46.373,43,41,6,10,405.27,5,19,17,1.131,0,2,2,2,0,0.116,41.5
5.939,29,27,39.5,2,14.6,17,15,14,29.045,42.236,29.96,46.27,43,41,6,10,449.72,5,19,17,1.129,0,1,2,2,0,0.116,41.5
5.8,27,25,38.0,3,9.8,17,14,16,27.106,42.018,27.409,46.322,43,41,4,8,340.37,6,19,16,1.13,0,0,0,4,0,0.14,41.5
5.514,30,28,40.5,3,13.6,18,15,16,30.572,45.12,31.722,49.685,46,44,6,10,463.75,5,19,17,1.129,0,1,2,2,0,0.109,40.9
5.827,30,29,39.0,6,5.9,18,12,22,32.636,52.505,33.864,57.767,52,51,3,11,443.95,8,15,12,1.133,0,1,1,6,0,0.154,35.3
5.827,31,30,42.0,6,7.7,19,12,22,33.303,53.4,34.25,58.906,53,52,4,11,434.52,8,16,12,1.133,1,0,0,6,0,0.151,36.5
5.534,35,32,45.5,7,8.6,24,17,26,37.357,58.112,39.665,65.319,61,58,5,8,496.45,8,19,17,1.126,0,0,1,2,0,0.131,41.4
5.719,35,32,45.5,7,8.6,24,17,26,37.357,58.112,39.665,65.319,61,58,5,8,496.45,8,19,17,1.126,0,0,1,2,0,0.131,41.4
6.015,54,51,69.5,11,6.5,36,24,41,58.157,93.458,60.233,104.083,95,92,6,15,721.28,18,26,23,1.131,1,1,1,8,0,0.189,39.1
4.0,35,33,47.0,4,7.3,22,18,22,36.166,56.654,36.977,62.582,57,55,4,11,476.55,9,21,18,1.138,0,0,2,4,2,0.158,40.0
5.8,30,27,42.0,1,14.0,19,18,16,29.192,43.683,29.75,48.485,46,43,6,8,360.41,3,23,22,1.128,0,0,0,2,0,0.065,44.2
7.42,51,46,70.0,6,5.1,36,30,33,52.861,79.371,55.767,87.923,84,79,4,10,653.25,14,36,34,1.113,0,1,1,4,0,0.167,45.6
7.553,50,45,69.0,4,4.2,34,30,27,49.884,73.342,51.631,80.143,77,72,3,11,644.16,12,36,34,1.113,0,1,2,5,1,0.156,47.2
7.699,47,43,63.0,8,5.3,32,24,32,49.245,75.883,51.705,84.263,79,75,4,11,623.2,13,30,28,1.124,0,1,2,4,1,0.165,42.7
7.745,45,40,60.0,6,6.1,30,24,26,44.949,66.905,46.966,73.808,71,66,4,10,577.12,8,29,28,1.118,0,1,2,3,1,0.113,45.5
7.638,44,39,59.0,6,6.1,30,24,27,44.566,66.392,47.029,73.468,71,66,4,9,559.13,8,29,28,1.113,0,1,1,3,0,0.113,45.5
7.585,42,38,58.0,5,6.1,29,24,28,43.453,66.396,45.625,73.733,70,66,4,9,528.68,11,30,28,1.117,0,0,0,4,0,0.157,43.9
5.8,33,30,45.0,1,14.0,19,18,13,30.342,45.222,29.563,49.504,46,43,6,11,414.38,3,23,22,1.151,0,0,3,2,3,0.065,44.2
7.509,43,39,59.0,5,6.1,29,24,27,43.837,66.909,45.563,74.073,70,66,4,10,546.67,11,30,28,1.122,0,0,1,4,1,0.157,43.9
7.523,53,48,72.0,5,6.7,34,29,27,51.535,77.432,52.142,85.006,80,75,5,14,677.73,12,36,34,1.133,0,0,4,4,4,0.15,45.3
6.444,46,42,62.0,6,5.8,30,24,27,46.13,70.818,47.199,78.168,73,69,4,12,596.68,11,30,28,1.133,0,0,3,4,3,0.151,43.5
7.62,46,42,62.0,7,5.6,31,24,30,47.718,73.0,49.943,80.847,76,72,4,11,609.17,12,30,28,1.123,0,1,2,4,1,0.158,43.1
7.602,43,39,59.0,5,6.1,29,24,27,44.479,66.625,46.978,73.575,70,66,4,10,607.57,11,30,28,1.115,0,0,1,4,0,0.157,43.9
8.201,41,38,55.0,5,8.5,24,19,21,40.399,61.592,40.779,67.364,62,59,5,14,568.02,9,25,22,1.142,0,1,4,4,3,0.145,40.7
8.071,42,39,56.0,6,8.1,25,19,23,41.925,64.476,42.54,70.779,65,62,5,14,582.05,10,25,22,1.142,0,1,4,4,3,0.154,40.3
7.959,43,40,57.0,7,7.7,26,19,25,43.452,67.36,44.301,74.195,68,65,5,14,596.08,10,25,22,1.141,0,1,4,4,3,0.147,40.0
7.854,44,41,58.0,8,7.4,27,19,27,44.979,70.243,46.063,77.61,71,68,5,14,610.11,10,25,22,1.141,0,1,4,4,3,0.141,39.7
8.149,42,39,56.0,6,8.1,25,19,23,41.925,64.476,42.54,70.779,65,62,5,14,582.05,9,25,22,1.142,0,1,4,4,3,0.138,40.3
7.77,43,40,57.0,7,7.7,26,19,25,43.452,67.36,44.301,74.195,68,65,5,14,596.08,9,25,22,1.141,0,1,4,4,3,0.132,40.0
8.538,38,35,52.0,4,8.9,23,19,21,38.549,57.494,40.063,62.874,59,56,5,12,534.46,9,25,22,1.123,0,2,2,4,0,0.153,41.1
8.387,39,36,53.0,5,8.5,24,19,23,40.076,60.378,41.824,66.289,62,59,5,12,548.49,9,25,22,1.124,0,2,2,4,0,0.145,40.7
7.959,40,37,54.0,6,8.1,25,19,25,41.603,63.262,43.585,69.704,65,62,5,12,562.52,9,25,22,1.124,0,2,2,4,0,0.138,40.3
7.959,40,37,54.0,6,8.1,25,19,25,41.603,63.262,43.585,69.704,65,62,5,12,562.52,9,25,22,1.124,0,2,2,4,0,0.138,40.3
7.046,45,41,61.0,6,5.7,30,24,29,46.078,71.12,47.779,78.698,74,70,4,11,576.7,12,30,28,1.124,0,0,1,5,1,0.162,42.9
5.584,40,37,52.0,8,10.4,26,18,30,41.999,67.81,43.478,76.438,70,67,7,11,507.63,13,23,22,1.141,0,0,1,3,1,0.186,38.8
7.77,44,40,60.0,5,4.6,29,24,25,44.358,66.458,45.869,72.728,69,65,3,11,582.09,11,30,28,1.119,0,1,2,5,1,0.159,44.6
7.456,44,39,59.0,6,6.1,30,24,27,44.122,66.581,46.108,73.864,71,66,4,9,542.68,8,29,28,1.119,0,0,1,3,1,0.113,45.5
6.658,47,43,63.0,6,5.8,30,24,26,46.513,71.33,47.137,78.507,73,69,4,13,614.67,11,30,28,1.138,0,0,4,4,4,0.151,43.5
4.602,33,30,44.0,3,4.2,23,20,18,33.583,48.785,34.943,53.25,51,48,2,7,441.33,4,20,18,1.109,0,2,2,3,0,0.078,47.9
7.222,40,35,51.0,10,11.9,27,17,32,41.493,66.418,44.182,75.969,72,67,8,8,468.67,6,22,22,1.134,0,0,0,0,0,0.083,40.3
6.0,30,27,36.0,11,5.6,21,10,27,32.53,53.891,34.517,61.106,57,54,3,6,369.51,3,9,6,1.132,0,0,0,3,0,0.053,38.9
6.854,29,26,34.0,12,5.7,20,8,27,31.53,52.891,33.517,60.106,56,53,3,6,357.5,3,8,6,1.134,0,0,0,3,0,0.054,37.7
6.796,30,27,36.0,11,5.6,21,10,27,32.53,53.891,34.517,61.106,57,54,3,6,369.51,3,9,6,1.132,0,0,0,3,0,0.053,38.9
5.8,29,26,41.0,0,11.6,20,20,17,28.983,43.138,30.051,48.192,46,43,5,6,343.42,3,23,22,1.121,0,0,0,1,0,0.065,46.5
5.8,30,27,42.0,1,10.9,21,20,19,30.509,46.022,31.813,51.607,49,46,5,6,357.45,3,23,22,1.122,0,0,0,1,0,0.061,45.7
5.8,47,42,61.5,8,11.1,29,21,30,46.54,73.171,47.693,81.601,77,72,8,13,570.67,10,28,27,1.133,0,0,0,5,0,0.13,40.3
5.921,44,40,59.0,7,9.4,28,20,24,43.939,65.342,45.455,71.974,68,64,6,12,579.1,8,25,22,1.125,1,1,2,3,1,0.118,43.8
4.398,21,19,30.0,0,3.8,12,12,7,20.341,27.185,21.546,28.599,28,26,1,7,360.24,1,15,12,1.1,0,0,2,2,1,0.036,46.2
4.398,24,22,33.0,1,3.4,13,12,7,22.634,31.094,23.182,32.694,31,29,1,9,410.25,1,15,12,1.127,0,0,4,2,3,0.032,44.8
5.523,22,20,33.0,0,7.4,13,12,7,21.452,27.891,22.852,29.343,29,27,2,7,367.26,1,16,12,1.087,1,0,1,2,0,0.034,48.1
4.398,25,23,36.0,1,5.9,13,12,11,25.123,35.389,26.932,37.512,36,34,2,10,435.37,3,17,12,1.103,0,0,1,4,0,0.083,38.2
4.398,31,28,45.0,0,4.9,18,18,13,30.649,42.273,32.693,44.927,44,41,2,10,497.44,4,23,18,1.096,0,0,1,4,0,0.091,43.9
6.229,20,18,29.0,0,8.0,11,11,7,19.452,25.891,20.852,27.343,27,25,2,7,343.24,1,15,12,1.094,0,0,1,2,0,0.037,44.0
5.854,34,31,46.0,4,11.3,23,19,22,34.772,53.334,36.034,59.73,56,53,6,8,414.51,5,21,18,1.127,0,0,0,2,0,0.089,43.4
6.796,33,30,40.0,12,8.8,20,8,27,34.476,57.865,35.676,65.106,60,57,5,10,417.52,4,10,6,1.142,0,0,0,5,0,0.067,35.1
6.252,25,23,30.0,9,6.5,17,8,23,27.477,46.123,28.995,52.275,48,46,3,6,317.43,3,8,6,1.136,0,0,0,3,0,0.063,37.0
7.036,28,25,33.0,11,6.0,19,8,25,30.003,50.007,31.756,56.69,53,50,3,6,343.47,3,8,6,1.134,0,0,0,3,0,0.057,38.0
5.681,31,30,37.0,15,1.4,27,12,42,40.25,70.37,44.523,81.429,73,72,1,3,412.7,12,12,12,1.131,0,0,0,2,0,0.164,37.5
7.284,29,26,34.0,11,7.7,19,8,26,31.025,52.109,32.762,59.189,55,52,4,7,358.49,3,8,6,1.138,0,0,0,3,0,0.055,36.5
5.0,25,23,33.0,8,14.0,16,7,20,26.531,43.123,27.819,49.106,45,43,6,7,312.42,3,12,10,1.142,1,0,0,1,0,0.067,37.2
5.8,34,32,43.0,8,9.3,20,11,22,34.964,55.749,35.466,61.429,56,54,5,12,463.92,4,14,12,1.138,1,1,1,6,0,0.071,37.0
5.4,31,28,43.0,1,10.9,21,20,18,30.893,46.534,31.75,51.947,49,46,5,7,375.44,3,23,22,1.129,0,0,1,1,1,0.061,45.7
5.4,32,30,41.0,8,9.6,20,11,22,33.535,53.094,34.557,59.01,54,52,5,10,431.92,3,14,12,1.135,1,1,1,4,0,0.056,38.5
5.4,33,31,44.0,6,12.0,18,11,19,33.405,51.833,34.142,56.807,52,50,6,13,466.95,2,16,12,1.136,1,1,1,5,0,0.038,36.0
5.8,18,16,24.5,2,11.1,12,10,11,17.886,27.167,18.517,30.365,29,27,3,4,213.26,1,12,11,1.125,0,0,0,1,0,0.034,44.4
5.8,30,26,42.0,2,9.5,21,19,16,28.961,42.036,30.046,46.694,46,42,4,5,340.41,2,23,22,1.112,0,0,0,1,0,0.043,50.0
5.8,26,23,35.5,2,8.1,18,16,14,25.323,37.447,25.978,41.535,40,37,3,5,307.35,2,18,17,1.123,0,0,1,1,1,0.05,48.6
6.431,45,42,54.5,17,4.7,32,15,44,50.91,86.043,53.978,97.554,89,86,4,10,580.8,14,18,17,1.134,0,0,0,6,0,0.157,37.2
7.448,41,37,50.5,14,5.5,29,15,36,44.374,72.854,47.023,82.474,77,73,4,8,504.69,9,18,17,1.13,0,0,0,4,0,0.117,39.7
7.613,43,38,52.5,15,8.1,29,14,36,45.175,73.847,47.819,83.846,79,74,6,9,516.71,6,18,17,1.133,0,0,0,3,0,0.076,39.2
5.0,47,43,65.5,4,6.9,34,28,29,48.288,72.421,49.983,80.312,76,72,5,9,571.68,9,32,29,1.115,2,0,0,4,0,0.118,47.2
6.854,47,43,65.5,4,6.9,34,28,29,48.288,72.421,49.983,80.312,76,72,5,9,571.68,9,32,29,1.115,2,0,0,4,0,0.118,47.2
7.705,38,35,50.5,7,9.2,27,20,30,40.88,64.869,43.08,73.391,68,65,6,8,470.63,8,24,23,1.129,0,0,0,2,0,0.118,41.5
7.319,39,36,51.5,8,8.8,28,20,32,42.406,67.752,44.841,76.806,71,68,6,8,484.66,8,24,23,1.13,0,0,0,2,0,0.113,41.2
7.444,42,38,54.5,10,8.3,30,20,34,44.933,71.636,47.603,81.221,76,72,6,8,510.7,8,24,23,1.128,0,0,0,2,0,0.105,41.7
6.886,44,40,56.5,11,9.1,31,20,37,47.481,76.621,50.37,87.135,81,77,7,9,539.75,8,24,23,1.132,0,0,0,2,0,0.099,40.3
6.854,45,42,60.5,9,6.5,33,22,35,48.868,77.072,51.267,86.557,80,77,5,9,565.73,10,26,23,1.124,2,0,0,4,0,0.125,42.9
6.357,29,26,40.5,0,15.0,18,18,14,27.665,40.8,27.989,45.069,43,40,6,8,346.38,2,23,23,1.127,0,0,0,2,0,0.047,45.0
7.297,46,42,55.5,18,5.7,33,15,45,51.502,86.49,55.074,98.633,91,87,5,9,575.83,11,18,17,1.134,0,0,0,4,0,0.121,37.9
5.652,82,82,93.0,42,8.8,53,11,100,100.76,182.995,106.979,210.133,182,182,16,29,1169.69,29,11,0,1.155,0,0,0,13,0,0.159,29.1
5.0,37,34,48.5,9,7.9,26,15,29,39.573,63.094,41.529,71.102,66,63,5,8,459.6,7,19,17,1.129,2,0,0,3,0,0.106,41.3
5.0,38,35,49.5,10,7.6,27,15,31,41.1,65.978,43.29,74.517,69,66,5,8,473.63,7,19,17,1.129,2,0,0,3,0,0.101,40.9
5.0,40,37,52.5,10,7.4,28,16,31,42.815,68.305,44.745,76.727,71,68,5,9,501.64,7,20,17,1.128,2,0,0,4,0,0.099,41.2
6.824,44,40,56.5,13,6.7,31,16,35,46.868,75.072,49.267,84.557,79,75,5,9,541.71,8,20,17,1.127,2,0,0,4,0,0.101,41.3
7.412,44,41,56.5,14,6.3,32,16,39,48.922,79.839,51.79,90.388,83,80,5,9,557.76,9,20,17,1.13,2,0,0,4,0,0.108,40.0
5.0,42,39,54.5,11,6.9,29,16,33,45.056,72.516,46.961,81.351,75,72,5,10,531.67,9,20,17,1.13,2,0,0,5,0,0.12,40.3
5.538,45,41,57.5,13,6.6,31,16,35,47.583,76.4,49.722,85.767,80,76,5,10,557.71,8,20,17,1.129,2,0,0,5,0,0.1,40.8
5.0,42,39,57.5,6,7.4,30,22,29,44.288,68.421,45.983,76.312,71,68,5,9,523.64,8,26,23,1.122,2,0,0,4,0,0.113,44.1
6.717,45,41,60.5,8,6.9,32,22,31,46.815,72.305,48.745,80.727,76,72,5,9,549.68,9,26,23,1.121,2,0,0,4,0,0.118,44.4
7.634,44,41,59.5,8,6.8,32,22,33,47.341,74.189,49.506,83.142,77,74,5,9,551.7,9,26,23,1.124,2,0,0,4,0,0.117,43.2
5.0,41,38,56.5,5,7.7,29,22,27,42.761,65.538,44.222,72.896,68,65,5,9,509.61,8,26,23,1.121,2,0,0,4,0,0.118,44.6
5.0,42,39,57.5,6,7.4,30,22,29,44.288,68.421,45.983,76.312,71,68,5,9,523.64,8,26,23,1.122,2,0,0,4,0,0.113,44.1
5.0,40,33,53.0,7,5.6,26,19,21,36.665,54.567,37.688,60.069,61,54,3,7,439.5,1,25,24,1.112,0,0,0,4,0,0.016,48.1
5.0,51,43,68.0,9,5.5,35,26,30,48.793,73.203,50.739,81.228,81,73,4,8,570.69,3,32,30,1.113,0,0,0,4,0,0.037,47.9
5.0,44,41,59.5,8,6.8,32,22,33,47.341,74.189,49.506,83.142,77,74,5,9,551.7,9,26,23,1.124,2,0,0,4,0,0.117,43.2
7.06,39,36,48.5,13,5.6,28,15,36,43.374,71.854,46.023,81.474,75,72,4,8,492.68,8,18,17,1.132,0,0,0,4,0,0.107,38.9
7.018,37,34,46.5,12,5.9,27,15,34,41.132,67.643,43.807,76.849,71,68,4,7,462.65,7,18,17,1.13,0,0,0,3,0,0.099,39.7
6.357,50,46,62.5,12,6.0,33,21,37,52.118,84.519,53.574,94.486,87,83,5,13,637.75,13,24,23,1.138,0,0,2,6,2,0.149,39.8
7.292,38,35,47.5,13,8.5,27,14,36,42.46,70.519,45.364,80.637,74,71,6,8,476.69,7,18,17,1.136,0,0,0,2,0,0.095,38.0
7.448,44,40,56.5,8,7.2,29,21,29,44.581,70.33,45.62,78.406,73,69,5,11,549.63,7,24,23,1.136,0,0,2,4,2,0.096,42.0
7.796,47,42,59.5,10,9.6,30,20,31,46.909,74.207,48.177,83.193,78,73,7,12,575.68,6,24,23,1.14,0,0,2,3,2,0.077,41.1
6.276,46,42,55.5,17,4.8,32,15,42,50.384,84.159,53.216,95.138,88,84,4,10,578.78,13,18,17,1.133,0,0,0,6,0,0.148,38.1
6.745,38,33,50.5,3,6.0,25,22,17,36.946,50.563,39.37,54.839,55,50,3,8,583.32,4,24,23,1.097,0,0,2,2,0,0.073,50.0
6.602,42,38,54.5,7,7.7,28,21,27,42.34,66.12,43.404,73.782,69,65,5,10,519.6,6,24,23,1.135,0,0,2,3,2,0.087,43.1
7.525,45,41,57.5,9,6.9,30,21,31,46.108,73.214,47.381,81.821,76,72,5,11,563.66,9,24,23,1.136,0,0,2,4,2,0.118,41.7
5.8,30,27,42.0,0,9.5,20,20,15,29.532,42.625,30.631,46.954,45,42,4,7,378.46,3,23,22,1.118,0,0,1,1,1,0.067,47.6
6.745,42,38,54.5,7,10.8,27,20,27,42.141,66.112,43.199,74.154,69,65,7,11,519.61,6,24,23,1.141,0,0,2,2,2,0.087,41.5
6.0,43,38,57.0,8,10.6,28,20,28,42.757,66.6,44.262,74.814,71,66,7,10,513.63,8,27,26,1.134,0,0,1,2,1,0.113,42.4
5.652,38,33,50.5,4,5.7,26,22,20,37.447,53.218,39.779,58.412,58,53,3,7,518.46,4,24,23,1.102,0,0,1,2,0,0.069,49.1
5.879,40,35,52.5,5,5.3,27,22,22,39.689,57.429,41.995,63.037,62,57,3,8,548.49,5,24,23,1.106,0,0,1,3,0,0.081,47.4
6.337,39,34,51.5,4,5.7,26,22,19,38.472,53.447,41.131,58.254,58,53,3,8,597.35,4,24,23,1.099,0,0,2,2,0,0.069,49.1
5.623,38,33,50.5,3,6.0,25,22,17,36.748,50.658,38.875,54.941,55,50,3,8,538.87,4,24,23,1.099,0,1,2,2,0,0.073,50.0
6.071,39,34,51.5,4,5.6,26,22,20,38.162,54.545,40.233,59.622,59,54,3,8,534.46,5,24,23,1.104,0,0,1,3,0,0.085,48.1
7.092,39,34,52.0,6,13.6,25,19,25,38.296,59.28,39.836,67.063,64,59,8,9,456.58,6,26,26,1.137,0,0,1,0,1,0.094,42.4
6.215,42,37,56.0,7,12.5,27,20,27,41.537,64.49,43.052,72.688,69,64,8,10,498.62,6,27,26,1.136,0,0,1,1,1,0.087,42.2
6.921,40,35,53.0,7,12.9,26,19,27,39.822,62.163,41.597,70.478,67,62,8,9,470.61,6,26,26,1.137,0,0,1,0,1,0.09,41.9
5.412,28,25,38.5,2,7.3,20,18,16,28.766,40.891,30.853,45.265,44,41,3,5,365.91,2,19,17,1.104,0,1,1,0,0,0.045,48.8
5.917,28,25,38.5,2,7.3,20,18,16,28.964,40.796,31.347,45.163,44,41,3,5,410.36,2,19,17,1.102,0,0,1,0,0,0.045,48.8
5.484,29,26,39.5,3,6.7,21,18,19,30.181,44.778,32.211,49.946,48,45,3,5,361.5,3,19,17,1.11,0,0,0,1,0,0.063,46.7
5.983,28,25,38.5,3,6.8,21,18,19,29.466,43.451,31.756,48.737,47,44,3,4,345.5,2,19,17,1.108,0,0,0,0,0,0.043,47.7
6.056,29,26,39.5,2,7.3,20,18,15,29.594,41.214,31.71,45.209,44,41,3,6,400.35,2,19,17,1.103,0,2,2,0,0,0.045,48.8
5.417,31,27,43.5,2,4.3,25,23,20,31.784,46.156,33.864,51.733,51,47,2,2,348.47,3,24,23,1.101,0,0,0,0,0,0.059,53.2
5.445,32,28,44.5,2,4.3,25,23,19,32.167,46.669,33.802,52.073,51,47,2,3,366.46,3,24,23,1.108,0,0,1,0,1,0.059,53.2
5.513,32,28,44.5,2,4.3,25,23,19,32.612,46.48,34.722,51.677,51,47,2,3,382.91,3,24,23,1.1,0,1,1,0,0,0.059,53.2
5.635,32,28,44.5,2,4.3,25,23,19,32.809,46.385,35.216,51.575,51,47,2,3,427.36,3,24,23,1.097,0,0,1,0,0,0.059,53.2
5.521,33,29,45.5,3,3.9,26,23,22,34.026,50.367,36.08,56.358,55,51,2,3,378.5,4,24,23,1.105,0,0,0,1,0,0.073,51.0
5.719,32,28,44.5,3,4.0,26,23,22,33.311,49.04,35.625,55.149,54,50,2,2,362.5,3,24,23,1.103,0,0,0,0,0,0.056,52.0
5.703,33,29,45.5,2,4.3,25,23,18,33.439,46.803,35.58,51.621,51,47,2,4,417.35,3,24,23,1.098,0,2,2,0,0,0.059,53.2
5.724,31,27,43.5,2,4.3,25,23,20,31.784,46.156,33.864,51.733,51,47,2,2,348.47,3,24,23,1.101,0,0,0,0,0,0.059,53.2
5.697,32,28,44.5,2,4.3,25,23,19,32.167,46.669,33.802,52.073,51,47,2,3,366.46,3,24,23,1.108,0,0,1,0,1,0.059,53.2
5.836,32,28,44.5,2,4.3,25,23,19,32.612,46.48,34.722,51.677,51,47,2,3,382.91,3,24,23,1.1,0,1,1,0,0,0.059,53.2
5.893,32,28,44.5,2,4.3,25,23,19,32.809,46.385,35.216,51.575,51,47,2,3,427.36,3,24,23,1.097,0,0,1,0,0,0.059,53.2
5.839,33,29,45.5,3,3.9,26,23,22,34.026,50.367,36.08,56.358,55,51,2,3,378.5,4,24,23,1.105,0,0,0,1,0,0.073,51.0
5.947,32,28,44.5,3,4.0,26,23,22,33.311,49.04,35.625,55.149,54,50,2,2,362.5,3,24,23,1.103,0,0,0,0,0,0.056,52.0
5.991,33,29,45.5,2,4.3,25,23,18,33.439,46.803,35.58,51.621,51,47,2,4,417.35,3,24,23,1.098,0,2,2,0,0,0.059,53.2
5.14,27,24,37.5,2,7.3,20,18,17,27.939,40.567,29.995,45.321,44,41,3,4,331.47,2,19,17,1.105,0,0,0,0,0,0.045,48.8
4.973,28,25,38.5,2,7.3,20,18,16,28.322,41.08,29.932,45.661,44,41,3,5,349.46,2,19,17,1.114,0,0,1,0,1,0.045,48.8
5.263,28,25,38.5,2,7.3,20,18,16,28.766,40.891,30.853,45.265,44,41,3,5,365.91,2,19,17,1.104,0,1,1,0,0,0.045,48.8
5.039,28,25,38.5,2,7.3,20,18,16,28.964,40.796,31.347,45.163,44,41,3,5,410.36,2,19,17,1.102,0,0,1,0,0,0.045,48.8
5.379,29,26,39.5,3,6.7,21,18,19,30.181,44.778,32.211,49.946,48,45,3,5,361.5,3,19,17,1.11,0,0,0,1,0,0.063,46.7
5.175,28,25,38.5,3,6.8,21,18,19,29.466,43.451,31.756,48.737,47,44,3,4,345.5,2,19,17,1.108,0,0,0,0,0,0.043,47.7
5.165,29,26,39.5,2,7.3,20,18,15,29.594,41.214,31.71,45.209,44,41,3,6,400.35,2,19,17,1.103,0,2,2,0,0,0.045,48.8
5.245,27,24,37.5,2,7.3,20,18,17,27.939,40.567,29.995,45.321,44,41,3,4,331.47,2,19,17,1.105,0,0,0,0,0,0.045,48.8
5.757,28,25,38.5,2,7.3,20,18,16,28.322,41.08,29.932,45.661,44,41,3,5,349.46,2,19,17,1.114,0,0,1,0,1,0.045,48.8
5.0,33,29,45.0,6,6.3,23,16,19,32.895,48.105,34.665,53.155,52,48,3,6,401.52,3,19,16,1.107,1,0,0,2,0,0.058,47.9
5.0,27,24,38.0,4,5.0,20,15,16,27.632,39.793,29.443,44.032,43,40,2,4,332.45,2,18,16,1.101,1,0,0,1,0,0.047,50.0
5.0,34,31,46.0,1,14.0,19,18,12,31.169,45.545,30.421,49.448,46,43,6,12,448.82,4,23,22,1.15,0,1,4,2,3,0.087,44.2
5.678,80,75,104.0,9,5.0,51,42,44,83.447,122.352,87.353,132.687,124,119,6,24,1412.41,21,42,36,1.115,0,0,6,12,0,0.169,42.9
5.347,55,51,71.0,6,5.1,34,28,27,56.305,80.542,59.08,86.689,82,78,4,17,1019.15,0,28,24,1.111,0,0,5,8,0,0.0,43.6
6.125,41,36,55.0,6,13.1,26,20,25,40.01,61.607,41.29,69.272,66,61,8,10,484.59,6,27,26,1.136,0,0,1,1,1,0.091,42.6
7.796,41,36,54.0,7,12.7,26,19,27,40.537,63.49,42.052,71.688,68,63,8,10,486.61,6,26,26,1.138,0,0,1,1,1,0.088,41.3
5.456,35,32,47.0,5,5.6,23,18,22,35.762,55.04,37.034,60.744,57,54,3,9,455.55,3,21,18,1.125,0,0,1,4,1,0.053,42.6
5.0,28,25,38.5,4,6.8,19,15,19,28.895,44.105,30.665,49.155,47,44,3,6,353.48,2,19,17,1.117,0,0,0,2,0,0.043,43.2
5.0,32,29,42.5,7,7.3,22,15,26,34.497,54.858,36.955,61.899,58,55,4,7,410.59,4,19,17,1.125,0,0,0,2,0,0.069,40.0
5.0,27,24,37.5,3,7.3,18,15,17,27.369,41.222,28.904,45.74,44,41,3,6,339.45,2,19,17,1.116,0,0,0,2,0,0.045,43.9
7.991,75,74,93.0,25,9.1,46,21,69,84.751,145.974,87.211,164.245,144,143,13,28,1044.28,30,23,10,1.149,0,0,0,15,0,0.208,32.2
6.759,104,100,127.5,33,9.0,63,30,89,114.097,192.835,117.791,216.317,193,189,17,37,1420.76,38,32,17,1.145,0,0,0,19,0,0.197,33.3
6.35,111,108,136.0,35,9.5,69,34,102,124.608,213.482,128.967,240.968,213,210,20,39,1515.91,43,34,18,1.147,0,0,0,19,0,0.202,32.9
5.8,25,23,33.0,8,14.0,16,7,20,26.531,43.123,27.819,49.106,45,43,6,7,312.42,3,12,10,1.142,1,0,0,1,0,0.067,37.2
6.921,41,36,54.0,8,12.3,27,19,29,41.349,65.047,43.358,73.893,70,65,8,9,484.64,6,26,26,1.137,0,0,1,0,1,0.086,41.5
7.409,41,36,55.0,6,13.1,26,20,25,40.01,61.607,41.29,69.272,66,61,8,10,484.59,6,27,26,1.136,0,0,1,1,1,0.091,42.6
6.959,42,37,56.0,7,11.1,27,20,26,41.231,63.716,42.5,71.399,68,63,7,10,499.6,7,27,26,1.133,0,0,1,2,1,0.103,42.9
7.538,39,36,50.0,5,8.8,24,19,21,38.497,59.189,38.676,65.235,60,57,5,12,519.95,7,20,18,1.144,0,1,4,3,3,0.117,42.1
7.187,42,39,55.0,6,8.1,25,19,23,41.925,64.476,42.54,70.779,65,62,5,14,582.05,8,22,18,1.142,0,1,4,4,3,0.123,40.3
7.745,37,33,50.0,3,7.7,24,21,19,36.459,52.858,37.983,57.807,56,52,4,9,478.99,6,24,22,1.112,0,1,1,3,0,0.107,46.2
7.62,39,35,52.0,4,8.8,25,21,22,39.007,57.843,40.75,63.721,61,57,5,10,508.04,7,24,22,1.118,0,1,1,3,0,0.115,43.9
7.523,42,38,57.0,5,8.1,26,21,24,42.436,63.131,44.614,69.265,66,62,5,12,570.14,8,26,22,1.117,0,1,1,4,0,0.121,41.9
7.0,37,34,48.0,4,7.7,23,19,18,35.949,54.203,35.909,59.321,55,52,4,11,490.9,6,20,18,1.141,0,1,4,3,3,0.109,44.2
4.301,18,17,25.5,2,14.8,11,8,10,18.096,27.713,18.216,30.658,28,27,4,6,230.25,3,12,11,1.135,1,0,0,2,0,0.107,40.7
4.5,15,14,22.5,0,21.1,9,8,5,13.996,19.804,13.722,21.748,20,19,4,5,188.18,1,12,11,1.145,1,0,1,0,1,0.05,47.4
5.102,15,14,22.5,0,21.1,9,8,5,14.638,19.52,15.137,21.25,20,19,4,5,249.08,1,12,11,1.118,1,0,1,0,0,0.05,47.4
4.87,17,16,24.5,3,14.3,12,8,12,18.193,27.942,19.068,31.654,29,28,4,4,212.28,2,12,11,1.131,1,0,0,0,0,0.069,42.9
4.301,16,15,23.5,1,17.4,10,8,8,15.854,23.502,16.0,26.033,24,23,4,5,200.22,2,12,11,1.132,1,0,0,1,0,0.083,43.5
4.438,15,14,22.5,1,18.2,10,8,8,15.139,22.174,15.546,24.824,23,22,4,4,184.22,1,12,11,1.128,1,0,0,0,0,0.043,45.5
5.0,31,28,44.0,0,7.3,19,19,13,30.24,42.251,31.585,45.529,44,41,3,9,433.94,3,24,22,1.11,0,1,2,2,1,0.068,46.3
5.0,45,41,62.0,1,8.3,27,26,19,42.428,62.898,42.097,68.345,64,60,5,14,585.58,5,31,28,1.139,0,0,4,4,4,0.078,45.0
5.8,26,24,36.0,0,10.5,17,17,14,25.864,38.807,26.193,42.697,40,38,4,7,322.35,5,19,18,1.124,0,0,0,3,0,0.125,44.7
5.8,29,26,41.0,0,15.0,18,18,14,27.665,40.8,27.989,45.069,43,40,6,8,346.38,5,23,22,1.127,0,0,0,2,0,0.116,45.0
6.071,41,36,54.0,8,10.8,27,19,29,41.374,65.087,43.324,73.474,70,65,7,9,483.63,8,26,26,1.13,0,0,0,2,0,0.114,41.5
7.387,42,37,55.0,8,10.8,27,19,28,41.757,65.6,43.262,73.814,70,65,7,10,501.62,8,26,26,1.136,0,0,1,2,1,0.114,41.5
4.0,28,26,37.0,4,14.0,17,13,17,27.966,44.334,28.177,49.915,45,43,6,9,362.4,6,17,16,1.161,0,0,3,0,3,0.133,39.5
5.0,28,25,39.5,2,11.9,19,17,17,27.983,42.138,29.051,47.192,45,42,5,6,331.41,4,22,21,1.124,0,0,0,1,0,0.089,45.2
7.222,37,33,50.0,5,12.3,24,19,24,36.989,57.505,38.284,64.774,61,57,7,9,445.55,9,26,26,1.136,0,0,1,1,1,0.148,42.1
4.921,29,26,40.5,2,11.6,19,17,17,28.697,43.465,29.506,48.402,46,43,5,7,347.41,5,22,21,1.126,0,0,0,2,0,0.109,44.2
6.886,38,34,51.0,6,11.7,25,19,26,38.516,60.389,40.046,68.189,64,60,7,9,459.58,10,26,26,1.136,0,0,1,1,1,0.156,41.7
6.252,39,35,52.0,7,11.1,26,19,28,40.043,63.272,41.807,71.604,67,63,7,9,473.61,10,26,26,1.137,0,0,1,1,1,0.149,41.3
7.155,40,35,53.0,7,11.5,26,19,26,39.516,61.389,41.046,69.189,66,61,7,9,471.59,7,26,26,1.134,0,0,1,1,1,0.106,42.6
4.432,32,29,44.5,3,12.2,21,18,20,32.246,49.451,33.273,55.315,52,49,6,8,388.47,6,23,21,1.129,0,0,0,2,0,0.115,42.9
5.519,31,28,42.5,4,12.0,21,17,22,32.058,50.007,33.58,56.521,53,50,6,7,374.49,7,22,21,1.13,0,0,0,1,0,0.132,42.0
6.921,41,36,54.0,8,10.9,27,19,28,41.043,64.272,42.807,72.604,69,64,7,9,485.62,8,26,26,1.134,0,0,1,1,1,0.116,42.2
6.77,41,36,54.0,8,10.9,27,19,28,41.043,64.272,42.807,72.604,69,64,7,9,485.62,8,26,26,1.134,0,0,1,1,1,0.116,42.2
4.0,24,22,33.0,1,15.6,14,13,10,22.364,33.582,21.887,37.171,34,32,5,8,305.29,3,17,16,1.162,0,0,3,0,3,0.088,43.8
4.485,29,26,40.5,1,13.2,18,17,12,26.891,39.465,26.648,43.587,41,38,5,8,355.35,3,22,21,1.147,0,0,3,0,3,0.073,47.4
6.959,33,29,46.0,2,13.0,21,19,17,31.387,46.752,31.995,52.03,50,46,6,8,388.44,5,26,26,1.131,0,0,1,1,1,0.1,45.7
7.26,41,36,54.0,7,11.3,26,19,26,40.231,62.716,41.5,70.399,67,62,7,10,487.59,8,26,26,1.135,0,0,1,2,1,0.119,41.9
6.377,37,33,50.0,5,10.7,24,19,23,36.682,56.731,37.733,63.485,60,56,6,9,446.53,9,26,26,1.134,0,0,1,2,1,0.15,42.9
6.553,38,34,52.0,4,10.9,24,20,21,36.87,56.174,37.426,62.279,59,55,6,10,460.51,9,27,26,1.132,0,0,1,3,1,0.153,43.6
6.229,41,36,54.0,7,11.3,26,19,26,40.231,62.716,41.5,70.399,67,62,7,10,487.59,8,26,26,1.135,0,0,1,2,1,0.119,41.9
6.252,39,35,50.0,7,8.3,25,18,25,39.257,61.047,40.563,67.971,64,60,5,10,498.0,9,22,22,1.133,0,1,2,3,1,0.141,41.7
7.284,39,34,52.0,6,13.6,25,19,25,38.296,59.28,39.836,67.063,64,59,8,9,456.58,6,26,26,1.137,0,0,1,0,1,0.094,42.4
6.959,37,33,51.0,3,13.2,23,20,20,35.65,54.065,36.216,60.153,57,53,7,10,445.5,8,27,26,1.135,0,0,1,2,1,0.14,43.4
6.721,46,41,61.0,10,10.8,29,19,33,47.02,74.545,49.438,84.063,79,74,8,12,576.77,10,28,26,1.136,0,0,1,2,1,0.127,39.2
5.8,30,28,38.0,9,11.3,19,10,25,32.654,53.425,34.415,60.505,55,53,6,9,404.95,8,14,12,1.142,0,1,1,2,0,0.145,35.8
6.0,23,20,33.0,1,18.8,14,13,12,21.709,32.262,22.318,36.235,35,32,6,6,264.32,2,20,20,1.132,0,0,0,0,0,0.057,43.8
6.367,30,27,41.0,2,9.3,20,18,16,29.699,43.756,30.603,48.393,46,43,4,7,382.85,5,22,22,1.125,0,1,2,1,1,0.109,46.5
7.509,43,38,56.0,9,11.6,28,19,31,43.591,69.258,45.574,78.518,74,69,8,10,514.67,9,26,26,1.138,0,0,1,1,1,0.122,40.6
6.387,40,35,53.0,7,13.1,25,18,26,39.342,61.421,40.807,69.142,66,61,8,10,470.59,8,26,26,1.133,0,0,0,2,0,0.121,41.0
6.959,42,37,55.0,9,11.8,28,19,31,42.876,67.93,45.12,77.309,73,68,8,9,498.67,7,26,26,1.137,0,0,1,0,1,0.096,41.2
6.745,43,38,57.0,8,11.9,28,20,29,43.064,67.374,44.813,76.103,72,67,8,10,512.65,7,27,26,1.136,0,0,1,1,1,0.097,41.8
6.921,44,39,58.0,8,11.8,28,20,29,43.779,68.701,45.267,77.312,73,68,8,11,528.65,8,27,26,1.137,0,0,1,2,1,0.11,41.2
7.387,38,34,49.0,7,10.0,25,18,26,38.849,60.494,40.659,68.05,64,60,6,9,481.02,7,22,22,1.134,0,1,2,1,1,0.109,41.7
7.495,38,34,49.0,7,10.0,25,18,26,38.849,60.494,40.659,68.05,64,60,6,9,481.02,7,22,22,1.134,0,1,2,1,1,0.109,41.7
6.77,42,37,55.0,8,12.1,27,19,29,42.064,66.374,43.813,75.103,71,66,8,10,500.64,7,26,26,1.138,0,0,1,1,1,0.099,40.9
7.456,39,34,52.0,7,14.8,25,18,27,38.934,60.869,40.904,69.222,66,61,9,9,453.61,6,26,26,1.135,0,0,0,0,0,0.091,41.0
7.469,39,34,52.0,7,14.8,25,18,27,38.934,60.869,40.904,69.222,66,61,9,9,453.61,6,26,26,1.135,0,0,0,0,0,0.091,41.0
6.721,39,34,52.0,7,14.8,25,18,27,38.934,60.869,40.904,69.222,66,61,9,9,453.61,6,26,26,1.135,0,0,0,0,0,0.091,41.0
7.648,40,35,53.0,7,12.9,26,19,27,39.822,62.163,41.597,70.478,67,62,8,9,470.61,6,26,26,1.137,0,0,1,0,1,0.09,41.9
7.886,40,35,53.0,8,14.1,26,18,29,40.461,63.752,42.665,72.637,69,64,9,9,467.64,6,26,26,1.135,0,0,0,0,0,0.087,40.6
7.222,38,34,49.0,8,11.3,25,17,28,39.487,62.083,41.728,70.209,66,62,7,9,478.05,7,22,22,1.132,0,1,1,1,0,0.106,40.3
7.658,37,33,48.0,7,11.9,24,17,26,37.96,59.2,39.966,66.794,63,59,7,9,464.02,7,22,22,1.132,0,1,1,1,0,0.111,40.7
5.585,33,30,41.5,8,7.4,22,14,24,34.718,54.523,36.597,61.161,57,54,4,8,475.4,6,17,17,1.133,0,0,2,2,1,0.105,40.7
7.585,37,33,48.0,7,13.8,23,16,25,37.455,58.418,39.211,65.877,62,58,8,10,465.01,7,22,22,1.136,0,1,1,1,0,0.113,39.7
7.745,38,34,50.0,7,11.7,24,17,26,38.675,60.527,40.421,68.003,64,60,7,10,480.02,7,23,22,1.133,0,1,1,2,0,0.109,40.0
5.444,34,30,47.0,3,14.9,21,18,17,32.077,48.04,32.483,53.659,51,47,7,9,405.45,5,26,26,1.142,0,0,2,0,2,0.098,44.7
5.291,33,29,46.0,3,14.9,21,18,18,31.694,47.527,32.546,53.319,51,47,7,8,387.46,5,26,26,1.134,0,0,1,0,1,0.098,44.7
5.821,35,32,46.5,5,14.0,20,14,18,34.47,51.396,35.477,56.472,53,50,7,12,471.97,3,19,17,1.129,1,1,1,3,0,0.057,40.0
6.602,43,37,55.5,11,11.9,27,16,30,42.868,66.938,45.523,75.683,73,67,8,10,514.72,5,25,25,1.13,0,0,0,1,0,0.068,40.3
6.62,35,30,50.5,1,13.0,23,22,16,32.477,46.356,33.296,51.275,51,46,6,7,392.45,3,31,31,1.115,0,0,0,1,0,0.059,50.0
7.071,36,31,51.5,2,12.2,24,22,18,34.004,49.24,35.057,54.69,54,49,6,7,406.48,4,31,31,1.116,0,0,0,1,0,0.074,49.0
4.0,38,33,53.5,4,10.9,26,22,22,37.058,55.007,38.58,61.521,60,55,6,7,434.54,5,31,31,1.119,0,0,0,1,0,0.083,47.3
4.0,36,31,51.5,2,12.2,24,22,18,34.004,49.24,35.057,54.69,54,49,6,7,406.48,4,31,31,1.116,0,0,0,1,0,0.074,49.0
4.0,31,27,44.0,2,14.0,20,18,16,29.477,43.356,30.296,48.275,47,43,6,7,356.42,4,26,26,1.123,0,0,0,1,0,0.085,46.5
5.8,33,29,43.5,7,10.0,22,14,21,32.751,50.232,34.029,56.232,54,50,5,7,387.48,5,18,17,1.125,1,0,0,2,0,0.093,44.0
4.523,43,37,56.5,9,10.3,30,21,31,43.471,67.316,46.177,76.471,74,68,7,7,489.68,4,27,27,1.125,0,0,0,0,0,0.054,44.1
4.0,31,27,44.0,2,16.7,19,17,15,28.972,42.574,29.54,47.358,46,42,7,8,357.41,4,26,26,1.128,0,0,0,1,0,0.087,45.2
7.051,39,34,54.5,5,11.9,27,22,25,38.891,58.665,40.892,66.225,64,59,7,7,447.59,6,31,31,1.122,0,0,0,0,0,0.094,45.8
5.186,41,35,56.5,5,13.6,27,22,24,39.386,58.883,41.137,66.308,65,59,8,8,460.59,3,31,31,1.124,0,0,0,0,0,0.046,45.8
5.224,20,19,27.0,0,3.7,13,13,8,21.161,27.862,22.779,29.518,28,27,1,6,449.92,2,13,12,1.093,0,0,3,2,0,0.071,48.1
6.73,44,38,57.0,11,11.4,29,18,32,44.208,69.745,46.637,79.178,76,70,8,9,508.69,5,26,26,1.131,0,0,0,1,0,0.066,41.4
4.0,40,34,55.5,4,12.7,26,22,21,37.552,55.225,38.824,61.604,61,55,7,8,447.54,3,31,31,1.12,0,0,0,1,0,0.049,47.3
4.0,36,31,52.5,0,13.3,23,23,14,32.665,45.8,32.989,50.069,50,45,6,8,406.43,3,32,31,1.113,0,0,0,2,0,0.06,51.1
5.0,39,34,55.5,3,12.7,26,23,21,37.552,55.225,38.824,61.604,60,55,7,8,447.54,4,32,31,1.12,0,0,0,1,0,0.067,47.3
4.0,35,31,48.0,5,13.0,23,18,23,35.079,54.109,36.586,61.019,58,54,7,8,413.53,6,26,26,1.13,0,0,0,1,0,0.103,42.6
4.0,36,32,49.0,6,12.3,24,18,25,36.606,56.992,38.347,64.434,61,57,7,8,427.56,7,26,26,1.13,0,0,0,1,0,0.115,42.1
5.0,21,19,28.5,4,13.9,14,10,17,22.268,35.811,23.597,40.983,38,36,5,5,255.36,3,15,15,1.138,0,0,0,0,0,0.079,38.9
6.833,41,37,53.5,7,7.9,27,20,26,41.588,63.862,43.08,70.84,67,63,5,10,520.03,9,24,23,1.124,0,1,1,4,0,0.134,42.9
7.367,38,35,50.5,5,8.5,25,20,24,39.062,59.978,40.318,66.425,62,59,5,10,493.99,10,24,23,1.126,0,1,1,4,0,0.161,42.4
7.959,39,36,51.5,6,8.1,26,20,26,40.588,62.862,42.08,69.84,65,62,5,10,508.02,10,24,23,1.126,0,1,1,4,0,0.154,41.9
7.959,39,36,51.5,6,8.1,26,20,26,40.588,62.862,42.08,69.84,65,62,5,10,508.02,10,24,23,1.126,0,1,1,4,0,0.154,41.9
6.178,45,39,58.0,11,11.4,29,18,31,45.035,70.069,47.495,79.122,76,70,8,10,543.13,5,26,26,1.13,0,1,1,1,0,0.066,41.4
5.0,40,35,56.5,4,12.1,27,23,23,39.079,58.109,40.586,65.019,63,58,7,8,461.57,5,32,31,1.121,0,0,0,1,0,0.079,46.6
4.0,37,32,52.5,3,11.5,25,22,20,35.531,52.123,36.818,58.106,57,52,6,7,420.51,4,31,31,1.117,0,0,0,1,0,0.07,48.1
6.446,28,25,33.0,11,6.0,19,8,25,30.003,50.007,31.756,56.69,53,50,3,6,343.47,3,8,6,1.134,0,0,0,3,0,0.057,38.0
5.301,43,39,56.0,7,10.6,27,20,27,42.856,67.44,43.654,75.363,70,66,7,12,535.61,7,24,22,1.142,0,0,2,3,2,0.1,40.9
5.8,34,32,41.5,9,8.9,20,11,24,36.025,57.541,37.642,64.128,58,56,5,12,532.46,10,13,11,1.145,0,0,3,3,2,0.172,35.7
6.0,33,30,44.0,4,14.0,20,16,20,33.095,50.876,34.137,56.757,53,50,7,10,425.92,9,22,22,1.135,0,1,1,2,0,0.17,40.0
6.735,39,35,50.0,8,11.5,24,16,26,39.39,61.854,40.875,69.212,65,61,7,11,496.02,8,22,22,1.135,0,1,1,3,0,0.123,39.3
6.362,41,37,56.0,3,11.5,27,24,24,40.704,61.832,41.739,68.983,65,61,7,10,497.58,9,29,28,1.131,0,0,1,2,1,0.138,44.3
8.222,35,32,47.0,4,13.0,22,18,22,35.177,54.949,35.978,61.568,57,54,7,10,435.51,9,23,22,1.14,0,0,1,2,1,0.158,40.7
5.282,22,21,29.0,2,14.7,13,11,13,22.667,35.091,23.085,39.061,35,34,5,8,309.76,5,13,12,1.149,0,1,2,1,1,0.143,38.2
6.886,38,35,50.5,6,8.1,26,20,27,39.761,62.538,41.222,69.896,65,62,5,9,473.58,9,24,23,1.127,0,0,0,4,0,0.138,41.9
7.721,40,36,51.0,8,9.7,25,17,26,40.278,63.149,41.568,70.469,66,62,6,11,513.02,9,22,22,1.137,0,1,2,3,1,0.136,40.3
7.022,39,35,54.0,2,12.3,26,24,22,38.462,57.621,39.523,64.359,61,57,7,9,467.55,8,29,28,1.129,0,0,1,1,1,0.131,45.6
6.69,21,20,28.0,1,16.1,12,11,11,21.14,32.207,21.324,35.645,32,31,5,8,295.73,4,13,12,1.15,0,1,2,1,1,0.125,38.7
7.523,32,29,44.0,2,14.9,20,18,18,31.853,47.665,32.921,53.133,50,47,7,9,407.9,6,23,22,1.13,0,1,1,1,0,0.12,42.6
5.0,43,39,58.5,3,11.5,28,25,22,41.756,62.53,42.159,69.453,65,61,7,11,529.57,6,30,29,1.139,0,0,3,1,3,0.092,45.9
7.357,33,30,47.0,2,16.7,21,18,18,32.52,48.56,33.307,54.272,51,48,8,9,398.47,6,24,22,1.131,1,0,0,1,0,0.118,43.8
5.385,23,21,32.0,1,20.6,13,12,13,22.445,34.691,22.779,38.943,36,34,7,8,283.33,4,17,16,1.145,0,0,0,1,0,0.111,38.2
6.521,32,29,44.0,2,14.9,20,18,18,31.409,47.854,32.0,53.528,50,47,7,9,391.45,6,23,22,1.139,0,0,1,1,1,0.12,42.6
7.367,37,34,49.5,5,8.6,25,20,24,38.347,58.651,39.864,65.216,61,58,5,9,477.99,8,24,23,1.124,0,1,1,3,0,0.131,43.1
7.102,39,36,51.5,6,8.1,26,20,26,40.588,62.862,42.08,69.84,65,62,5,10,508.02,10,24,23,1.126,0,1,1,4,0,0.154,41.9
7.377,31,28,43.0,1,15.9,19,18,16,29.882,44.971,30.239,50.113,47,44,7,9,377.42,5,23,22,1.139,0,0,1,1,1,0.106,43.2
7.745,30,28,40.0,2,11.1,19,17,17,30.435,46.185,31.063,51.1,47,45,5,9,401.86,7,19,18,1.136,0,1,2,2,1,0.149,42.2
7.638,37,34,49.5,6,8.2,26,20,27,39.046,61.211,40.767,68.687,64,61,5,8,457.58,7,24,23,1.126,0,0,0,3,0,0.109,42.6
7.495,37,33,51.5,3,13.0,24,21,21,36.267,54.552,37.279,60.813,58,54,7,9,439.52,7,28,27,1.126,0,0,0,2,0,0.121,44.4
7.229,38,34,52.5,4,12.3,25,21,23,37.794,57.436,39.04,64.229,61,57,7,9,453.55,7,28,27,1.127,0,0,0,2,0,0.115,43.9
6.724,32,29,44.0,2,14.9,20,18,18,31.409,47.854,32.0,53.528,50,47,7,9,391.45,6,23,22,1.139,0,0,1,1,1,0.12,42.6
7.292,43,38,57.5,7,10.8,28,21,27,42.562,65.531,44.017,73.268,70,65,7,10,509.62,7,28,27,1.127,0,0,0,3,0,0.1,43.1
8.097,40,36,54.5,5,9.8,27,22,25,40.209,61.614,41.495,68.9,65,61,6,9,484.58,7,28,27,1.13,0,0,1,2,1,0.108,44.3
8.222,40,36,54.5,5,9.8,27,22,25,40.209,61.614,41.495,68.9,65,61,6,9,484.58,7,28,27,1.13,0,0,1,2,1,0.108,44.3
5.8,30,27,38.5,7,8.3,20,13,21,30.64,48.527,31.722,54.489,51,48,4,7,368.45,4,17,17,1.135,0,0,1,2,1,0.078,41.7
7.244,39,35,53.5,4,10.3,26,22,23,38.682,58.731,39.733,65.485,62,58,6,9,470.55,7,28,27,1.129,0,0,1,2,1,0.113,44.8
6.638,38,34,52.0,5,12.3,24,19,23,37.981,57.512,39.688,64.149,61,57,7,10,473.61,7,27,26,1.125,0,0,0,2,0,0.115,42.1
6.886,38,34,52.0,5,12.3,24,19,23,37.981,57.512,39.688,64.149,61,57,7,10,473.61,7,27,26,1.125,0,0,0,2,0,0.115,42.1
6.854,36,32,50.0,3,13.7,22,19,19,34.927,51.745,36.165,57.318,55,51,7,10,445.55,7,27,26,1.124,0,0,0,2,0,0.127,43.1
7.585,38,34,52.0,5,12.3,24,19,23,37.981,57.512,39.688,64.149,61,57,7,10,473.61,7,27,26,1.125,0,0,0,2,0,0.115,42.1
7.62,38,34,52.0,5,12.3,24,19,23,37.981,57.512,39.688,64.149,61,57,7,10,473.61,7,27,26,1.125,0,0,0,2,0,0.115,42.1
6.62,37,33,51.0,4,13.0,23,19,21,36.454,54.629,37.926,60.733,58,54,7,10,459.58,7,27,26,1.125,0,0,0,2,0,0.121,42.6
7.367,42,37,56.0,7,11.3,26,19,25,41.222,62.723,42.904,69.773,67,62,7,11,515.65,7,27,26,1.125,0,0,0,3,0,0.104,41.9
6.893,38,34,49.0,7,13.6,23,16,25,38.169,59.745,39.665,67.086,63,59,8,11,481.01,9,22,22,1.137,0,1,1,2,0,0.143,39.0
6.921,40,37,52.5,8,7.4,28,20,31,42.815,68.305,44.745,76.727,71,68,5,9,501.64,10,24,23,1.128,0,0,0,4,0,0.141,41.2
7.161,39,36,51.5,7,7.7,27,20,29,41.288,65.421,42.983,73.312,68,65,5,9,487.61,9,24,23,1.128,0,0,0,4,0,0.132,41.5
6.593,32,29,42.0,4,12.0,21,17,21,32.441,50.52,33.517,56.861,53,50,6,8,392.48,6,19,18,1.137,0,0,1,1,1,0.113,42.0
6.815,29,27,39.0,2,11.1,19,17,18,30.052,45.673,31.125,50.761,47,45,5,8,383.87,7,19,18,1.128,0,1,1,2,0,0.149,42.2
7.569,32,29,44.0,2,12.5,21,19,19,31.914,48.636,32.756,54.445,51,48,6,8,390.46,6,23,22,1.134,0,0,1,1,1,0.118,43.8
6.357,39,35,50.0,8,11.5,24,16,26,39.39,61.854,40.875,69.212,65,61,7,11,496.02,10,22,22,1.135,0,1,1,3,0,0.154,39.3
8.222,40,36,51.0,9,10.9,25,16,28,40.916,64.738,42.637,72.628,68,64,7,11,510.05,10,22,22,1.135,0,1,1,3,0,0.147,39.1
8.398,32,29,43.0,3,13.0,19,16,17,31.261,47.218,31.824,52.053,49,46,6,10,412.87,8,22,22,1.132,0,1,1,3,0,0.163,41.3
6.382,39,35,50.0,9,10.9,25,16,29,40.089,64.414,41.779,72.684,68,64,7,10,475.61,8,22,22,1.136,0,0,0,3,0,0.118,39.1
8.301,39,35,50.0,8,11.5,24,16,26,38.945,62.043,39.955,69.608,65,61,7,11,479.57,8,22,22,1.141,0,0,1,3,1,0.123,39.3
6.889,41,37,53.0,8,12.5,25,17,27,41.411,64.956,42.881,72.711,68,64,8,12,523.05,9,23,22,1.136,0,1,1,3,0,0.132,39.1
6.78,39,35,50.0,8,12.9,24,16,27,39.696,62.629,41.426,70.501,66,62,8,11,495.04,9,22,22,1.137,0,1,1,2,0,0.136,38.7
7.509,39,36,51.5,6,8.1,26,20,26,40.588,62.862,42.08,69.84,65,62,5,10,508.02,10,24,23,1.126,0,1,1,4,0,0.154,41.9
6.456,41,37,53.5,7,9.4,27,20,27,41.895,64.636,43.631,72.129,68,64,6,10,519.05,8,24,23,1.127,0,1,1,3,0,0.118,42.2
6.921,38,35,50.5,5,8.5,25,20,24,39.062,59.978,40.318,66.425,62,59,5,10,493.99,10,24,23,1.126,0,1,1,4,0,0.161,42.4
6.854,40,36,52.5,6,8.3,26,20,24,40.062,60.978,41.318,67.425,64,60,5,10,506.0,8,24,23,1.124,0,1,1,4,0,0.125,43.3
6.301,32,28,44.5,4,17.4,19,15,18,30.52,46.56,31.307,52.272,50,46,8,9,374.45,4,25,25,1.136,0,0,0,1,0,0.08,41.3
5.469,30,27,38.5,6,15.2,18,12,19,30.048,46.734,31.165,52.678,49,46,7,9,387.89,4,17,17,1.145,0,1,2,0,1,0.082,39.1
5.4,38,34,52.0,1,8.2,25,24,15,35.797,50.596,35.995,54.942,53,49,4,9,476.89,4,26,24,1.121,0,1,3,2,2,0.075,51.0
6.301,36,33,48.5,2,5.8,24,22,19,35.431,53.592,35.563,58.749,55,52,3,9,451.46,6,24,23,1.13,0,0,2,4,2,0.109,46.2
6.301,36,33,48.5,2,5.8,24,22,19,35.431,53.592,35.563,58.749,55,52,3,9,451.46,6,24,23,1.13,0,0,2,4,2,0.109,46.2
5.8,22,21,30.5,2,12.1,12,10,12,22.239,34.327,22.534,37.412,34,33,4,9,308.35,5,14,11,1.134,0,0,0,4,0,0.147,36.4
5.8,35,31,49.5,1,14.6,22,21,17,33.213,48.785,33.756,53.983,52,48,7,9,411.46,5,28,27,1.125,0,0,0,2,0,0.096,45.8
5.8,35,32,46.0,3,14.0,21,18,18,33.702,51.763,33.637,57.623,53,50,7,11,441.46,3,20,18,1.152,0,0,3,1,3,0.057,42.0
5.8,25,22,36.0,0,14.3,17,17,13,24.214,35.043,25.074,39.152,38,35,5,5,287.35,2,22,22,1.119,0,0,0,0,0,0.053,48.6
5.301,33,29,45.5,5,16.3,20,15,20,32.047,49.443,33.069,55.687,53,49,8,9,388.48,4,25,25,1.136,0,0,0,1,0,0.075,40.8
4.62,29,27,38.0,4,8.2,20,16,22,30.971,49.342,32.239,55.358,51,49,4,7,366.46,7,18,18,1.13,0,0,0,3,0,0.137,40.8
5.8,31,28,43.0,1,14.0,19,18,15,30.048,43.945,30.881,48.535,46,43,6,9,394.47,3,23,22,1.129,0,0,1,1,1,0.065,44.2
5.247,33,31,45.5,4,9.4,23,18,22,35.303,53.345,37.142,59.489,55,53,5,8,480.4,7,20,17,1.122,1,0,1,2,0,0.127,43.4
5.807,51,45,67.5,8,10.1,34,26,34,51.164,79.283,53.307,89.012,85,79,8,11,602.76,9,30,27,1.127,0,0,0,3,0,0.106,43.0
5.449,103,99,129.0,27,6.6,65,38,82,112.837,184.596,117.296,205.25,185,181,12,34,1431.8,27,38,24,1.134,0,0,0,19,0,0.146,35.9
7.585,53,48,71.5,6,7.9,33,27,28,51.556,78.534,52.148,86.504,81,76,6,15,680.74,12,35,33,1.138,0,0,4,4,4,0.148,43.4
6.699,40,35,54.0,5,13.8,25,20,23,38.484,58.723,39.529,65.857,63,58,8,10,470.56,6,27,26,1.135,0,0,1,1,1,0.095,43.1
4.272,14,13,21.5,0,21.1,9,8,6,13.612,19.291,13.784,21.408,20,19,4,4,170.19,1,12,11,1.127,1,0,0,0,0,0.05,47.4
4.824,45,41,61.0,5,7.7,28,23,24,44.57,66.901,45.875,73.546,69,65,5,13,599.71,10,30,28,1.131,0,0,3,3,3,0.145,43.1
6.83,39,35,50.0,8,11.5,24,16,26,39.39,61.854,40.875,69.212,65,61,7,11,496.02,9,22,22,1.135,0,1,1,3,0,0.138,39.3
5.8,32,29,44.0,1,8.7,21,20,17,31.943,46.803,33.068,51.369,49,46,4,8,453.32,4,23,22,1.117,0,0,1,3,0,0.082,45.7
6.699,38,35,50.5,6,8.1,26,20,27,39.761,62.538,41.222,69.896,65,62,5,9,473.58,9,24,23,1.127,0,0,0,4,0,0.138,41.9
9.0,38,34,49.0,7,12.1,23,16,24,37.863,58.971,39.114,65.797,62,58,7,11,481.99,9,22,22,1.134,0,1,1,3,0,0.145,39.7
5.8,32,29,44.0,1,8.7,21,20,17,31.745,46.898,32.574,51.472,49,46,4,8,408.87,4,23,22,1.119,0,1,1,3,0,0.082,45.7
6.745,34,31,46.5,2,10.2,22,20,18,33.767,50.0,34.58,54.97,52,49,5,9,435.9,8,24,23,1.122,0,1,1,3,0,0.154,44.9
8.398,40,36,51.0,9,12.3,25,16,29,41.223,65.512,43.188,73.916,69,65,8,11,509.07,10,22,22,1.137,0,1,1,2,0,0.145,38.5
6.01,46,43,60.5,9,5.4,30,21,31,47.899,75.912,49.176,84.207,77,74,4,13,616.72,14,26,23,1.138,0,0,3,5,3,0.182,40.5
5.8,28,25,36.5,5,13.6,18,13,19,28.199,44.309,29.302,50.236,47,44,6,7,338.43,3,17,17,1.142,0,0,1,0,1,0.064,40.9
7.301,27,25,36.5,1,11.4,16,15,10,26.3,36.636,26.796,39.45,37,35,4,9,399.65,3,18,17,1.127,0,3,4,1,1,0.081,45.7
4.0,20,18,27.5,2,6.3,15,13,14,20.918,31.833,22.034,35.697,34,32,2,3,238.31,1,13,11,1.116,0,0,0,1,0,0.029,46.9
8.086,37,34,47.5,7,8.5,24,17,25,38.455,59.952,40.057,66.868,62,59,5,10,530.44,9,19,17,1.133,0,0,2,3,1,0.145,40.7
5.0,28,25,39.5,0,7.7,20,20,14,27.323,39.447,27.978,43.535,42,39,3,5,331.37,3,23,23,1.116,0,0,1,1,1,0.071,51.3
5.0,22,20,30.5,2,5.9,16,14,14,22.633,34.16,23.489,37.907,36,34,2,4,266.32,3,17,17,1.115,0,0,0,2,0,0.083,47.1
8.137,26,24,36.5,0,11.1,17,17,12,25.843,36.894,26.574,40.46,38,36,4,7,387.23,4,19,17,1.124,0,0,2,1,1,0.105,47.2
7.013,32,28,45.5,1,15.6,21,20,17,30.784,45.131,31.847,50.564,49,45,7,7,367.45,4,27,27,1.124,0,0,0,0,0,0.082,46.7
5.788,27,25,39.5,0,10.5,19,18,13,27.46,38.382,28.637,42.12,40,38,4,6,393.26,4,20,17,1.108,1,0,1,1,0,0.1,50.0
5.301,37,34,47.5,8,10.0,24,16,26,38.564,60.821,40.114,68.26,63,60,6,10,485.01,9,19,17,1.138,0,1,2,2,1,0.143,40.0
4.0,32,29,43.0,3,13.3,19,16,16,31.127,46.309,31.801,51.081,48,45,6,10,459.31,7,22,22,1.135,0,0,2,2,1,0.146,42.2
4.678,31,27,44.5,1,11.4,22,21,17,30.268,43.811,31.597,48.983,48,44,5,5,351.44,4,27,27,1.113,0,0,0,0,0,0.083,50.0
5.0,36,33,47.5,7,8.3,25,18,27,38.798,60.087,41.336,67.571,63,60,5,8,484.47,7,22,21,1.126,0,2,2,1,0,0.111,41.7
5.412,28,26,41.5,1,10.3,20,16,13,28.46,39.382,29.637,43.12,41,39,4,6,405.27,3,20,17,1.106,3,0,1,1,0,0.073,51.3
7.921,26,24,36.5,0,14.3,16,16,11,25.14,36.207,25.324,39.645,37,35,5,8,343.77,4,19,17,1.133,0,1,2,1,1,0.108,45.7
6.74,38,35,48.5,8,11.3,24,16,27,39.585,62.923,41.12,70.758,65,62,7,11,500.03,9,19,17,1.141,0,1,2,2,1,0.138,38.7
6.943,25,23,35.5,0,11.1,17,17,13,25.46,36.382,26.637,40.12,38,36,4,6,369.24,4,19,17,1.114,0,0,1,1,0,0.105,47.2
5.886,31,27,44.5,1,8.9,23,22,18,30.773,44.592,32.353,49.9,49,45,4,4,350.45,4,27,27,1.109,0,0,0,0,0,0.082,51.1
5.594,39,36,49.5,10,7.7,26,15,29,41.755,65.625,44.006,73.405,68,65,5,10,530.5,9,18,17,1.129,1,2,2,3,0,0.132,40.0
8.377,29,27,38.5,6,9.6,21,15,25,32.09,51.672,34.097,58.853,54,52,5,6,363.51,5,18,17,1.132,0,0,0,1,0,0.093,40.4
5.3,19,17,27.5,0,10.7,14,14,11,19.171,27.84,20.063,31.156,30,28,3,3,221.28,2,17,17,1.113,0,0,0,0,0,0.067,50.0
5.668,20,19,26.0,0,0.0,12,12,6,20.561,26.444,21.795,27.191,26,25,0,7,356.05,2,12,12,1.088,0,4,4,2,0,0.077,48.0
6.602,39,32,53.0,5,6.1,25,20,17,34.611,49.8,35.165,54.239,56,49,3,7,423.45,1,26,24,1.107,0,0,0,4,0,0.018,51.0
4.31,28,26,38.0,4,6.7,20,15,19,29.423,45.356,30.472,50.445,47,45,3,6,349.42,3,15,12,1.121,1,0,0,3,0,0.064,44.4
4.639,24,23,34.0,2,5.1,18,15,16,25.875,39.371,26.705,43.531,40,39,2,5,308.36,5,15,12,1.116,1,0,0,3,0,0.125,46.2
5.192,15,15,22.0,0,8.7,10,9,8,15.768,23.836,15.659,25.87,23,23,2,5,204.2,2,9,6,1.125,1,0,0,3,0,0.087,43.5
4.883,38,34,49.0,9,6.2,28,19,31,40.559,64.618,43.074,73.355,69,65,4,6,458.63,8,22,22,1.129,0,0,1,1,1,0.116,43.1
4.602,27,25,33.0,10,8.2,17,7,24,30.157,49.051,32.841,55.404,51,49,4,8,380.59,6,11,10,1.131,0,0,0,2,0,0.118,34.7
5.8,23,20,32.0,1,6.5,16,15,11,22.417,31.178,23.625,34.124,34,31,2,4,327.19,0,17,16,1.101,0,0,1,1,0,0.0,51.6
5.0,45,39,61.0,7,7.4,32,25,29,44.858,67.767,47.074,75.893,74,68,5,7,515.66,5,29,26,1.116,0,0,0,2,0,0.068,47.1
4.602,35,33,44.0,10,6.3,23,13,30,39.167,63.356,42.034,71.068,65,63,4,10,490.71,12,17,16,1.128,0,0,0,4,0,0.185,36.5
7.62,25,23,33.5,2,8.3,16,14,13,24.865,37.098,25.29,40.689,38,36,3,7,333.77,4,17,17,1.13,0,1,2,2,1,0.105,44.4
6.6,34,29,49.0,4,8.5,24,19,18,32.488,46.92,33.807,52.109,52,47,4,5,378.46,2,26,24,1.109,1,0,0,1,0,0.038,51.1
7.084,34,30,47.5,3,13.7,23,20,21,33.837,50.898,35.37,57.395,55,51,7,7,395.51,5,27,27,1.125,0,0,0,0,0,0.091,45.1
5.357,27,26,38.0,3,2.3,19,16,17,28.525,44.134,28.824,48.076,44,43,1,7,355.37,10,17,12,1.118,0,0,0,6,0,0.227,44.2
4.307,32,29,43.5,1,11.9,19,18,13,30.096,43.745,29.994,47.479,45,42,5,10,413.82,4,20,17,1.13,0,1,2,3,1,0.089,45.2
6.566,39,35,50.5,6,12.1,24,18,23,38.531,59.156,39.597,65.927,62,58,7,11,495.99,4,20,17,1.137,0,1,2,2,1,0.065,41.4
5.976,38,35,48.0,13,1.4,32,19,39,44.46,72.545,48.381,82.806,77,74,1,3,469.72,10,19,18,1.119,0,0,0,2,0,0.13,43.2
6.2,23,21,31.0,5,12.5,16,11,19,24.795,39.694,26.358,45.398,42,40,5,5,281.4,2,16,16,1.135,0,0,0,0,0,0.048,40.0
5.381,31,29,43.5,3,10.2,22,18,20,33.061,49.134,34.927,54.864,51,49,5,7,450.37,6,20,17,1.12,1,0,1,1,0,0.118,44.9
6.456,35,31,48.5,3,7.5,25,22,22,35.256,53.014,36.784,59.149,57,53,4,6,410.51,6,27,27,1.116,0,0,0,2,0,0.105,47.2
5.509,35,31,48.5,3,9.6,24,21,21,34.751,52.232,36.029,58.232,56,52,5,7,411.5,6,27,27,1.12,0,0,0,2,0,0.107,46.2
4.382,24,20,36.0,0,0.0,20,20,12,23.161,31.302,24.568,34.491,36,32,0,0,252.32,0,24,24,1.078,0,0,0,0,0,0.0,62.5
4.0,18,16,25.5,0,4.0,13,13,9,17.558,25.291,17.96,27.578,27,25,1,3,211.23,1,13,11,1.103,0,0,0,2,0,0.037,52.0
4.0,22,20,31.0,0,3.2,16,16,11,21.8,31.502,22.176,34.203,33,31,1,4,265.28,2,15,12,1.103,0,0,0,3,0,0.061,51.6
4.0,22,20,29.5,4,5.3,17,13,18,23.972,37.6,25.557,42.528,40,38,2,3,266.37,2,13,11,1.119,0,0,0,1,0,0.05,44.7
4.0,20,18,28.0,0,3.4,15,15,11,20.085,29.174,20.722,31.993,31,29,1,3,237.27,1,14,12,1.103,0,0,0,2,0,0.032,51.7
8.367,26,24,36.5,0,11.1,17,17,12,25.645,36.989,26.08,40.562,38,36,4,7,342.78,4,19,17,1.127,0,1,2,1,1,0.105,47.2
4.648,21,19,29.0,1,3.2,16,15,12,21.922,30.96,23.381,34.041,33,31,1,3,314.19,1,14,12,1.098,0,0,1,1,0,0.03,51.6
5.959,35,31,48.5,3,9.6,24,21,21,34.751,52.232,36.029,58.232,56,52,5,7,411.5,6,27,27,1.12,0,0,0,2,0,0.107,46.2
4.0,20,18,27.5,2,3.2,15,13,13,21.084,30.807,22.676,34.119,33,31,1,3,255.36,2,13,11,1.101,0,0,0,1,0,0.061,48.4
8.194,36,33,46.5,7,8.5,24,17,26,38.071,59.44,40.12,66.529,62,59,5,9,512.45,9,19,17,1.128,0,0,1,3,0,0.145,40.7
4.0,25,22,33.0,4,5.0,19,15,18,25.972,39.6,27.557,44.528,43,40,2,3,290.39,2,14,12,1.113,0,0,0,1,0,0.047,47.5
4.0,27,24,35.0,6,4.3,21,15,22,29.026,45.367,31.08,51.358,49,46,2,3,318.45,2,14,12,1.116,0,0,0,1,0,0.041,45.7
4.045,28,25,37.0,4,6.8,20,16,19,28.708,44.029,30.017,49.235,47,44,3,5,333.42,2,15,12,1.119,0,0,0,2,0,0.043,45.5
4.033,26,23,34.0,5,4.7,20,15,20,27.499,42.483,29.319,47.943,46,43,2,3,304.42,2,14,12,1.115,0,0,0,1,0,0.043,46.5
4.0,24,22,32.5,3,5.3,17,14,16,24.875,38.371,25.705,42.531,40,38,2,5,296.35,4,14,11,1.119,0,0,0,3,0,0.1,44.7
4.0,25,23,33.5,4,4.9,18,14,18,26.402,41.254,27.466,45.946,43,41,2,5,310.38,5,14,11,1.121,0,0,0,3,0,0.116,43.9
4.0,20,18,27.5,2,6.3,15,13,14,20.918,31.833,22.034,35.697,34,32,2,3,238.31,1,13,11,1.116,0,0,0,1,0,0.029,46.9
5.557,33,30,43.5,5,9.6,22,17,22,34.303,52.345,36.142,58.489,55,52,5,8,468.39,6,19,17,1.125,0,0,1,2,0,0.109,42.3
4.569,31,27,44.5,1,11.4,22,21,17,30.268,43.811,31.597,48.983,48,44,5,5,351.44,4,27,27,1.113,0,0,0,0,0,0.083,50.0
4.0,19,17,26.5,0,4.0,13,13,8,19.056,25.269,20.506,27.13,27,25,1,4,306.19,1,13,11,1.085,0,0,1,1,0,0.037,52.0
6.699,38,35,48.5,8,9.8,24,16,26,39.278,62.149,40.568,69.469,64,61,6,11,501.01,9,19,17,1.139,0,1,2,3,1,0.141,39.3
5.73,32,28,45.5,1,15.6,21,20,17,30.784,45.131,31.847,50.564,49,45,7,7,367.45,4,27,27,1.124,0,0,0,0,0,0.082,46.7
6.724,37,34,47.5,7,10.3,23,16,24,37.752,59.265,38.807,66.054,61,58,6,11,486.98,9,19,17,1.139,0,1,2,3,1,0.148,39.7
7.658,25,23,35.5,1,10.3,18,17,16,25.961,39.036,27.046,43.694,41,39,4,5,304.38,4,19,17,1.12,0,0,0,1,0,0.098,46.2
6.903,28,26,38.5,1,12.8,17,16,13,27.381,40.418,27.54,44.27,41,39,5,9,373.8,5,19,17,1.135,0,1,2,2,1,0.122,43.6
5.876,22,21,30.0,2,0.0,17,15,16,24.074,37.378,24.909,41.159,38,37,0,4,284.33,6,14,12,1.112,0,0,0,4,0,0.158,45.9
4.0,17,17,22.0,3,3.6,10,7,11,17.944,29.484,17.54,31.831,28,28,1,7,241.22,4,5,0,1.137,0,0,0,6,0,0.143,35.7
7.175,37,34,47.5,7,8.5,24,17,25,38.257,60.047,39.563,66.971,62,59,5,10,485.99,9,19,17,1.135,0,1,2,3,1,0.145,40.7
5.71,32,30,44.5,3,10.2,22,18,19,33.247,49.742,34.37,55.306,51,49,5,8,423.91,6,20,17,1.129,1,1,2,1,1,0.118,44.9
5.06,24,23,32.0,4,7.9,15,10,15,25.744,38.742,27.244,42.454,39,38,3,8,349.47,6,10,6,1.117,1,0,0,3,0,0.154,39.5
5.886,31,27,44.5,1,11.4,22,21,17,30.268,43.811,31.597,48.983,48,44,5,5,351.44,4,27,27,1.113,0,0,0,0,0,0.083,50.0
5.33,29,27,41.5,1,9.5,20,18,15,29.701,42.593,30.853,46.745,44,42,4,7,423.29,5,20,17,1.113,1,0,1,2,0,0.114,47.6
5.019,37,35,49.5,7,8.1,26,18,27,40.069,62.603,41.87,70.176,64,62,5,9,496.03,9,20,17,1.132,1,1,2,2,1,0.141,41.9
6.6,27,26,37.0,3,4.7,19,15,17,29.416,43.654,30.972,47.81,44,43,2,7,388.9,7,15,12,1.112,1,1,1,3,0,0.159,44.2
6.42,32,30,45.5,3,8.5,22,16,17,32.943,47.803,34.068,52.369,49,47,4,8,465.33,5,20,17,1.114,3,0,1,3,0,0.102,46.8
6.2,28,25,37.5,3,2.7,19,16,12,27.621,37.913,28.818,40.656,40,37,1,6,392.67,1,18,17,1.099,0,3,3,2,0,0.025,51.4
5.0,26,25,36.0,3,4.7,19,15,18,28.589,43.331,30.114,47.866,44,43,2,6,354.46,7,15,12,1.113,1,0,0,3,0,0.159,44.2
5.347,28,26,40.5,1,9.8,20,18,15,28.986,41.265,30.398,45.535,43,41,4,6,407.29,4,20,17,1.111,1,0,1,1,0,0.093,48.8
5.983,35,32,48.5,5,9.6,24,16,20,36.248,52.211,38.574,57.784,55,52,5,8,506.46,4,20,17,1.111,3,0,1,1,0,0.073,46.2
6.0,38,34,50.5,7,10.7,24,16,22,38.152,56.771,40.006,62.931,60,56,6,10,541.87,6,22,21,1.124,1,1,2,2,0,0.1,42.9
6.936,31,29,42.5,4,8.3,21,15,19,32.47,48.687,33.83,53.785,50,48,4,8,455.34,7,19,17,1.121,2,0,1,3,0,0.14,43.8
6.752,33,31,44.5,7,8.8,24,15,26,36.642,56.785,39.211,64.11,59,57,5,7,480.45,8,19,17,1.125,2,0,1,1,0,0.136,42.1
4.0,20,18,27.5,2,3.2,15,13,13,20.612,31.058,21.483,34.408,33,31,1,3,239.29,2,13,11,1.11,0,0,0,2,0,0.061,48.4
7.42,31,29,42.5,5,9.8,22,15,22,33.588,51.018,35.688,57.279,53,51,5,7,452.39,6,19,17,1.123,2,0,1,1,0,0.113,43.1
4.0,22,20,30.0,2,5.6,17,15,16,23.445,35.716,24.796,40.112,38,36,2,3,264.35,2,14,12,1.114,0,0,0,1,0,0.053,47.2
6.907,33,30,44.5,5,10.0,22,15,20,34.249,50.211,36.574,55.784,53,50,5,8,482.44,4,19,17,1.116,2,0,1,1,0,0.075,44.0
6.0,38,34,50.5,8,11.5,25,16,27,38.847,61.203,40.563,69.059,65,61,7,9,457.59,7,22,21,1.132,1,0,0,2,0,0.108,41.0
4.0,23,21,31.0,2,5.6,17,15,15,23.829,36.229,24.733,40.452,38,36,2,4,282.34,2,14,12,1.124,0,0,1,1,1,0.053,47.2
4.664,26,24,36.5,1,10.3,18,17,15,26.986,39.265,28.398,43.535,41,39,4,6,383.27,4,19,17,1.116,0,0,1,1,0,0.098,46.2
7.854,29,27,40.5,3,11.1,20,15,18,30.535,45.251,32.165,50.449,47,45,5,7,424.33,4,19,17,1.121,2,0,1,1,0,0.085,44.4
4.0,21,19,28.5,3,5.7,16,13,16,22.445,34.716,23.796,39.112,37,35,2,3,252.34,1,13,11,1.117,0,0,0,1,0,0.027,45.7
6.0,38,34,50.5,8,10.2,25,16,25,38.653,59.425,40.415,66.505,63,59,6,9,477.01,6,22,21,1.127,1,1,1,2,0,0.095,42.4
6.0,39,35,51.5,8,9.8,25,16,26,39.256,61.756,40.466,68.979,65,61,6,10,474.57,7,22,21,1.131,1,0,0,4,0,0.108,41.0
5.21,29,27,41.0,2,9.3,19,16,16,29.578,43.767,30.602,48.033,45,43,4,8,380.46,6,19,16,1.117,1,0,0,3,0,0.133,44.2
4.467,37,34,49.5,6,8.6,25,18,24,38.545,58.556,40.358,65.113,61,58,5,9,522.44,7,20,17,1.123,1,0,1,3,0,0.115,43.1
5.78,26,25,36.0,3,4.7,19,15,18,28.589,43.331,30.114,47.866,44,43,2,6,354.46,6,15,12,1.113,1,0,0,3,0,0.136,44.2
4.76,27,26,40.0,3,4.8,19,14,16,28.777,42.774,29.807,46.661,43,42,2,7,368.44,5,17,12,1.111,2,0,0,4,0,0.116,45.2
5.726,22,22,25.0,16,1.7,21,5,38,31.767,57.948,36.092,68.18,60,60,1,1,304.6,15,6,6,1.136,0,0,0,0,0,0.25,35.0
7.886,34,32,45.5,5,12.5,22,17,24,36.346,56.549,38.154,63.485,58,56,7,10,498.43,9,20,17,1.134,0,0,1,2,0,0.155,39.3
5.194,21,19,29.5,1,12.1,15,14,14,21.72,32.825,22.83,37.069,35,33,4,4,250.33,2,17,17,1.123,0,0,0,0,0,0.057,45.5
5.8,23,20,32.0,1,10.0,15,14,10,21.911,30.396,22.87,33.207,33,30,3,5,328.18,0,17,16,1.107,0,0,1,1,0,0.0,50.0
5.8,31,28,43.0,1,6.7,22,21,17,30.896,45.473,31.71,50.03,48,45,3,6,371.42,3,21,18,1.112,0,0,0,3,0,0.063,48.9
8.092,37,34,51.0,3,14.5,23,20,21,37.314,55.883,38.637,62.153,58,55,8,11,521.42,9,25,22,1.13,0,0,1,2,0,0.155,41.8
5.483,21,19,29.5,0,13.3,14,14,11,21.02,30.265,21.926,33.598,32,30,4,5,270.74,2,17,17,1.12,0,1,1,0,0,0.063,46.7
6.684,34,32,45.5,5,10.5,23,18,25,36.851,57.331,38.909,64.402,59,57,6,9,497.44,9,20,17,1.13,0,0,1,2,0,0.153,40.4
7.699,48,44,66.0,6,6.6,35,28,32,50.454,76.185,52.909,84.877,80,76,5,9,606.17,11,31,28,1.117,1,1,1,3,0,0.138,46.1
7.161,46,42,64.0,4,8.7,32,27,27,46.895,69.636,48.631,77.129,73,69,6,10,579.1,11,31,28,1.118,1,1,1,3,0,0.151,46.4
6.708,48,44,64.5,7,6.8,33,25,30,49.357,74.956,51.057,82.88,78,74,5,11,612.13,13,27,23,1.12,1,1,1,5,0,0.167,44.6
5.857,49,45,67.5,5,6.5,36,30,32,51.454,77.185,53.909,85.877,81,77,5,9,618.18,11,32,29,1.115,1,1,1,3,0,0.136,46.8
7.092,45,42,60.5,6,7.1,31,24,28,46.694,71.327,48.023,79.141,73,70,5,11,592.09,11,26,23,1.131,1,1,3,3,2,0.151,44.3
5.553,54,50,71.0,4,5.3,34,30,26,54.753,78.429,56.966,84.432,80,76,4,16,938.24,0,29,24,1.111,0,0,4,8,0,0.0,44.7
6.22,53,49,68.5,12,5.6,37,24,40,56.706,89.701,59.319,100.166,93,89,5,12,686.27,11,26,23,1.125,1,1,1,6,0,0.118,41.6
8.0,44,41,59.5,6,7.1,31,24,29,46.755,70.625,49.006,78.405,73,70,5,10,590.55,11,26,23,1.12,1,2,2,3,0,0.151,44.3
7.119,44,41,59.5,7,6.8,32,24,32,47.454,73.185,49.909,81.877,76,73,5,9,570.14,11,26,23,1.122,1,1,1,3,0,0.145,43.8
5.009,46,42,61.5,8,6.8,33,24,32,48.454,74.185,50.909,82.877,78,74,5,9,582.15,10,26,23,1.12,1,1,1,3,0,0.128,44.6
6.391,44,41,59.5,6,7.1,31,24,29,46.755,70.625,49.006,78.405,73,70,5,10,590.55,11,26,23,1.12,1,2,2,3,0,0.151,44.3
6.268,48,44,63.5,9,7.6,34,24,35,51.002,79.17,53.677,88.79,83,79,6,10,611.2,11,26,23,1.124,1,1,1,3,0,0.133,43.0
7.602,47,43,62.5,9,6.5,34,24,34,49.981,77.069,52.671,86.292,81,77,5,9,596.18,11,26,23,1.121,1,1,1,3,0,0.136,44.2
7.131,47,43,65.0,5,8.3,33,27,29,48.894,72.269,51.586,80.255,76,72,6,10,609.2,10,31,28,1.115,1,1,1,2,0,0.132,45.8
5.801,35,30,50.5,1,14.9,23,22,17,32.784,47.131,33.847,52.564,52,47,7,7,391.47,4,31,31,1.118,0,0,0,0,0,0.077,48.9
7.569,45,42,60.5,7,6.8,32,24,32,48.169,74.512,50.364,83.086,77,74,5,10,586.14,13,26,23,1.123,1,1,1,4,0,0.169,43.2
7.357,45,42,60.5,7,6.8,32,24,32,48.169,74.512,50.364,83.086,77,74,5,10,586.14,12,26,23,1.123,1,1,1,4,0,0.156,43.2
5.423,52,48,70.5,7,6.0,38,30,36,55.222,84.28,57.887,93.916,88,84,5,10,662.24,14,32,29,1.118,1,1,1,4,0,0.159,45.2
6.772,48,44,63.5,9,6.4,34,24,34,50.696,78.396,53.125,87.501,82,78,5,10,612.18,11,26,23,1.122,1,1,1,4,0,0.134,43.6
5.876,45,42,60.5,6,7.1,31,24,28,47.138,71.138,48.943,78.745,73,70,5,11,608.54,11,26,23,1.125,1,2,3,3,1,0.151,44.3
7.237,49,45,64.5,9,6.3,34,24,34,51.41,79.723,53.58,88.711,83,79,5,11,628.18,11,26,23,1.123,1,1,1,5,0,0.133,43.0
6.0,32,29,44.5,3,6.0,24,21,21,33.707,49.662,35.972,55.361,53,50,3,5,399.55,5,24,23,1.107,0,0,0,1,0,0.094,48.0
5.284,27,25,36.5,3,12.2,17,14,16,27.997,41.538,29.557,46.056,43,41,5,8,373.9,4,18,17,1.123,0,1,1,1,0,0.093,41.5
5.097,35,32,46.5,5,13.7,20,15,19,33.748,52.905,33.608,58.702,54,51,7,12,443.46,6,22,21,1.151,0,0,2,3,2,0.111,39.2
6.678,38,34,52.0,6,10.0,26,20,26,38.826,60.101,40.557,67.561,64,60,6,8,454.58,8,27,26,1.126,0,0,0,2,0,0.125,43.3
7.886,48,44,66.0,5,8.2,33,27,29,50.081,73.345,53.233,81.175,77,73,6,11,641.27,11,31,28,1.112,1,1,1,2,0,0.143,45.2
5.422,41,38,56.5,4,6.3,29,24,25,42.567,63.76,44.074,70.342,66,63,4,9,529.03,11,26,23,1.117,1,1,1,4,0,0.167,46.0
5.945,51,46,72.0,3,6.8,37,33,28,51.4,74.418,53.387,82.046,79,74,5,9,626.15,10,37,34,1.109,1,1,1,3,0,0.127,50.0
6.644,46,42,64.0,4,8.7,32,27,27,46.895,69.636,48.631,77.129,73,69,6,10,579.1,10,31,28,1.118,1,1,1,3,0,0.137,46.4
7.398,45,41,60.5,7,7.0,32,24,30,46.927,71.301,49.148,79.461,75,71,5,9,568.12,11,26,23,1.119,1,1,1,3,0,0.147,45.1
5.0,16,14,23.5,0,23.8,9,9,7,14.634,21.393,14.79,23.907,23,21,5,5,185.21,0,15,15,1.138,0,0,0,0,0,0.0,42.9
6.983,49,46,64.5,10,6.0,35,24,38,53.464,84.49,56.103,94.541,87,84,5,11,644.23,15,26,23,1.125,1,1,1,5,0,0.172,41.7
6.303,42,39,57.5,6,7.1,31,24,31,45.1,69.978,47.29,78.517,73,70,5,8,521.67,11,26,23,1.122,1,0,0,3,0,0.151,44.3
5.013,36,32,49.0,6,11.9,25,19,27,37.418,58.549,39.654,66.64,63,59,7,7,425.59,8,26,26,1.129,0,0,0,0,0,0.127,42.4
5.0,39,36,49.0,9,9.7,23,14,26,39.264,63.992,39.557,71.283,65,62,6,13,504.55,9,18,16,1.15,0,0,2,5,2,0.138,37.1
5.301,35,32,48.0,4,11.5,23,17,20,34.824,53.032,35.455,59.2,55,52,6,9,434.49,4,23,22,1.138,2,0,2,1,2,0.073,44.2
5.523,26,24,35.0,4,9.8,17,13,17,27.228,41.476,28.614,46.16,43,41,4,7,389.28,6,17,16,1.126,0,0,1,2,0,0.14,41.5
5.8,32,29,44.0,3,10.0,22,19,21,33.223,49.982,35.222,55.943,53,50,5,7,403.55,3,23,22,1.119,0,0,0,1,0,0.057,44.0
5.143,26,24,35.0,5,9.1,18,13,20,27.73,44.131,29.023,49.734,46,44,4,6,324.42,7,17,16,1.13,0,0,0,2,0,0.152,40.9
7.252,33,30,44.5,4,7.7,23,19,22,33.971,52.342,35.239,58.358,55,52,4,7,402.49,7,23,23,1.122,0,0,0,3,0,0.127,44.2
5.481,29,26,40.0,4,13.6,18,14,18,28.719,44.567,29.512,49.9,47,44,6,8,350.42,6,21,20,1.134,0,0,0,2,0,0.128,40.9
6.301,37,33,51.0,5,12.1,25,20,25,37.606,57.992,39.347,65.434,62,58,7,8,439.57,6,27,26,1.128,0,0,0,1,0,0.097,43.1
6.77,44,39,61.0,4,10.6,30,26,27,43.847,66.203,45.563,74.059,71,66,7,9,517.64,9,33,32,1.122,0,0,0,2,0,0.127,45.5
6.167,36,32,50.0,4,11.1,24,20,22,35.772,54.334,37.034,60.73,58,54,6,8,426.52,7,27,26,1.125,0,0,0,2,0,0.121,44.4
6.137,34,30,47.0,4,11.5,23,19,22,34.058,52.007,35.58,58.521,56,52,6,7,398.51,6,26,26,1.125,0,0,0,1,0,0.107,44.2
7.337,32,30,43.5,5,9.8,22,15,21,33.774,51.625,35.131,57.721,53,51,5,8,425.93,6,19,17,1.132,2,1,2,1,1,0.113,43.1
7.745,29,26,35.0,10,5.9,20,10,25,31.003,51.007,32.756,57.69,54,51,3,6,355.48,3,9,6,1.131,0,0,0,3,0,0.056,39.2
5.4,33,31,42.0,8,9.4,20,11,22,34.25,54.422,35.012,60.219,55,53,5,11,447.92,4,14,12,1.136,1,1,1,5,0,0.073,37.7
6.523,33,30,41.0,11,7.1,21,10,26,34.454,56.763,35.671,63.607,59,56,4,9,414.51,4,11,6,1.136,0,0,0,5,0,0.068,37.5
5.9,29,26,41.0,1,9.1,21,20,18,29.488,43.92,30.807,49.109,47,44,4,5,342.43,3,23,22,1.116,0,0,0,1,0,0.064,47.7
7.886,28,25,34.0,9,6.3,19,10,23,29.477,48.123,30.995,54.275,51,48,3,6,341.45,3,9,6,1.131,0,0,0,3,0,0.059,39.6
7.649,43,39,55.5,10,8.2,30,20,34,45.648,72.963,48.057,82.431,77,73,6,9,526.7,8,24,23,1.129,0,0,0,3,0,0.104,41.1
6.851,48,43,63.0,7,5.8,31,24,26,46.799,71.003,47.682,78.298,74,69,4,12,610.68,8,29,28,1.135,0,0,4,3,4,0.108,44.9
5.0,30,27,40.0,5,8.7,19,14,19,29.828,46.971,30.415,52.283,49,46,4,8,370.42,5,20,20,1.137,0,0,1,3,1,0.102,41.3
5.827,26,25,35.0,4,7.0,16,12,18,28.152,44.084,29.432,48.518,44,43,3,9,383.89,6,15,12,1.128,0,1,1,4,0,0.136,37.2
5.8,27,26,38.0,3,11.6,16,12,17,28.314,44.196,29.063,48.74,44,43,5,10,375.45,6,16,12,1.133,1,0,0,4,0,0.136,37.2
4.301,31,28,40.5,4,11.1,19,15,17,30.463,46.123,31.336,51.207,48,45,5,9,401.48,7,18,17,1.138,0,0,2,1,2,0.146,42.2
8.62,25,23,36.5,0,15.2,16,14,10,24.427,33.716,25.12,36.788,35,33,5,7,368.21,3,19,17,1.115,2,0,1,1,0,0.086,48.5
5.827,32,31,43.0,7,7.3,20,12,24,34.83,56.283,36.012,62.322,56,55,4,11,448.55,8,16,12,1.133,1,0,0,6,0,0.143,36.4
4.955,28,26,37.5,3,11.6,18,15,17,29.362,43.574,31.023,48.393,45,43,5,8,434.75,4,18,17,1.125,0,1,2,1,0,0.089,41.9
6.108,34,31,48.0,1,6.3,25,22,17,34.204,48.538,35.358,53.31,51,48,3,6,429.9,5,25,24,1.111,2,1,2,1,1,0.098,52.1
5.0,30,27,41.0,4,8.2,22,18,22,31.542,48.687,33.33,54.939,52,49,4,5,358.48,6,22,22,1.121,0,0,0,1,0,0.115,44.9
6.432,28,26,37.0,5,10.9,18,13,20,30.54,46.051,33.881,51.663,48,46,5,8,481.4,6,17,16,1.123,0,0,1,1,0,0.125,39.1
7.161,40,37,55.0,3,10.2,27,22,22,40.51,60.054,41.591,66.429,62,59,6,10,517.0,7,26,24,1.126,2,1,2,2,1,0.113,45.8
7.658,43,39,59.0,5,6.1,29,24,27,44.281,66.72,46.483,73.677,70,66,4,10,563.12,11,30,28,1.116,0,1,1,4,0,0.157,43.9
7.187,34,32,45.5,7,8.8,24,15,25,36.827,57.392,38.654,64.552,59,57,5,8,453.99,6,19,17,1.132,2,1,2,1,1,0.102,42.1
7.495,43,40,60.0,4,6.3,29,23,24,44.137,65.349,45.659,71.602,67,64,4,11,579.09,9,28,24,1.119,2,1,2,4,1,0.134,45.3
7.046,30,28,38.0,8,11.3,19,11,25,33.615,52.92,37.409,59.992,55,53,6,9,512.47,8,16,16,1.132,0,0,1,1,0,0.145,35.8
6.678,30,28,38.0,8,11.3,19,11,25,33.615,52.92,37.409,59.992,55,53,6,9,512.47,9,16,16,1.132,0,0,1,1,0,0.164,35.8
6.745,29,27,37.0,7,12.0,18,11,23,32.088,50.036,35.648,56.577,52,50,6,9,498.44,8,16,16,1.132,0,0,1,1,0,0.154,36.0
7.921,35,32,49.0,1,12.5,23,20,16,34.215,49.076,34.853,53.974,51,48,6,9,446.9,5,25,24,1.124,2,1,2,1,1,0.098,47.9
7.638,33,31,44.5,6,9.3,23,15,23,35.301,54.509,36.892,61.137,56,54,5,8,439.96,7,19,17,1.132,2,1,2,1,1,0.125,42.6
5.456,27,25,35.0,6,10.9,17,11,21,28.938,46.309,30.676,52.152,48,46,5,8,359.5,7,16,16,1.134,0,0,0,2,0,0.146,37.0
4.301,33,30,44.5,6,13.7,21,14,21,33.267,51.552,34.279,57.813,54,51,7,9,403.49,6,19,17,1.134,1,0,0,2,0,0.111,41.2
6.0,34,32,45.5,7,10.7,23,14,24,36.322,56.611,37.898,63.635,58,56,6,9,454.98,6,19,17,1.136,2,1,2,1,1,0.103,41.1
5.8,22,20,29.5,5,8.1,14,9,17,23.369,37.222,24.904,41.74,39,37,3,6,291.41,2,13,11,1.128,0,0,0,2,0,0.051,37.8
7.585,46,42,62.0,7,5.6,31,24,30,47.718,73.0,49.943,80.847,76,72,4,11,609.17,13,30,28,1.123,0,1,2,4,1,0.171,43.1
5.0,32,30,41.0,7,9.8,18,11,21,32.661,52.872,33.222,58.665,53,51,5,12,441.51,6,15,12,1.15,0,0,2,4,2,0.113,35.3
7.658,47,43,65.0,6,7.1,31,24,27,47.686,71.334,49.426,78.515,74,70,5,12,620.15,12,31,28,1.122,1,1,2,4,1,0.162,44.3
7.0,43,39,59.0,5,6.1,29,24,27,44.479,66.625,46.978,73.575,70,66,4,10,607.57,11,30,28,1.115,0,0,1,4,0,0.157,43.9
5.8,25,22,33.0,6,12.2,17,11,19,25.795,40.694,27.358,46.398,44,41,5,5,293.41,3,16,16,1.132,0,0,0,0,0,0.068,41.5
5.0,32,29,43.0,2,8.9,21,19,16,32.33,45.644,34.171,49.917,48,45,4,8,443.38,4,20,18,1.109,0,2,2,1,0,0.083,46.7
6.638,30,27,35.0,12,7.3,20,8,28,32.552,54.992,34.523,62.604,58,55,4,7,372.52,3,8,6,1.138,0,0,0,3,0,0.052,36.4
6.699,46,42,62.0,6,5.8,30,24,27,46.13,70.818,47.199,78.168,73,69,4,12,596.68,11,30,28,1.133,0,0,3,4,3,0.151,43.5
6.509,40,37,52.5,8,5.8,29,21,32,43.32,69.087,45.5,77.644,72,69,4,8,500.65,9,24,23,1.125,0,0,0,4,0,0.125,42.0
5.8,38,34,49.0,10,6.5,26,14,28,39.739,62.069,42.171,69.524,66,62,4,8,476.65,7,18,16,1.121,2,0,0,3,0,0.106,41.9
7.26,51,46,63.5,13,7.1,34,21,38,52.71,84.967,54.671,95.565,89,84,6,12,632.78,10,24,23,1.138,0,0,2,4,2,0.112,40.5
6.721,49,45,64.5,9,7.8,33,22,32,50.129,78.316,51.387,87.32,81,77,6,12,614.71,8,26,23,1.134,2,0,2,4,2,0.099,42.9
6.923,45,42,60.5,9,6.5,33,22,35,48.868,77.072,51.267,86.557,80,77,5,9,565.73,10,26,23,1.124,2,0,0,4,0,0.125,42.9
7.367,42,37,55.0,8,12.1,27,19,29,42.064,66.374,43.813,75.103,71,66,8,10,500.64,7,26,26,1.138,0,0,1,1,1,0.099,40.9
7.328,36,32,49.0,4,13.0,23,19,22,35.462,54.621,36.523,61.359,58,54,7,9,431.52,8,26,26,1.136,0,0,1,1,1,0.138,42.6
7.444,37,33,48.0,7,11.9,24,17,26,37.96,59.2,39.966,66.794,63,59,7,9,464.02,7,22,22,1.132,0,1,1,1,0,0.111,40.7
6.854,33,28,48.5,0,14.3,22,22,14,30.236,42.145,31.08,46.651,47,42,6,6,362.42,2,31,31,1.111,0,0,0,0,0,0.043,52.4
6.959,37,33,50.0,5,12.3,24,19,24,36.989,57.505,38.284,64.774,61,57,7,9,445.55,8,26,26,1.136,0,0,1,1,1,0.131,42.1
6.444,38,33,51.0,6,12.3,25,19,24,37.274,57.178,38.83,64.565,62,57,7,8,441.56,6,26,26,1.133,0,0,1,0,1,0.097,43.9
7.42,41,36,54.0,8,12.3,27,19,29,41.349,65.047,43.358,73.893,70,65,8,9,484.64,7,26,26,1.137,0,0,1,0,1,0.1,41.5
7.268,41,36,54.0,8,12.3,27,19,29,41.349,65.047,43.358,73.893,70,65,8,9,484.64,7,26,26,1.137,0,0,1,0,1,0.1,41.5
7.569,40,35,53.0,7,12.9,26,19,27,39.822,62.163,41.597,70.478,67,62,8,9,470.61,6,26,26,1.137,0,0,1,0,1,0.09,41.9
5.8,31,29,39.0,10,10.5,20,10,28,34.54,57.061,36.966,64.896,59,57,6,9,416.61,9,14,12,1.139,0,0,0,2,0,0.153,35.1
7.119,40,35,53.0,7,12.9,26,19,27,39.822,62.163,41.597,70.478,67,62,8,9,470.61,7,26,26,1.137,0,0,1,0,1,0.104,41.9
6.77,42,37,55.0,8,12.1,27,19,29,42.064,66.374,43.813,75.103,71,66,8,10,500.64,7,26,26,1.138,0,0,1,1,1,0.099,40.9
4.301,20,19,27.5,3,12.9,12,8,12,20.337,31.924,20.432,35.282,32,31,4,7,260.28,4,12,11,1.138,1,0,0,3,0,0.125,38.7
4.959,15,14,22.5,0,21.1,9,8,5,14.44,19.615,14.642,21.352,20,19,4,5,204.63,1,12,11,1.124,1,1,1,0,0,0.05,47.4
4.78,23,21,33.5,0,13.3,15,14,9,21.764,30.898,21.699,33.788,32,30,4,6,280.28,3,18,17,1.126,1,0,1,1,1,0.094,50.0
7.367,41,36,54.0,8,12.3,27,19,29,41.349,65.047,43.358,73.893,70,65,8,9,484.64,6,26,26,1.137,0,0,1,0,1,0.086,41.5
7.119,41,36,54.0,7,12.7,26,19,27,40.537,63.49,42.052,71.688,68,63,8,10,486.61,6,26,26,1.138,0,0,1,1,1,0.088,41.3
7.155,39,34,52.0,6,13.6,25,19,25,38.296,59.28,39.836,67.063,64,59,8,9,456.58,6,26,26,1.137,0,0,1,0,1,0.094,42.4
6.377,34,30,47.0,3,12.2,22,19,19,32.914,49.636,33.756,55.445,53,49,6,8,402.47,6,26,26,1.132,0,0,1,1,1,0.113,44.9
7.745,37,33,51.0,3,11.5,23,20,19,35.344,53.291,35.665,58.864,56,52,6,10,446.48,8,27,26,1.132,0,0,1,3,1,0.143,44.2
7.046,36,32,49.0,4,13.0,23,19,22,35.462,54.621,36.523,61.359,58,54,7,9,431.52,8,26,26,1.136,0,0,1,1,1,0.138,42.6
6.509,31,27,44.0,2,15.9,20,18,17,29.784,44.131,30.847,49.564,48,44,7,7,355.44,4,26,26,1.126,0,0,0,0,0,0.083,45.5
6.602,31,27,44.0,2,15.9,20,18,17,29.784,44.131,30.847,49.564,48,44,7,7,355.44,4,26,26,1.126,0,0,0,0,0,0.083,45.5
5.032,33,29,44.5,5,13.5,22,17,23,33.364,51.781,35.131,58.81,56,52,7,7,385.52,4,22,21,1.131,0,0,0,0,0,0.071,42.3
4.0,22,20,33.0,0,20.0,14,13,10,21.182,30.378,21.557,33.82,32,30,6,6,262.3,3,18,16,1.127,1,0,0,0,0,0.094,46.7
6.886,41,36,54.0,8,10.8,27,19,29,41.374,65.087,43.324,73.474,70,65,7,9,483.63,8,26,26,1.13,0,0,0,2,0,0.114,41.5
5.8,30,27,42.0,1,8.9,21,20,18,30.675,44.996,32.455,50.029,48,45,4,6,374.5,3,23,22,1.112,0,0,0,1,0,0.063,46.7
5.8,30,27,42.0,0,9.5,20,20,15,29.976,42.436,31.551,46.558,45,42,4,7,394.91,3,23,22,1.109,0,1,1,1,0,0.067,47.6
4.0,32,28,46.0,1,11.1,22,21,17,30.983,45.138,32.051,50.192,49,45,5,6,367.44,4,27,26,1.115,0,0,0,1,0,0.082,48.9
4.0,29,26,42.5,1,15.0,19,17,14,27.95,40.473,28.534,44.86,43,40,6,7,342.39,4,23,21,1.122,1,0,0,1,0,0.093,47.5
6.854,42,37,55.0,8,10.8,27,19,28,41.757,65.6,43.262,73.814,70,65,7,10,501.62,8,26,26,1.136,0,0,1,2,1,0.114,41.5
6.602,43,38,56.0,8,10.6,27,19,28,42.472,66.927,43.716,75.023,71,66,7,11,517.62,9,26,26,1.137,0,0,1,3,1,0.127,40.9
6.42,40,35,53.0,7,13.1,25,18,26,39.342,61.421,40.807,69.142,66,61,8,10,470.59,8,26,26,1.133,0,0,0,2,0,0.121,41.0
6.921,40,37,49.5,14,5.3,29,15,38,44.9,74.738,47.785,84.889,78,75,4,8,506.71,10,18,17,1.132,0,0,0,4,0,0.128,38.7
6.678,47,43,62.5,9,6.7,33,22,32,49.169,75.512,51.364,84.086,79,75,5,10,598.15,8,26,23,1.121,2,1,1,4,0,0.101,44.0
6.1,29,26,41.0,0,15.0,18,18,14,27.665,40.8,27.989,45.069,43,40,6,8,346.38,5,23,22,1.127,0,0,0,2,0,0.116,45.0
4.301,18,17,25.5,2,14.8,11,8,10,18.096,27.713,18.216,30.658,28,27,4,6,230.25,3,12,11,1.135,1,0,0,2,0,0.107,40.7
6.292,42,37,55.0,8,10.8,27,19,28,41.757,65.6,43.262,73.814,70,65,7,10,501.62,8,26,26,1.136,0,0,1,2,1,0.114,41.5
4.0,31,28,43.5,2,11.1,20,18,17,30.412,45.793,30.96,50.611,48,45,5,8,375.42,6,23,21,1.125,0,0,0,3,0,0.125,44.4
7.689,43,39,55.5,8,10.3,28,20,29,43.668,68.996,44.961,77.569,72,68,7,11,533.64,6,24,23,1.141,0,0,2,2,2,0.083,41.2
6.509,42,37,56.0,7,12.5,27,20,27,41.537,64.49,43.052,72.688,69,64,8,10,498.62,7,27,26,1.136,0,0,1,1,1,0.101,42.2
7.131,41,36,54.0,8,12.3,27,19,29,41.349,65.047,43.358,73.893,70,65,8,9,484.64,6,26,26,1.137,0,0,1,0,1,0.086,41.5
5.8,35,31,45.5,9,8.9,24,14,25,35.805,56.0,37.551,63.062,60,56,5,7,415.54,7,18,17,1.126,1,0,0,2,0,0.117,42.9
4.0,37,32,53.5,1,12.5,24,23,16,34.192,48.683,34.75,53.485,53,48,6,8,420.46,4,32,31,1.114,0,0,0,2,0,0.075,50.0
6.921,44,39,59.0,8,11.8,27,19,29,43.966,68.778,45.915,77.232,73,68,8,12,548.71,7,28,26,1.136,0,0,1,2,1,0.096,39.7
5.0,36,32,49.0,6,12.3,24,18,25,36.606,56.992,38.347,64.434,61,57,7,8,427.56,8,26,26,1.13,0,0,0,1,0,0.131,42.1
5.971,40,35,53.0,8,14.1,26,18,29,40.461,63.752,42.665,72.637,69,64,9,9,467.64,6,26,26,1.135,0,0,0,0,0,0.087,40.6
4.0,34,30,47.0,4,13.7,22,18,21,33.552,51.225,34.824,57.604,55,51,7,8,399.5,6,26,26,1.129,0,0,0,1,0,0.109,43.1
6.0,34,29,49.5,1,13.3,23,22,16,31.762,45.029,32.841,50.066,50,45,6,6,376.45,2,31,31,1.113,0,0,0,0,0,0.04,51.1
4.0,31,27,44.0,2,14.0,20,18,16,29.477,43.356,30.296,48.275,47,43,6,7,356.42,4,26,26,1.123,0,0,0,1,0,0.085,46.5
5.418,36,32,49.0,3,14.6,21,18,16,33.175,49.88,32.875,55.208,52,48,7,11,439.44,5,26,26,1.15,0,0,3,1,3,0.096,43.8
4.0,38,33,53.5,4,12.5,26,22,23,37.364,55.781,39.131,62.81,61,56,7,7,433.56,5,31,31,1.122,0,0,0,0,0,0.082,46.4
7.201,40,35,53.0,7,11.5,26,19,26,39.516,61.389,41.046,69.189,66,61,7,9,471.59,6,26,26,1.134,0,0,1,1,1,0.091,42.6
5.83,40,36,51.0,9,10.8,25,16,29,40.804,65.741,42.233,73.893,69,65,7,11,491.61,10,22,22,1.137,0,0,0,4,0,0.145,38.5
4.767,38,34,49.0,7,8.3,25,18,26,38.874,60.534,40.625,67.631,64,60,5,9,480.01,6,19,16,1.127,0,1,1,3,0,0.094,41.7
7.046,39,35,53.5,5,11.7,26,21,25,39.321,60.32,40.801,67.644,64,60,7,9,467.58,7,28,27,1.127,0,0,0,2,0,0.109,43.3
7.658,31,28,43.0,2,14.9,20,18,19,31.025,47.342,32.063,53.189,50,47,7,8,373.46,6,23,22,1.132,0,0,0,1,0,0.12,42.6
6.254,20,19,27.0,1,16.1,12,11,12,20.954,31.6,21.881,35.203,32,31,5,7,322.19,4,13,12,1.136,0,0,1,1,0,0.125,38.7
7.602,34,31,46.0,4,13.2,22,18,22,34.462,53.621,35.523,60.359,56,53,7,9,419.51,7,23,22,1.139,0,0,1,1,1,0.125,41.5
8.155,33,30,45.0,3,14.0,21,18,20,32.936,50.738,33.762,56.944,53,50,7,9,405.48,7,23,22,1.139,0,0,1,1,1,0.132,42.0
7.119,32,29,44.0,2,14.9,20,18,18,31.409,47.854,32.0,53.528,50,47,7,9,391.45,6,23,22,1.139,0,0,1,1,1,0.12,42.6
6.213,41,37,52.0,9,9.1,26,17,29,41.692,67.036,42.926,75.15,70,66,6,11,508.61,10,22,22,1.139,0,0,1,4,1,0.143,39.4
7.658,41,37,53.5,8,7.6,28,20,29,42.288,66.421,43.983,74.312,70,66,5,9,499.62,7,24,23,1.126,0,0,0,4,0,0.1,42.4
6.087,37,33,48.0,7,12.3,23,16,24,37.148,57.643,38.659,64.588,61,57,7,10,465.99,9,22,22,1.133,0,1,1,2,0,0.148,40.4
7.097,39,35,53.5,5,11.7,26,21,25,39.321,60.32,40.801,67.644,64,60,7,9,467.58,7,28,27,1.127,0,0,0,2,0,0.109,43.3
7.569,41,37,53.5,7,7.9,27,20,26,41.588,63.862,43.08,70.84,67,63,5,10,520.03,7,24,23,1.124,0,1,1,4,0,0.104,42.9
5.8,32,29,44.0,2,12.5,21,19,19,31.914,48.636,32.756,54.445,51,48,6,8,390.46,3,23,22,1.134,0,0,1,1,1,0.059,43.8
6.158,39,35,50.0,9,10.9,25,16,29,40.089,64.414,41.779,72.684,68,64,7,10,475.61,9,22,22,1.136,0,0,0,3,0,0.132,39.1
6.587,41,37,53.5,7,7.9,27,20,26,41.588,63.862,43.08,70.84,67,63,5,10,520.03,9,24,23,1.124,0,1,1,4,0,0.134,42.9
7.18,36,33,48.5,4,9.1,24,20,22,36.82,55.767,38.102,61.801,58,55,5,9,463.96,8,24,23,1.124,0,1,1,3,0,0.138,43.6
7.721,41,37,53.5,7,7.9,27,20,26,41.588,63.862,43.08,70.84,67,63,5,10,520.03,8,24,23,1.124,0,1,1,4,0,0.119,42.9
6.883,39,36,51.5,6,8.1,26,20,26,40.588,62.862,42.08,69.84,65,62,5,10,508.02,10,24,23,1.126,0,1,1,4,0,0.154,41.9
7.921,42,37,56.0,7,11.3,26,19,25,41.222,62.723,42.904,69.773,67,62,7,11,515.65,7,27,26,1.125,0,0,0,3,0,0.104,41.9
6.796,42,37,56.0,7,11.3,26,19,25,41.222,62.723,42.904,69.773,67,62,7,11,515.65,7,27,26,1.125,0,0,0,3,0,0.104,41.9
5.8,31,28,43.0,2,12.5,21,19,20,31.531,48.123,32.819,54.106,51,48,6,7,372.47,3,23,22,1.127,0,0,0,1,0,0.059,43.8
6.87,39,35,50.0,8,11.5,24,16,26,39.39,61.854,40.875,69.212,65,61,7,11,496.02,9,22,22,1.135,0,1,1,3,0,0.138,39.3
5.244,104,100,130.0,28,7.0,66,38,85,114.198,188.505,118.415,210.244,189,185,13,34,1428.78,28,38,24,1.136,0,0,0,19,0,0.148,35.7
6.137,107,103,134.0,28,6.9,67,39,85,117.1,191.908,121.518,213.373,192,188,13,36,1488.86,29,39,24,1.135,0,0,0,20,0,0.151,35.6
5.0,21,18,31.0,0,7.1,15,15,10,19.865,28.065,20.512,30.867,31,28,2,3,234.27,1,20,20,1.102,0,0,0,1,0,0.032,53.6
7.638,42,38,51.5,15,7.9,29,14,38,45.702,75.73,48.58,86.261,80,76,6,9,518.73,7,18,17,1.135,0,0,0,3,0,0.088,38.2
7.638,42,38,54.5,8,7.5,28,20,29,43.003,67.749,44.438,75.521,71,67,5,10,515.62,8,24,23,1.127,0,0,0,5,0,0.113,41.8
7.086,40,36,51.0,9,10.9,25,16,28,40.916,64.738,42.637,72.628,68,64,7,11,510.05,10,22,22,1.135,0,1,1,3,0,0.147,39.1
5.8,36,33,47.0,3,14.0,21,18,17,34.085,52.276,33.574,57.963,53,50,7,12,459.45,3,20,18,1.159,0,0,4,1,4,0.057,42.0
5.8,35,32,48.5,3,16.0,22,18,18,34.987,50.763,36.33,56.366,53,50,8,10,465.38,7,24,23,1.127,1,2,2,0,0,0.132,44.0
6.202,44,39,60.5,5,13.6,28,23,27,43.363,66.523,44.813,74.64,71,66,9,11,521.64,10,32,31,1.131,0,0,0,2,0,0.141,42.4
5.8,32,30,41.0,7,10.0,19,11,20,32.723,51.538,33.25,56.804,52,50,5,11,433.89,3,14,12,1.136,1,1,1,5,0,0.058,38.0
6.536,39,36,51.5,6,8.1,26,20,26,40.588,62.862,42.08,69.84,65,62,5,10,508.02,10,24,23,1.126,0,1,1,4,0,0.154,41.9
6.854,43,38,57.5,7,10.8,28,21,27,42.562,65.531,44.017,73.268,70,65,7,10,509.62,7,28,27,1.127,0,0,0,3,0,0.1,43.1
7.071,31,29,43.5,3,10.2,22,17,20,33.061,49.134,34.927,54.864,51,49,5,7,450.37,6,20,17,1.12,2,0,1,1,0,0.118,44.9
6.42,31,29,44.5,2,9.1,21,16,15,31.416,44.92,32.307,48.954,46,44,4,8,451.3,5,20,17,1.113,3,0,1,3,0,0.109,47.7
6.081,112,108,139.0,32,7.4,71,39,95,124.536,206.319,130.12,230.821,207,203,15,37,1559.02,33,39,24,1.137,0,0,0,19,0,0.159,35.0
6.538,35,31,48.5,3,9.6,24,21,21,34.751,52.232,36.029,58.232,56,52,5,7,411.5,6,27,27,1.12,0,0,0,2,0,0.107,46.2
7.921,37,34,48.5,6,10.3,24,18,24,38.037,58.938,39.353,65.844,61,58,6,10,482.99,8,20,17,1.135,0,1,2,2,1,0.131,41.4
5.8,28,26,37.0,5,13.6,17,12,18,28.297,45.149,28.694,50.785,46,44,6,9,360.41,6,17,16,1.154,0,0,2,1,2,0.13,38.6
4.77,22,21,29.0,6,5.1,16,9,18,24.402,39.254,25.466,43.946,40,39,2,5,286.36,3,9,6,1.127,1,0,0,3,0,0.075,41.0
6.135,35,32,45.5,7,8.6,24,17,26,37.357,58.112,39.665,65.319,61,58,5,8,496.45,8,19,17,1.126,0,0,1,2,0,0.131,41.4
4.0,22,20,29.5,4,5.3,17,13,18,23.972,37.6,25.557,42.528,40,38,2,3,266.37,2,13,11,1.119,0,0,0,1,0,0.05,44.7
5.384,37,35,49.5,4,9.4,23,18,18,36.638,55.491,36.398,60.95,55,53,5,12,507.91,7,20,17,1.15,1,1,5,2,4,0.127,43.4
5.0,27,24,35.0,4,4.9,19,15,17,27.514,41.251,28.87,45.681,44,41,2,5,340.83,2,14,12,1.114,0,1,1,2,0,0.045,46.3
5.824,41,37,57.0,4,8.1,27,23,25,41.894,62.48,44.301,69.112,66,62,5,10,531.71,10,30,28,1.115,0,0,0,3,0,0.152,43.5
5.8,31,28,39.0,6,2.1,21,15,20,31.691,48.898,32.75,53.641,51,48,1,7,401.87,2,14,12,1.118,0,1,1,5,0,0.039,43.8
5.108,36,34,48.5,6,8.5,25,18,25,38.542,59.72,40.108,66.761,61,59,5,9,482.0,9,20,17,1.132,1,1,2,2,1,0.148,42.4
5.8,27,26,38.0,4,9.1,17,12,18,28.82,44.978,29.818,49.657,45,44,4,9,374.46,6,16,12,1.129,1,0,0,4,0,0.133,38.6
6.44,41,38,56.5,5,7.5,30,24,29,43.573,67.094,45.529,75.102,70,67,5,8,507.64,10,26,23,1.121,1,0,0,3,0,0.143,44.8
5.301,26,24,34.0,6,11.4,17,11,20,28.353,43.974,31.233,49.743,46,44,5,7,437.32,6,16,16,1.131,0,0,1,1,0,0.13,38.6
6.409,35,31,49.0,3,11.8,23,20,20,34.246,51.451,35.273,57.315,55,51,6,8,412.49,7,27,26,1.124,0,0,0,2,0,0.127,45.1
6.883,42,39,57.0,6,7.5,29,22,28,44.588,67.494,47.034,74.966,70,67,5,10,562.14,11,25,22,1.119,1,1,1,3,0,0.157,43.3
6.553,31,27,36.0,12,7.5,20,8,26,32.025,53.109,33.762,60.189,57,53,4,7,370.5,2,8,6,1.136,0,0,0,3,0,0.035,37.7
4.879,42,39,57.5,6,7.1,31,24,31,45.1,69.978,47.29,78.517,73,70,5,8,521.67,11,26,23,1.122,1,0,0,3,0,0.151,44.3
4.585,44,41,59.5,7,6.8,32,24,32,47.454,73.185,49.909,81.877,76,73,5,9,570.14,11,26,23,1.122,1,1,1,3,0,0.145,43.8
7.056,32,28,45.0,2,13.3,21,19,17,30.673,45.425,31.54,50.821,49,45,6,7,372.44,4,26,26,1.129,0,0,1,0,1,0.082,46.7
6.824,104,100,130.0,27,7.1,65,38,83,113.859,186.697,118.302,207.749,187,183,13,35,1446.82,27,38,24,1.135,0,0,0,19,0,0.144,35.5
7.222,41,36,54.0,7,11.3,26,19,26,40.231,62.716,41.5,70.399,67,62,7,10,487.59,8,26,26,1.135,0,0,1,2,1,0.119,41.9
5.18,22,20,32.5,0,13.3,15,14,10,21.381,30.385,21.762,33.448,32,30,4,5,262.29,3,18,17,1.115,1,0,0,1,0,0.094,50.0
5.0,27,24,38.5,1,12.8,18,17,15,26.456,39.254,27.29,43.777,42,39,5,6,317.38,4,22,21,1.122,0,0,0,1,0,0.095,46.2
4.954,68,62,84.0,21,0.9,47,26,51,71.199,114.774,73.404,126.81,119,113,1,15,853.99,14,25,18,1.122,0,0,0,14,0,0.118,41.6
4.801,31,28,39.0,6,2.1,21,15,20,31.691,48.898,32.75,53.641,51,48,1,7,401.87,2,14,12,1.118,0,1,1,5,0,0.039,43.8
7.469,37,34,49.5,5,8.6,25,20,24,38.347,58.651,39.864,65.216,61,58,5,9,477.99,8,24,23,1.124,0,1,1,3,0,0.131,43.1
5.38,34,30,47.0,4,13.7,22,18,21,33.552,51.225,34.824,57.604,55,51,7,8,399.5,6,26,26,1.129,0,0,0,1,0,0.109,43.1
7.523,37,34,49.5,6,8.2,26,20,27,39.046,61.211,40.767,68.687,64,61,5,8,457.58,7,24,23,1.126,0,0,0,3,0,0.109,42.6
6.959,31,27,44.0,2,13.3,21,19,18,30.289,44.912,31.603,50.481,49,45,6,6,354.45,4,26,26,1.122,0,0,0,0,0,0.082,46.7
6.762,35,32,47.0,5,12.5,23,18,24,35.989,56.505,37.284,63.774,59,56,7,9,433.54,8,23,22,1.139,0,0,1,1,1,0.136,41.1
7.456,41,37,53.5,8,7.6,28,20,29,42.288,66.421,43.983,74.312,70,66,5,9,499.62,7,24,23,1.126,0,0,0,4,0,0.1,42.4
7.108,39,36,51.5,7,7.7,27,20,29,41.288,65.421,42.983,73.312,68,65,5,9,487.61,9,24,23,1.128,0,0,0,4,0,0.132,41.5
8.119,33,30,46.5,1,8.0,24,23,20,33.73,50.131,35.023,55.734,53,50,4,6,396.48,7,25,23,1.115,0,0,0,2,0,0.132,48.0
4.538,10,10,14.0,1,0.0,7,6,6,10.725,16.633,10.648,17.874,16,16,0,3,138.13,1,4,0,1.117,0,0,0,3,0,0.063,43.8
4.0,19,17,26.5,0,7.7,13,13,9,18.692,26.389,19.369,28.811,28,26,2,4,244.69,1,13,11,1.108,0,1,1,1,0,0.036,50.0
5.99,25,24,35.0,2,5.0,18,15,16,27.062,40.447,28.352,44.451,41,40,2,6,340.43,6,15,12,1.111,1,0,0,3,0,0.146,45.0
7.167,33,30,40.0,11,5.3,22,11,27,34.96,57.545,36.426,64.524,60,57,3,8,413.52,4,10,6,1.132,0,0,0,5,0,0.067,38.6
7.119,43,40,58.5,6,7.1,31,24,30,45.927,70.301,48.148,78.461,73,70,5,9,556.11,11,26,23,1.121,1,1,1,3,0,0.151,44.3
7.854,36,34,47.5,7,11.3,24,17,28,39.399,62.316,41.677,70.316,64,62,7,10,526.49,11,20,17,1.134,0,0,1,2,0,0.172,38.7
8.699,38,34,49.5,7,10.2,25,18,25,38.653,59.425,40.415,66.505,63,59,6,9,477.01,7,23,23,1.127,0,1,1,2,0,0.111,42.4
7.276,46,40,59.0,12,10.8,30,18,34,46.449,73.956,48.853,83.803,80,74,8,10,538.72,6,26,26,1.132,0,0,0,2,0,0.075,40.5
6.119,107,103,134.0,28,6.9,67,39,85,117.1,191.908,121.518,213.373,192,188,13,36,1488.86,27,39,24,1.135,0,0,0,20,0,0.141,35.6
5.8,39,35,47.5,14,8.7,27,13,34,42.685,68.512,46.171,78.106,73,69,6,8,513.57,7,17,17,1.132,0,2,2,0,0,0.096,39.1
6.456,103,99,129.0,27,7.1,65,38,83,113.144,185.37,117.847,206.539,186,182,13,34,1430.82,27,38,24,1.135,0,0,0,18,0,0.145,35.7
8.456,36,33,47.5,7,12.5,23,14,23,37.014,56.734,38.637,63.616,59,56,7,10,512.43,5,19,17,1.136,2,0,2,1,1,0.085,41.1
5.74,38,35,53.0,2,7.3,27,23,20,38.467,55.851,39.58,61.433,58,55,4,8,486.96,6,26,24,1.117,2,1,2,2,1,0.103,49.1
6.854,34,31,48.0,1,8.5,24,21,16,33.699,47.756,34.603,52.393,50,47,4,7,430.89,5,25,24,1.115,2,1,2,1,1,0.1,51.1
6.971,40,36,51.0,9,9.2,26,17,29,40.978,65.709,42.472,73.94,69,65,6,10,492.61,9,22,22,1.138,0,0,1,3,1,0.13,40.0
5.921,38,34,52.0,6,10.0,26,20,26,38.826,60.101,40.557,67.561,64,60,6,8,454.58,9,27,26,1.126,0,0,0,2,0,0.141,43.3
6.495,103,99,129.0,27,7.1,65,38,83,113.144,185.37,117.847,206.539,186,182,13,34,1430.82,27,38,24,1.135,0,0,0,18,0,0.145,35.7
7.658,44,39,58.5,7,9.1,29,22,27,43.451,66.825,44.711,74.525,71,66,6,10,526.62,7,28,27,1.129,0,0,1,3,1,0.099,43.9
5.0,33,29,45.5,1,8.9,22,21,16,31.391,45.691,31.955,50.113,49,45,4,7,384.42,4,24,23,1.114,0,0,0,3,0,0.082,48.9
5.945,44,41,61.5,6,8.5,32,24,30,46.594,71.196,48.534,79.6,74,71,6,9,546.68,11,27,23,1.121,2,0,0,3,0,0.149,45.1
5.0,41,38,56.5,5,7.7,29,22,27,42.761,65.538,44.222,72.896,68,65,5,9,509.61,8,26,23,1.121,2,0,0,4,0,0.118,44.6
6.198,32,30,42.5,5,9.3,22,17,24,34.83,54.229,36.904,60.904,56,54,5,8,470.41,9,19,17,1.128,0,0,1,2,0,0.161,40.7
7.148,51,45,64.0,16,10.2,34,18,43,53.578,87.592,56.904,99.962,94,88,9,11,609.86,10,26,26,1.136,0,0,0,2,0,0.106,38.6
7.137,25,23,35.5,0,11.1,17,17,13,25.46,36.382,26.637,40.12,38,36,4,6,369.24,4,19,17,1.114,0,0,1,1,0,0.105,47.2
8.301,40,36,51.5,8,7.8,27,19,28,41.4,64.418,43.387,72.046,68,64,5,9,506.05,8,23,23,1.126,0,1,1,3,0,0.118,42.2
6.851,52,47,71.0,6,5.1,36,30,32,53.245,79.883,55.705,88.263,84,79,4,11,671.24,13,36,34,1.117,0,1,2,4,1,0.155,45.6
6.863,46,43,56.0,16,5.8,32,16,43,51.405,86.261,54.222,97.637,89,86,5,11,593.8,14,16,12,1.135,0,0,0,6,0,0.157,37.2
5.0,27,25,34.5,5,11.9,16,11,17,27.879,42.996,28.983,47.705,44,42,5,9,382.28,4,13,11,1.136,0,2,2,2,0,0.091,38.1
6.833,51,44,64.0,16,10.6,34,18,41,52.336,84.381,55.688,96.337,92,85,9,10,591.84,8,26,26,1.133,0,0,0,1,0,0.087,40.0
6.886,47,42,61.0,9,7.2,30,19,27,46.686,70.334,48.426,77.515,74,69,5,12,608.14,7,24,22,1.123,2,1,2,4,1,0.095,43.5
5.575,49,43,65.0,10,8.0,33,21,32,49.308,75.156,51.944,83.936,81,75,6,10,592.78,7,28,26,1.119,2,0,0,3,0,0.086,44.0
5.801,51,45,65.0,14,11.8,33,19,40,52.546,84.927,55.387,96.63,91,85,10,12,608.83,6,27,26,1.137,0,0,0,2,0,0.066,38.8
7.268,66,59,86.0,13,8.7,43,30,45,67.015,105.116,69.859,117.811,111,104,9,16,822.04,11,37,34,1.133,0,0,2,4,2,0.099,41.3
6.347,46,41,60.0,9,8.8,29,18,27,45.353,69.229,46.813,76.654,73,68,6,12,574.69,7,24,22,1.127,2,0,1,4,1,0.096,42.6
7.398,47,42,61.0,9,7.2,30,19,27,46.686,70.334,48.426,77.515,74,69,5,12,608.14,7,24,22,1.123,2,1,2,4,1,0.095,43.5
6.921,47,42,61.0,9,7.2,30,19,27,46.686,70.334,48.426,77.515,74,69,5,12,608.14,7,24,22,1.123,2,1,2,4,1,0.095,43.5
5.0,48,43,61.5,12,5.2,32,20,34,50.216,77.578,53.387,86.282,82,77,4,11,641.67,7,22,17,1.121,0,2,2,4,0,0.085,41.6
7.071,51,45,69.0,8,9.9,30,20,26,48.749,72.851,50.159,79.867,77,71,7,15,647.77,6,30,26,1.125,2,0,1,5,1,0.078,42.3
6.745,47,41,62.5,9,10.3,29,18,27,45.936,68.683,48.313,76.108,74,68,7,12,585.77,6,27,25,1.119,2,0,0,3,0,0.081,42.6
4.8,13,12,19.0,0,15.8,8,8,7,12.833,19.4,12.994,21.535,20,19,3,4,161.18,1,11,10,1.133,0,0,0,1,0,0.05,42.1
7.495,46,41,60.0,9,7.4,30,19,27,45.971,69.007,47.972,76.306,73,68,5,11,592.14,7,24,22,1.122,2,1,2,3,1,0.096,44.1
5.8,26,23,34.0,4,14.3,15,11,12,23.891,36.465,23.648,40.587,38,35,5,8,319.32,3,16,16,1.16,0,0,3,0,3,0.079,42.9
6.585,49,43,65.5,8,8.5,32,22,28,47.969,71.716,49.875,79.315,77,71,6,11,592.73,6,29,27,1.117,2,0,0,4,0,0.078,45.1
6.18,49,43,63.0,13,11.3,32,19,37,49.997,79.941,52.62,90.716,86,80,9,11,579.78,6,27,26,1.134,0,0,0,2,0,0.07,40.0
4.0,32,30,42.0,5,9.3,22,17,24,34.632,54.323,36.409,61.006,56,54,5,8,425.96,8,19,18,1.13,0,1,1,2,0,0.143,40.7
6.921,49,43,66.5,8,8.7,29,19,26,47.532,70.313,49.864,76.949,75,69,6,14,634.82,6,29,25,1.115,2,0,0,5,0,0.08,42.0
6.678,49,43,65.0,9,8.3,32,21,29,48.165,72.785,50.12,80.86,78,72,6,11,596.74,6,28,26,1.123,2,0,1,3,1,0.077,44.4
4.444,40,36,53.0,6,3.1,29,23,28,41.465,64.327,43.182,71.441,68,64,2,7,484.59,9,24,22,1.116,0,0,0,5,0,0.132,45.3
8.0,44,40,60.0,5,7.7,28,23,25,44.631,66.2,46.858,72.811,69,65,5,12,598.17,11,30,28,1.12,0,1,2,3,1,0.159,43.1
7.222,45,40,59.0,8,9.2,28,18,25,44.27,66.156,45.972,72.843,70,65,6,12,577.11,6,24,22,1.121,2,1,1,4,0,0.086,43.1
6.678,46,40,59.0,12,12.0,30,18,35,46.756,74.73,49.404,85.092,81,75,9,10,537.74,6,26,26,1.135,0,0,0,1,0,0.074,40.0
7.06,45,40,59.0,9,7.2,30,19,29,45.475,69.498,47.631,77.232,74,69,5,10,555.71,7,24,22,1.119,2,0,0,4,0,0.095,43.5
7.222,44,39,58.0,9,7.4,30,19,29,44.76,68.171,47.176,76.022,73,68,5,9,539.71,6,24,22,1.118,2,0,0,3,0,0.082,44.1
6.371,39,35,51.0,7,12.9,25,18,27,39.537,62.49,41.052,70.688,66,62,8,10,474.6,8,23,22,1.14,0,0,1,1,1,0.121,40.3
6.658,44,39,58.0,8,9.2,28,18,26,43.915,65.582,46.307,72.61,70,65,6,11,558.74,6,24,22,1.117,2,0,0,3,0,0.086,43.1
8.097,47,41,61.5,8,5.5,34,26,32,47.605,72.76,50.046,81.434,79,73,4,7,544.7,9,29,29,1.116,0,0,0,3,0,0.114,46.6
7.2,36,33,46.0,6,10.3,23,17,25,37.368,58.752,38.87,65.714,61,58,6,10,468.99,7,19,18,1.133,0,1,1,3,0,0.115,39.7
5.222,40,36,50.5,11,10.4,26,15,31,41.924,67.363,44.188,76.379,71,67,7,10,512.09,8,18,15,1.14,0,1,2,1,1,0.113,38.8
5.0,33,29,44.0,5,11.8,22,17,22,33.53,50.756,35.773,57.231,55,51,6,7,402.57,4,22,22,1.122,0,0,0,0,0,0.073,43.1
5.86,33,31,43.5,7,7.3,21,14,24,35.423,56.022,37.205,62.392,57,55,4,10,467.01,11,19,17,1.134,0,1,2,3,1,0.193,38.2
6.833,41,38,56.5,7,5.9,27,20,30,43.882,68.683,46.489,76.278,71,68,4,11,554.75,13,27,23,1.122,0,0,0,5,0,0.183,39.7
5.0,35,31,48.5,2,14.0,22,20,19,34.213,50.418,35.711,56.109,54,50,7,9,429.55,6,27,27,1.122,0,0,0,1,0,0.111,44.0
5.815,37,34,47.0,7,8.3,24,17,26,38.588,60.862,40.08,67.84,63,60,5,10,484.0,10,19,18,1.131,0,1,1,4,0,0.159,40.0
6.11,35,32,48.0,1,9.6,24,23,20,35.578,52.556,36.887,58.176,55,52,5,8,445.94,7,25,24,1.119,0,1,1,2,0,0.127,46.2
4.0,39,36,52.0,4,8.1,27,23,26,40.874,62.534,42.625,69.631,65,62,5,9,504.03,10,25,24,1.123,0,1,1,3,0,0.154,43.5
5.0,35,31,47.0,5,9.3,24,19,23,35.278,54.116,36.79,60.647,58,54,5,7,413.52,5,23,22,1.123,0,0,0,2,0,0.086,44.4
5.022,33,30,45.0,4,9.4,23,19,23,34.278,53.116,35.79,59.647,56,53,5,7,401.51,7,23,22,1.125,0,0,0,2,0,0.125,43.4
7.796,41,37,55.0,5,8.6,26,19,21,40.39,59.356,41.688,65.06,62,58,5,11,538.04,7,24,22,1.122,2,1,2,3,1,0.113,44.8
6.432,45,40,58.5,9,9.2,27,16,25,43.985,66.483,45.426,73.053,70,65,6,13,581.1,6,23,21,1.124,2,1,1,5,0,0.086,41.5
7.398,43,39,57.0,7,7.8,28,19,25,43.444,65.123,45.21,71.891,68,64,5,11,566.1,8,24,22,1.123,2,1,2,3,1,0.118,43.8
5.0,33,29,46.5,1,12.8,22,21,18,32.476,46.989,34.25,52.401,51,47,6,7,398.53,5,27,27,1.115,0,0,0,0,0,0.098,46.8
5.0,27,24,38.0,1,12.8,18,17,15,26.928,39.003,28.483,43.488,42,39,5,6,333.45,4,22,22,1.115,0,0,0,0,0,0.095,46.2
5.796,31,27,44.0,1,11.9,20,19,15,29.643,42.331,30.938,46.697,46,42,5,7,373.47,4,26,26,1.112,0,0,0,1,0,0.087,47.6
5.0,31,27,44.0,1,11.9,20,19,15,29.643,42.331,30.938,46.697,46,42,5,7,373.47,4,26,26,1.112,0,0,0,1,0,0.087,47.6
5.0,37,34,47.0,8,9.5,25,17,29,39.707,63.192,41.938,71.335,66,63,6,9,481.05,9,19,18,1.132,0,1,1,2,0,0.136,39.7
5.0,27,24,38.0,1,10.0,19,18,16,27.434,39.785,29.239,44.404,43,40,4,5,332.46,4,22,22,1.11,0,0,0,0,0,0.093,47.5
5.959,29,26,41.0,1,9.5,20,19,16,29.148,42.113,30.693,46.614,45,42,4,6,360.47,4,23,22,1.11,0,0,0,1,0,0.089,47.6
5.0,43,39,56.0,7,11.8,27,20,29,43.494,69.029,44.722,77.522,72,68,8,12,532.64,8,24,22,1.14,0,0,1,3,1,0.111,39.7
7.699,43,39,57.0,7,7.8,28,19,25,43.444,65.123,45.21,71.891,68,64,5,11,566.1,8,24,22,1.123,2,1,2,3,1,0.118,43.8
7.45,43,39,57.0,7,7.8,28,19,25,43.444,65.123,45.21,71.891,68,64,5,11,566.1,7,24,22,1.123,2,1,2,3,1,0.103,43.8
5.0,68,61,88.0,14,8.3,44,30,47,69.256,109.327,72.075,122.435,115,108,9,17,852.07,12,37,34,1.134,0,0,2,5,2,0.104,40.7
7.461,43,39,57.0,7,7.8,28,19,25,43.444,65.123,45.21,71.891,68,64,5,11,566.1,7,24,22,1.123,2,1,2,3,1,0.103,43.8
7.699,42,38,56.0,6,8.2,27,19,23,41.917,62.24,43.449,68.475,65,61,5,11,552.07,7,24,22,1.123,2,1,2,3,1,0.108,44.3
6.886,43,39,57.0,7,7.8,28,19,25,43.444,65.123,45.21,71.891,68,64,5,11,566.1,8,24,22,1.123,2,1,2,3,1,0.118,43.8
6.658,43,39,57.0,7,7.8,28,19,25,43.444,65.123,45.21,71.891,68,64,5,11,566.1,7,24,22,1.123,2,1,2,3,1,0.103,43.8
5.8,21,19,27.5,2,7.4,12,10,8,19.505,28.556,19.216,30.569,29,27,2,7,282.67,1,12,11,1.132,0,1,2,3,1,0.034,44.4
4.0,37,34,50.0,2,7.4,25,23,20,37.182,55.178,38.034,60.642,57,54,4,9,478.94,9,25,24,1.123,0,1,2,3,1,0.158,46.3
4.0,37,34,50.0,2,8.9,25,23,22,37.82,56.767,39.102,62.801,59,56,5,9,475.97,8,25,24,1.121,0,1,1,3,0,0.136,44.6
5.244,40,37,51.0,7,10.8,25,18,28,41.631,66.065,43.091,73.837,68,65,7,12,526.05,10,20,18,1.136,0,1,1,4,0,0.147,38.5
7.097,40,36,51.5,7,11.3,25,18,26,40.39,62.854,41.875,70.212,66,62,7,11,508.03,9,23,23,1.132,0,1,1,3,0,0.136,40.3
5.0,29,25,42.0,0,10.8,19,19,12,27.567,37.094,29.364,40.494,41,37,4,6,360.49,3,26,26,1.094,0,0,0,0,0,0.073,51.4
6.947,35,31,48.5,1,6.5,23,22,15,34.052,46.807,35.892,50.734,50,46,3,8,468.0,6,27,27,1.103,0,1,2,1,1,0.12,50.0
6.914,37,33,50.5,2,6.0,24,22,17,35.821,51.269,36.915,55.648,54,50,3,9,481.96,7,27,27,1.113,0,1,2,3,1,0.13,48.0
7.167,40,36,55.5,3,9.1,26,22,19,39.149,56.145,40.472,61.436,59,55,5,10,520.02,9,28,27,1.117,1,1,2,2,1,0.153,47.3
6.5,35,31,48.5,1,8.5,23,22,16,33.886,47.833,35.25,52.313,51,47,4,8,450.95,6,27,27,1.113,0,1,2,1,1,0.118,48.9
7.119,39,35,52.5,4,8.6,26,22,23,39.488,58.585,41.54,65.057,62,58,5,9,508.06,8,27,27,1.122,0,1,2,1,1,0.129,44.8
7.167,39,35,52.5,4,8.6,26,22,23,39.488,58.585,41.54,65.057,62,58,5,9,508.06,9,27,27,1.122,0,1,2,1,1,0.145,44.8
5.0,30,26,43.0,0,10.8,19,19,11,28.395,37.418,30.222,40.438,41,37,4,7,394.93,3,26,26,1.093,0,1,1,0,0,0.073,51.4
5.0,30,26,43.0,0,10.8,19,19,11,27.95,37.607,29.301,40.834,41,37,4,7,378.48,3,26,26,1.104,0,0,1,0,1,0.073,51.4
7.509,43,39,58.5,5,6.3,27,22,24,43.797,64.174,46.5,70.232,67,63,4,12,603.21,11,29,27,1.115,0,1,2,3,1,0.164,42.9
5.8,36,33,47.5,4,4.0,22,18,17,34.695,52.407,34.597,56.72,53,50,2,11,478.48,7,22,21,1.134,0,0,3,5,3,0.132,44.0
5.0,37,34,47.0,6,10.5,22,16,23,36.827,58.712,37.097,65.113,60,57,6,12,470.51,7,19,18,1.142,0,0,1,5,1,0.117,38.6
5.0,33,29,46.0,2,10.9,21,19,17,31.885,46.542,33.154,51.322,50,46,5,8,403.5,5,26,26,1.116,0,0,0,2,0,0.1,45.7
5.0,31,27,44.0,1,14.6,19,18,14,29.138,41.549,30.182,45.78,45,41,6,8,374.46,4,26,26,1.117,0,0,0,1,0,0.089,46.3
6.657,43,39,58.5,5,7.8,27,22,25,43.631,65.2,45.858,71.811,68,64,5,12,586.16,11,29,27,1.122,0,1,2,3,1,0.162,42.2
6.836,39,35,52.5,4,7.0,26,22,22,39.181,57.811,40.989,63.768,61,57,4,9,509.04,8,27,27,1.119,0,1,2,2,1,0.131,45.6
6.524,43,39,58.5,5,6.3,27,22,24,43.797,64.174,46.5,70.232,67,63,4,12,603.21,11,29,27,1.115,0,1,2,3,1,0.164,42.9
6.693,35,31,48.5,1,8.5,23,22,16,33.886,47.833,35.25,52.313,51,47,4,8,450.95,6,27,27,1.113,0,1,2,1,1,0.118,48.9
6.602,44,39,57.5,7,7.6,29,22,27,44.256,66.68,46.517,74.096,71,66,5,10,564.13,8,27,27,1.123,0,1,2,2,1,0.113,43.9
6.609,39,35,52.5,4,8.6,26,22,23,39.488,58.585,41.54,65.057,62,58,5,9,508.06,8,27,27,1.122,0,1,2,1,1,0.129,44.8
7.149,43,39,58.5,5,6.3,27,22,24,43.325,64.425,45.307,70.522,67,63,4,12,587.14,11,29,27,1.119,0,1,2,4,1,0.164,42.9
7.066,43,39,58.5,5,6.3,27,22,24,43.325,64.425,45.307,70.522,67,63,4,12,587.14,11,29,27,1.119,0,1,2,4,1,0.164,42.9
7.721,40,36,55.0,3,8.5,27,24,23,39.707,59.771,40.699,66.066,63,59,5,9,481.55,10,29,28,1.12,0,0,0,4,0,0.159,45.8
6.018,25,22,31.0,4,0.0,16,12,14,23.976,37.149,24.057,40.163,39,36,0,6,302.3,0,12,12,1.116,0,0,0,6,0,0.0,44.4
5.0,34,31,47.0,4,13.0,21,17,23,34.981,54.512,36.688,61.149,57,54,7,10,437.58,5,24,22,1.132,0,0,0,2,0,0.088,38.9
8.398,36,32,50.0,2,7.7,25,23,20,35.444,52.458,36.477,57.943,56,52,4,7,424.49,7,28,28,1.114,0,0,0,3,0,0.125,48.1
6.149,35,31,48.5,1,6.5,23,22,15,33.579,47.058,34.699,51.024,50,46,3,8,451.93,6,27,27,1.109,0,1,2,2,1,0.12,50.0
6.955,39,35,52.5,4,8.6,26,22,23,39.488,58.585,41.54,65.057,62,58,5,9,508.06,9,27,27,1.122,0,1,2,1,1,0.145,44.8
8.222,43,39,58.5,5,6.3,27,22,24,43.325,64.425,45.307,70.522,67,63,4,12,587.14,11,29,27,1.119,0,1,2,4,1,0.164,42.9
7.022,43,39,58.5,5,6.3,27,22,24,43.797,64.174,46.5,70.232,67,63,4,12,603.21,11,29,27,1.115,0,1,2,3,1,0.164,42.9
6.815,43,39,58.5,5,7.8,27,22,25,43.631,65.2,45.858,71.811,68,64,5,12,586.16,11,29,27,1.122,0,1,2,3,1,0.162,42.2
5.8,32,29,43.5,2,7.0,20,18,14,30.518,44.76,30.716,48.759,46,43,3,9,417.44,5,22,21,1.134,0,0,3,2,3,0.109,46.5
5.8,31,28,42.5,2,14.0,18,16,15,30.679,43.833,32.449,48.059,46,43,6,10,430.98,6,22,21,1.118,0,1,1,1,0,0.13,41.9
5.8,29,26,37.5,5,13.0,18,13,20,29.718,46.2,31.466,52.026,49,46,6,8,368.51,4,17,17,1.131,0,0,0,1,0,0.082,39.1
6.699,32,29,45.5,0,15.9,17,17,15,30.776,45.382,31.744,49.617,47,44,7,12,429.53,5,24,21,1.128,0,0,0,3,0,0.106,38.6
4.796,26,25,36.0,1,5.6,17,15,11,25.498,38.025,24.756,41.135,37,36,2,8,348.3,3,15,12,1.143,1,0,3,3,3,0.081,47.2
5.9,41,37,55.0,3,7.0,27,24,20,39.897,58.505,40.489,63.851,61,57,4,10,518.96,6,26,24,1.12,0,1,2,4,1,0.098,47.4
7.644,38,35,51.5,5,8.1,27,22,27,40.046,62.211,41.767,69.687,65,62,5,8,469.59,9,25,23,1.124,0,0,0,3,0,0.138,43.5
9.0,36,33,47.5,6,10.3,24,18,25,37.653,58.425,39.415,65.505,61,58,6,9,465.0,9,23,23,1.129,0,1,1,2,0,0.148,41.4
5.8,37,34,49.0,11,7.7,27,15,31,40.385,64.65,42.836,73.308,68,65,5,7,457.63,7,19,16,1.128,1,0,0,2,0,0.103,41.5
5.8,38,35,51.0,9,9.5,26,16,28,40.068,63.312,41.773,71.185,66,63,6,9,472.6,7,20,16,1.13,1,0,0,3,0,0.106,41.3
5.0,25,22,36.0,0,8.8,18,18,12,24.082,34.236,24.762,37.911,37,34,3,4,289.33,2,22,22,1.115,0,0,1,0,1,0.054,52.9
4.772,22,20,30.0,3,2.7,18,15,17,23.951,36.498,25.551,41.029,39,37,1,2,263.36,2,14,12,1.109,0,0,0,1,0,0.051,48.6
7.886,41,37,56.0,4,8.1,28,24,25,41.234,62.654,42.46,69.481,66,62,5,9,495.58,11,29,28,1.121,0,0,0,4,0,0.167,45.2
5.77,38,34,51.5,3,5.6,26,23,20,37.492,54.891,38.546,60.013,58,54,3,8,473.94,5,25,23,1.111,0,1,1,4,0,0.086,48.1
4.602,36,33,46.0,9,3.2,26,17,30,38.992,63.211,40.943,70.856,66,63,2,7,450.58,8,18,16,1.125,0,0,0,5,0,0.121,41.3
4.432,39,35,52.0,5,3.3,28,23,26,39.938,61.443,41.421,68.026,65,61,2,7,470.56,8,24,22,1.115,0,0,0,5,0,0.123,45.9
5.114,37,32,52.0,3,9.8,24,21,19,35.411,51.425,36.915,56.737,56,51,5,8,441.55,5,27,24,1.112,0,0,0,2,0,0.089,47.1
9.0,45,40,63.0,5,8.8,30,25,28,45.255,68.389,47.421,76.105,73,68,6,10,552.71,10,34,32,1.119,0,0,0,3,0,0.137,44.1
5.523,37,33,47.5,9,6.7,25,16,27,37.935,60.505,39.461,67.944,64,60,4,8,450.56,8,21,21,1.132,0,0,1,3,1,0.125,41.7
5.8,23,21,32.0,0,11.8,16,16,13,23.103,34.338,23.767,38.409,36,34,4,5,280.33,4,18,18,1.13,0,0,1,0,1,0.111,47.1
6.409,44,40,59.5,8,8.5,29,21,31,45.692,71.669,47.881,80.275,75,71,6,11,562.73,13,29,27,1.131,0,0,1,3,1,0.173,40.8
5.0,34,31,43.5,11,12.1,21,8,27,35.562,58.531,37.017,66.268,61,58,7,10,425.55,5,16,15,1.143,2,0,0,3,0,0.082,36.2
7.553,35,32,41.0,14,7.7,23,9,33,38.341,65.189,40.506,74.142,68,65,5,9,443.61,5,9,6,1.141,0,0,0,4,0,0.074,35.4
7.056,41,37,56.0,6,6.8,26,18,22,41.083,60.214,43.091,65.897,63,59,4,11,557.11,6,25,22,1.117,2,1,2,3,1,0.095,44.1
7.42,40,36,54.0,6,6.9,27,19,22,40.181,58.811,41.989,64.768,62,58,4,9,521.05,5,24,22,1.117,2,1,2,2,1,0.081,46.6
6.79,35,33,41.0,15,7.1,24,9,37,40.395,69.956,43.029,79.972,72,70,5,9,459.66,10,9,6,1.142,0,0,0,4,0,0.139,34.3
7.268,37,33,50.0,5,7.5,25,18,20,36.939,53.6,38.773,59.143,57,53,4,8,479.01,5,23,22,1.116,2,1,2,1,1,0.088,47.2
5.479,22,21,28.0,1,0.0,13,12,6,22.555,28.898,23.625,29.574,28,27,0,8,406.89,2,12,12,1.095,0,6,6,2,0,0.071,48.1
6.712,36,33,42.0,15,7.4,24,9,35,39.868,68.072,42.267,77.557,71,68,5,9,457.64,5,9,6,1.141,0,0,0,4,0,0.07,35.3
7.886,37,33,50.0,5,7.5,25,18,20,36.939,53.6,38.773,59.143,57,53,4,8,479.01,5,23,22,1.116,2,1,2,1,1,0.088,47.2
6.991,37,34,43.0,16,7.0,25,9,37,41.395,70.956,44.029,80.972,74,71,5,9,471.67,5,9,6,1.14,0,0,0,4,0,0.068,35.2
6.328,26,24,31.0,10,6.1,18,8,25,29.003,49.007,30.756,55.69,51,49,3,6,331.46,3,8,6,1.137,0,0,0,3,0,0.059,36.7
7.745,36,33,42.0,16,5.8,25,9,36,40.374,68.854,43.023,78.474,72,69,4,8,456.65,5,9,6,1.137,0,0,0,4,0,0.069,36.2
6.77,36,33,42.0,16,5.8,25,9,36,40.374,68.854,43.023,78.474,72,69,4,8,456.65,5,9,6,1.137,0,0,0,4,0,0.069,36.2
6.682,36,33,42.0,15,6.0,24,9,34,39.562,67.298,41.716,76.268,70,67,4,9,458.62,5,9,6,1.138,0,0,0,5,0,0.071,35.8
7.174,39,36,45.0,20,3.8,29,9,43,45.459,78.287,49.063,89.637,82,79,3,7,497.75,6,9,6,1.135,0,0,0,4,0,0.073,36.7
7.222,36,33,42.0,16,5.8,25,9,36,40.374,68.854,43.023,78.474,72,69,4,8,456.65,5,9,6,1.137,0,0,0,4,0,0.069,36.2
6.646,36,33,42.0,15,6.0,24,9,34,39.562,67.298,41.716,76.268,70,67,4,9,458.62,5,9,6,1.138,0,0,0,5,0,0.071,35.8
5.8,26,23,36.5,0,9.7,15,15,8,24.293,32.084,25.972,34.009,34,31,3,8,437.23,3,21,21,1.097,0,0,1,3,0,0.088,48.4
7.009,40,36,53.0,7,6.7,27,18,24,40.708,60.694,42.75,67.183,64,60,4,9,523.07,7,23,22,1.12,2,1,2,2,1,0.109,45.0
7.0,37,34,43.0,16,7.0,25,9,37,41.395,70.956,44.029,80.972,74,71,5,9,471.67,5,9,6,1.14,0,0,0,4,0,0.068,35.2
7.824,33,30,45.0,3,15.7,21,18,21,33.242,51.512,34.313,58.233,54,51,8,9,404.5,6,23,22,1.142,0,0,1,0,1,0.111,41.2
6.442,32,29,44.0,2,16.7,20,18,19,31.715,48.629,32.552,54.817,51,48,8,9,390.47,6,23,22,1.142,0,0,1,0,1,0.118,41.7
6.921,41,37,55.0,6,6.8,27,19,22,40.896,60.138,42.443,65.977,63,59,4,10,537.05,6,24,22,1.118,2,1,2,3,1,0.095,45.8
7.959,38,34,51.0,5,7.4,25,18,20,37.654,54.927,39.227,60.353,58,54,4,9,495.01,5,23,22,1.118,2,1,2,2,1,0.086,46.3
6.588,36,33,48.0,3,15.7,21,18,18,34.392,53.05,34.125,59.252,54,51,8,12,458.47,7,23,22,1.162,0,0,4,0,4,0.13,41.2
5.0,38,34,51.0,6,6.5,28,22,28,39.837,61.665,42.069,69.394,66,62,4,6,452.6,6,24,22,1.119,0,0,0,2,0,0.091,45.2
7.081,37,33,49.0,5,14.3,23,18,23,36.484,56.723,37.529,63.857,60,56,8,10,446.54,6,23,22,1.14,0,0,1,1,1,0.1,41.1
6.293,38,34,50.0,6,15.0,24,18,26,38.317,60.381,39.841,68.561,64,60,9,10,459.59,6,23,22,1.143,0,0,1,0,1,0.094,40.0
7.699,47,42,61.0,9,8.6,30,19,28,46.992,71.109,48.978,78.804,75,70,6,12,607.16,7,24,22,1.126,2,1,2,3,1,0.093,42.9
7.456,50,44,66.0,9,9.9,31,20,27,48.043,72.516,49.301,80.283,77,71,7,13,615.72,6,28,26,1.131,2,0,2,3,2,0.078,43.7
7.398,42,38,57.0,6,6.7,26,18,22,41.798,61.542,43.546,67.107,64,60,4,12,573.11,7,25,22,1.118,2,1,2,4,1,0.109,43.3
7.222,48,42,64.0,9,8.3,32,21,30,47.781,72.272,50.182,80.52,78,72,6,10,578.75,6,28,26,1.118,2,0,0,3,0,0.077,44.4
7.046,42,38,56.0,7,6.5,28,19,24,42.423,63.022,44.205,69.392,66,62,4,10,551.08,8,24,22,1.119,2,1,2,3,1,0.121,45.2
6.328,27,25,38.0,1,12.8,18,16,14,27.283,39.578,28.148,43.721,41,39,5,7,351.82,5,19,18,1.121,1,1,1,1,0,0.122,46.2
6.87,43,39,57.0,7,6.3,28,19,24,43.137,64.349,44.659,70.602,67,63,4,11,567.08,9,24,22,1.121,2,1,2,4,1,0.134,44.4
6.097,46,41,60.0,8,7.6,29,19,25,45.631,67.2,47.858,73.811,71,66,5,12,610.18,6,24,22,1.118,2,1,2,3,1,0.085,43.9
7.06,43,39,58.0,7,7.8,27,18,25,43.631,65.2,45.858,71.811,68,64,5,12,586.16,8,25,22,1.122,2,1,2,3,1,0.118,42.2
4.301,44,40,58.0,8,6.8,31,23,33,46.341,73.189,48.506,82.142,77,73,5,9,539.69,8,25,22,1.125,0,0,0,4,0,0.104,42.5
6.886,50,44,66.0,10,9.5,32,20,30,49.186,74.887,51.125,83.358,80,74,7,12,611.76,6,28,26,1.126,2,0,1,3,1,0.075,43.2
6.77,22,20,30.5,1,12.1,15,14,13,22.745,33.054,24.182,36.911,35,33,4,5,329.22,3,17,17,1.119,0,0,1,0,0,0.086,45.5
5.796,51,45,65.0,14,10.7,33,19,39,52.239,84.152,54.836,95.341,90,84,9,12,609.81,8,27,26,1.135,0,0,0,3,0,0.089,39.3
7.495,47,43,63.0,8,7.1,29,19,27,47.588,71.738,49.529,78.645,74,70,5,14,644.2,10,26,22,1.123,2,1,2,5,1,0.135,41.4
7.523,46,41,60.0,9,8.8,29,18,27,45.797,69.04,47.733,76.259,73,68,6,12,591.14,7,24,22,1.121,2,1,1,4,0,0.096,42.6
5.8,18,16,25.5,2,15.4,11,9,10,17.853,26.134,18.955,29.159,28,26,4,5,230.32,0,15,15,1.121,0,0,0,0,0,0.0,42.3
6.745,51,45,67.5,8,8.5,32,22,26,49.18,72.552,50.671,79.598,77,71,6,13,645.16,6,29,27,1.121,2,1,2,4,1,0.078,45.1
7.301,45,41,59.0,9,7.1,30,19,29,46.498,70.891,48.733,78.721,74,70,5,11,594.16,9,24,22,1.125,2,1,2,3,1,0.122,42.9
5.678,53,50,69.0,6,5.0,34,28,30,55.807,82.196,58.489,89.263,83,80,4,16,942.28,13,28,24,1.116,0,0,4,8,0,0.157,42.5
7.367,35,31,48.5,1,6.5,23,22,15,34.052,46.807,35.892,50.734,50,46,3,8,468.0,6,27,27,1.103,0,1,2,1,1,0.12,50.0
7.097,47,42,61.0,9,7.2,30,19,27,46.686,70.334,48.426,77.515,74,69,5,12,608.14,7,24,22,1.123,2,1,2,4,1,0.095,43.5
7.143,64,57,84.0,11,9.2,41,30,41,63.961,99.348,66.336,110.98,105,98,9,16,793.98,10,37,34,1.132,0,0,2,4,2,0.095,41.8
7.301,48,42,64.0,9,9.9,31,20,29,47.276,71.491,49.426,79.604,77,71,7,11,579.74,6,28,26,1.121,2,0,0,3,0,0.078,43.7
5.8,31,28,43.5,1,10.6,22,21,19,31.509,47.022,32.813,52.607,50,47,5,6,369.46,3,24,23,1.119,0,0,0,1,0,0.06,46.8
7.222,45,40,58.5,9,9.2,27,16,25,44.457,66.233,46.619,72.763,70,65,6,13,597.17,7,23,21,1.119,2,1,1,4,0,0.1,41.5
5.8,37,33,51.5,2,14.5,24,22,22,36.574,55.327,37.83,62.102,59,55,8,9,438.54,4,28,27,1.129,0,0,0,1,0,0.068,43.6
5.8,25,22,36.0,1,9.1,16,15,11,23.316,33.822,23.426,36.784,36,33,3,6,293.3,1,19,16,1.115,0,0,0,3,0,0.028,48.5
6.268,46,42,57.0,14,8.5,30,16,40,50.264,82.116,53.853,93.039,86,82,7,12,614.29,9,20,18,1.135,0,1,1,3,0,0.105,36.6
5.155,56,52,72.0,6,5.1,34,28,26,57.33,80.771,60.432,86.531,82,78,4,18,1098.04,0,28,24,1.109,0,0,6,8,0,0.0,43.6
7.523,49,43,65.0,9,9.9,31,20,28,47.659,72.003,49.364,79.943,77,71,7,12,597.73,6,28,26,1.126,2,0,1,3,1,0.078,43.7
6.836,29,27,39.0,1,13.6,18,17,17,29.546,44.891,30.37,49.844,46,44,6,9,384.86,6,19,18,1.133,0,1,1,2,0,0.13,40.9
7.367,43,39,57.0,7,7.8,28,19,25,43.444,65.123,45.21,71.891,68,64,5,11,566.1,8,24,22,1.123,2,1,2,3,1,0.118,43.8
6.11,28,26,38.0,1,9.8,18,17,15,28.218,42.014,28.813,46.057,43,41,4,8,370.82,6,19,18,1.123,0,1,1,3,0,0.14,43.9
5.0,27,24,38.0,1,12.8,18,17,15,26.928,39.003,28.483,43.488,42,39,5,6,333.45,4,22,22,1.115,0,0,0,0,0,0.095,46.2
5.0,42,38,50.0,16,9.1,28,12,39,45.723,76.832,48.586,87.76,81,77,7,10,521.74,7,14,12,1.14,0,0,0,3,0,0.086,36.4
8.0,42,39,55.5,8,5.8,28,20,30,44.718,70.0,46.943,77.847,72,69,4,11,573.14,14,25,23,1.128,0,1,2,4,1,0.194,40.6
6.0,36,33,47.5,4,5.9,22,18,18,35.002,53.182,35.148,58.008,54,51,3,11,477.5,7,22,21,1.137,0,0,3,4,3,0.13,43.1
7.268,40,36,52.0,7,14.1,25,18,28,40.559,64.592,42.057,73.186,68,64,9,11,489.62,8,23,22,1.144,0,0,1,1,1,0.118,39.1
5.0,31,27,44.0,1,9.8,20,19,14,29.809,41.305,31.58,45.119,45,41,4,7,390.52,4,26,26,1.1,0,0,0,1,0,0.089,48.8
7.854,35,31,48.5,1,6.5,23,22,15,33.579,47.058,34.699,51.024,50,46,3,8,451.93,6,27,27,1.109,0,1,2,2,1,0.12,50.0
7.143,39,35,51.0,7,12.9,25,18,27,39.537,62.49,41.052,70.688,66,62,8,10,474.6,8,23,22,1.14,0,0,1,1,1,0.121,40.3
7.0,29,27,39.0,2,9.1,19,17,17,29.745,44.898,30.574,49.472,46,44,4,8,384.85,7,19,18,1.124,0,1,1,3,0,0.152,43.2
8.409,25,23,35.5,0,14.3,16,16,12,24.954,35.6,25.881,39.203,37,35,5,7,370.23,4,19,17,1.12,0,0,1,1,0,0.108,45.7
5.0,36,32,51.5,2,10.2,24,21,17,34.884,49.542,36.154,54.322,53,49,5,8,439.53,6,28,27,1.109,1,0,0,2,0,0.113,49.0
7.167,43,39,57.0,7,7.8,28,19,25,43.444,65.123,45.21,71.891,68,64,5,11,566.1,7,24,22,1.123,2,1,2,3,1,0.103,43.8
7.495,44,40,58.0,8,7.5,29,19,27,44.971,68.007,46.972,75.306,71,67,5,11,580.13,8,24,22,1.124,2,1,2,3,1,0.113,43.3
4.0,32,30,42.0,4,9.6,21,17,22,33.82,52.767,35.103,58.801,54,52,5,9,427.93,9,19,18,1.131,0,1,1,3,0,0.167,40.4
5.775,33,31,45.5,7,7.0,23,14,26,36.212,57.185,38.409,64.109,59,57,4,8,438.6,11,20,17,1.125,2,0,0,3,0,0.186,40.4
5.0,37,34,47.0,7,9.8,24,17,27,38.895,61.636,40.631,69.129,64,61,6,10,483.02,9,19,18,1.133,0,1,1,3,0,0.141,39.3
8.699,36,33,48.5,4,9.1,24,20,22,36.82,55.767,38.102,61.801,58,55,5,9,463.96,8,24,23,1.124,0,1,1,3,0,0.138,43.6
5.509,29,25,42.0,0,13.2,19,19,13,27.401,38.12,28.722,42.072,42,38,5,6,343.44,3,26,26,1.107,0,0,0,0,0,0.071,50.0
5.276,38,36,50.0,8,9.5,22,14,27,39.782,64.883,40.722,72.073,65,63,6,14,522.62,11,20,16,1.144,0,0,1,6,1,0.169,34.9
5.8,34,31,46.0,8,8.9,24,15,25,35.805,56.0,37.551,63.062,59,56,5,7,415.54,4,19,16,1.126,1,0,0,2,0,0.068,42.9
6.047,45,40,61.5,3,6.3,31,28,24,44.708,64.694,46.75,71.183,69,64,4,9,571.11,10,33,33,1.112,0,1,2,2,1,0.145,48.4
4.022,25,22,36.0,1,17.6,15,14,12,23.424,34.589,23.773,38.445,37,34,6,7,292.33,3,21,20,1.131,0,0,0,1,0,0.081,44.1
6.135,27,24,38.5,0,5.0,21,21,16,27.445,39.716,28.796,44.112,43,40,2,3,312.39,4,23,23,1.103,0,0,0,1,0,0.093,52.5
7.0,29,26,34.0,12,5.7,20,8,27,31.53,52.891,33.517,60.106,56,53,3,6,357.5,3,8,6,1.134,0,0,0,3,0,0.054,37.7
5.0,40,35,52.0,10,11.3,23,13,27,39.936,62.683,42.313,70.108,67,62,7,12,513.71,5,22,20,1.131,0,0,0,3,0,0.075,37.1
5.4,33,29,43.0,5,12.0,21,16,21,32.441,50.52,33.517,56.861,54,50,6,8,392.48,2,18,16,1.137,0,0,1,1,1,0.037,42.0
7.004,35,32,41.0,15,6.1,24,9,34,38.847,65.97,41.262,75.059,69,66,4,8,442.62,5,9,6,1.137,0,0,0,4,0,0.072,36.4
6.959,41,37,54.0,8,6.3,28,18,26,42.235,63.578,44.512,70.598,67,63,4,9,537.1,8,23,22,1.121,2,1,2,2,1,0.119,44.4
5.8,21,19,27.5,2,7.1,12,10,9,19.837,29.371,19.733,31.439,30,28,2,7,280.68,1,12,11,1.123,0,1,1,4,0,0.033,42.9
6.83,37,33,49.0,6,13.8,24,18,25,37.296,58.28,38.836,66.063,62,58,8,9,444.57,6,23,22,1.139,0,0,1,0,1,0.097,41.4
5.0,28,25,37.5,4,9.3,19,15,18,28.203,43.247,29.262,48.318,46,43,4,6,334.41,4,18,17,1.124,0,0,0,2,0,0.087,44.2
5.0,39,36,53.0,5,6.3,28,23,28,41.266,64.32,42.978,71.813,67,64,4,8,484.6,7,25,22,1.122,0,0,0,4,0,0.104,43.8
5.889,39,35,54.0,2,12.3,26,24,22,38.462,57.621,39.523,64.359,61,57,7,9,467.55,7,29,28,1.129,0,0,1,1,1,0.115,45.6
7.108,43,39,57.0,7,7.8,28,19,25,43.444,65.123,45.21,71.891,68,64,5,11,566.1,8,24,22,1.123,2,1,2,3,1,0.118,43.8
5.8,25,22,36.0,0,11.8,17,17,12,23.908,34.269,24.523,37.863,37,34,4,5,288.33,2,19,16,1.114,0,0,0,1,0,0.054,50.0
6.174,21,19,29.5,0,13.3,14,14,11,21.218,30.171,22.421,33.496,32,30,4,5,315.19,2,17,17,1.117,0,0,1,0,0,0.063,46.7
8.066,32,29,45.5,0,8.5,23,23,18,32.203,47.247,33.262,52.318,50,47,4,6,382.45,6,25,23,1.113,0,0,0,2,0,0.12,48.9
4.699,33,30,41.5,8,7.4,22,14,24,34.718,54.523,36.597,61.161,57,54,4,8,475.4,6,17,17,1.133,0,0,2,2,1,0.105,40.7
5.605,43,39,52.0,12,1.5,27,15,29,43.259,70.073,43.665,76.615,72,68,1,12,543.57,5,15,12,1.127,0,0,0,11,0,0.069,39.7
5.0,31,29,39.5,8,7.1,22,14,27,34.22,56.178,36.006,63.734,58,56,4,7,398.53,7,14,11,1.138,0,0,1,2,1,0.121,39.3
8.523,26,24,36.5,0,14.3,16,16,11,25.14,36.207,25.324,39.645,37,35,5,8,343.77,4,19,17,1.133,0,1,2,1,1,0.108,45.7
7.585,26,24,36.5,0,14.3,16,16,11,25.338,36.113,25.818,39.543,37,35,5,8,388.22,4,19,17,1.13,0,0,2,1,1,0.108,45.7
4.284,22,20,30.5,1,15.6,14,13,12,22.239,32.273,23.426,35.994,34,32,5,6,330.21,3,17,17,1.125,0,0,1,0,0,0.088,43.8
4.458,25,24,35.0,3,4.8,19,15,18,27.402,42.254,28.466,46.946,43,42,2,5,322.39,6,15,12,1.118,1,0,0,3,0,0.14,45.2
7.4,24,21,31.5,4,8.3,16,12,15,23.655,36.262,24.495,40.405,39,36,3,5,281.34,2,13,11,1.122,0,0,0,2,0,0.051,44.4
6.46,32,29,44.5,2,6.0,24,22,21,33.235,49.912,34.779,55.651,53,50,3,5,383.48,8,24,23,1.113,0,0,0,2,0,0.151,48.0
8.056,25,23,35.5,1,13.2,17,16,15,25.456,38.254,26.29,42.777,40,38,5,6,305.37,4,19,17,1.126,0,0,0,1,0,0.1,44.7
8.959,26,24,36.5,0,14.3,16,16,11,25.338,36.113,25.818,39.543,37,35,5,8,388.22,4,19,17,1.13,0,0,2,1,1,0.108,45.7
5.0,22,21,32.0,1,2.9,17,15,13,23.327,34.385,23.938,37.618,35,34,1,4,279.31,3,15,12,1.106,1,0,0,3,0,0.086,50.0
7.748,37,34,47.5,7,8.5,24,17,25,38.257,60.047,39.563,66.971,62,59,5,10,485.99,9,19,17,1.135,0,1,2,3,1,0.145,40.7
4.878,22,21,32.0,0,3.2,16,15,10,22.183,32.014,22.114,34.542,32,31,1,5,283.27,3,15,12,1.114,1,0,1,3,1,0.094,51.6
6.49,31,29,41.5,6,5.8,22,14,23,33.191,52.451,34.449,58.485,54,52,3,7,393.48,10,18,17,1.125,2,0,0,4,0,0.185,42.3
4.47,24,23,34.0,2,5.1,18,15,16,25.875,39.371,26.705,43.531,40,39,2,5,308.36,3,15,12,1.116,1,0,0,3,0,0.075,46.2
7.442,44,40,60.0,5,6.1,29,24,26,44.664,67.232,46.421,74.017,70,66,4,11,581.11,11,30,28,1.121,0,1,2,4,1,0.157,43.9
5.0,38,33,49.0,9,8.1,27,18,29,39.143,61.44,41.62,69.683,67,62,5,6,439.61,6,22,22,1.124,0,0,0,1,0,0.09,43.5
5.0,41,37,54.5,3,11.3,24,21,16,37.357,56.083,36.205,61.559,57,53,6,13,518.46,5,27,27,1.161,0,0,6,1,6,0.088,45.3
4.431,24,23,34.0,2,5.1,18,15,16,25.875,39.371,26.705,43.531,40,39,2,5,308.36,4,15,12,1.116,1,0,0,3,0,0.1,46.2
4.301,24,23,34.0,3,2.5,19,15,17,26.38,40.153,27.46,44.448,41,40,1,4,307.37,3,15,12,1.111,1,0,0,3,0,0.073,47.5
4.458,20,19,29.5,0,3.6,14,13,9,20.46,28.695,21.063,30.707,29,28,1,5,271.31,3,14,11,1.097,1,0,0,3,0,0.103,50.0
5.8,27,25,39.5,0,13.9,17,16,11,25.832,37.142,25.676,40.365,38,36,5,8,333.33,3,20,17,1.121,1,0,0,3,0,0.079,47.2
4.743,21,20,31.0,0,3.2,16,15,11,21.8,31.502,22.176,34.203,32,31,1,4,265.28,3,15,12,1.103,1,0,0,3,0,0.094,51.6
4.242,23,22,33.0,0,6.1,16,15,11,23.649,33.927,24.04,36.645,34,33,2,6,314.74,3,15,12,1.11,1,1,1,3,0,0.088,48.5
4.758,23,22,33.0,0,3.0,16,15,11,23.229,34.156,23.085,36.621,34,33,1,6,297.28,3,15,12,1.11,1,0,0,5,0,0.088,48.5
5.31,25,23,35.0,2,5.4,18,15,14,25.348,37.487,25.943,41.116,39,37,2,5,306.34,2,15,12,1.111,1,0,0,3,0,0.051,48.6
4.87,23,22,33.0,1,5.6,17,15,14,24.348,36.487,24.943,40.116,37,36,2,5,294.33,4,15,12,1.114,1,0,0,3,0,0.108,47.2
7.745,44,39,57.0,10,11.3,29,19,32,44.922,71.072,47.091,80.388,76,71,8,10,524.69,8,21,16,1.132,0,0,0,2,0,0.105,40.8
5.0,38,33,51.5,5,10.9,25,20,22,36.772,55.334,38.034,61.73,60,55,6,8,438.53,3,24,21,1.122,0,0,0,2,0,0.05,45.5
7.745,45,40,58.0,10,12.3,29,19,33,45.944,73.174,48.097,82.886,78,73,9,11,539.71,10,21,16,1.135,0,0,0,2,0,0.128,39.7
8.42,35,32,41.0,13,7.9,22,9,31,37.529,63.632,39.199,71.936,66,63,5,10,445.58,5,9,6,1.142,0,0,0,5,0,0.076,34.9
7.357,44,39,59.5,6,13.6,28,22,27,43.363,66.523,44.813,74.64,71,66,9,11,521.64,10,26,21,1.131,0,0,0,2,0,0.141,42.4
7.553,45,40,58.0,11,10.8,30,19,34,46.449,73.956,48.853,83.803,79,74,8,10,538.72,10,21,16,1.132,0,0,0,2,0,0.127,40.5
7.523,44,39,57.0,10,11.3,29,19,32,44.922,71.072,47.091,80.388,76,71,8,10,524.69,9,21,16,1.132,0,0,0,2,0,0.118,40.8
7.699,45,40,58.0,11,10.8,30,19,34,46.449,73.956,48.853,83.803,79,74,8,10,538.72,8,21,16,1.132,0,0,0,2,0,0.101,40.5
4.379,22,21,32.0,0,6.1,16,15,12,22.821,33.604,23.182,36.701,34,33,2,5,280.3,3,15,12,1.112,1,0,0,3,0,0.088,48.5
7.678,44,39,57.0,9,11.6,28,19,30,44.11,69.516,45.784,78.182,74,69,8,11,526.66,9,21,16,1.133,0,0,0,3,0,0.122,40.6
7.284,32,30,38.0,13,6.5,22,9,32,36.32,62.087,38.5,70.644,64,62,4,8,416.58,5,9,6,1.139,0,0,0,4,0,0.078,35.5
7.509,33,31,39.0,12,8.1,21,9,31,36.529,62.632,38.199,70.936,64,62,5,10,433.57,5,9,6,1.144,0,0,0,5,0,0.078,33.9
7.959,34,31,41.0,11,6.8,22,11,28,35.981,59.647,37.432,67.023,62,59,4,9,428.54,5,10,6,1.136,0,0,0,5,0,0.081,37.3
6.79,34,32,40.0,14,7.5,23,9,35,38.868,67.072,41.267,76.557,69,67,5,9,445.63,9,9,6,1.143,0,0,0,4,0,0.13,34.3
5.522,24,23,36.0,0,6.1,16,15,10,23.724,34.375,23.33,36.704,34,33,2,7,310.28,4,17,12,1.112,1,0,0,5,0,0.118,48.5
8.367,35,32,42.0,13,6.3,24,11,32,38.32,64.087,40.5,72.644,67,64,4,8,440.6,5,10,6,1.135,0,0,0,4,0,0.075,37.5
8.252,35,32,42.0,12,6.5,23,11,30,37.508,62.531,39.193,70.438,65,62,4,9,442.57,5,10,6,1.136,0,0,0,5,0,0.077,37.1
7.297,38,35,44.0,14,7.6,23,9,31,39.823,67.541,40.836,76.031,69,66,5,12,495.59,5,9,6,1.152,0,0,2,5,2,0.072,34.8
7.81,33,31,40.0,12,6.3,23,11,32,37.32,63.087,39.5,71.644,65,63,4,8,428.59,5,10,6,1.137,0,0,0,4,0,0.077,36.5
7.745,40,37,51.5,7,8.2,25,18,24,40.355,62.887,40.955,69.52,64,61,5,12,531.99,9,20,17,1.14,0,1,3,4,2,0.141,41.0
8.0,37,34,47.0,9,6.3,26,17,30,39.793,64.203,41.739,72.228,67,64,4,8,462.6,5,16,12,1.129,0,0,0,4,0,0.075,40.6
7.377,39,36,50.5,7,8.2,25,18,25,39.972,62.374,41.017,69.18,64,61,5,11,514.0,9,20,17,1.134,0,1,2,4,1,0.141,41.0
7.561,39,36,45.0,17,6.7,26,9,39,43.637,75.167,46.245,85.597,78,75,5,10,501.7,5,9,6,1.141,0,0,0,5,0,0.064,34.7
8.42,36,33,43.0,12,7.8,23,11,31,38.529,64.632,40.199,72.936,67,64,5,10,457.59,5,10,6,1.14,0,0,0,5,0,0.075,35.9
8.071,34,32,41.0,12,6.3,23,11,32,38.035,64.414,39.955,72.853,66,64,4,9,444.59,6,10,6,1.138,0,0,0,5,0,0.091,35.9
8.357,38,35,44.0,16,6.9,25,9,37,42.11,72.283,44.483,82.182,75,72,5,10,487.67,5,9,6,1.141,0,0,0,5,0,0.067,34.7
5.4,37,33,46.5,9,13.1,23,14,28,38.341,61.054,40.762,69.268,65,61,8,10,464.66,7,18,17,1.136,0,0,0,1,0,0.108,37.7
5.0,31,28,41.0,5,9.8,22,17,23,32.563,50.789,34.336,57.438,54,51,5,6,373.5,5,19,18,1.126,0,0,0,1,0,0.093,43.1
5.0,30,26,40.5,4,9.5,19,15,16,28.391,42.691,28.955,47.113,46,42,4,7,348.39,2,21,21,1.122,0,0,0,3,0,0.043,45.2
5.0,27,24,38.5,2,0.0,20,18,16,27.546,40.127,29.102,43.87,43,40,0,4,336.43,3,22,21,1.097,0,0,0,3,0,0.07,50.0
5.0,28,25,39.5,3,0.0,21,18,18,29.073,43.011,30.864,47.285,46,43,0,4,350.46,4,22,21,1.1,0,0,0,3,0,0.087,48.8
5.0,41,38,51.0,9,10.3,26,17,30,42.578,69.392,43.66,78.324,71,68,7,12,529.63,8,19,18,1.152,0,0,3,2,3,0.113,38.2
8.252,34,31,40.0,14,6.3,23,9,32,37.32,63.087,39.5,71.644,66,63,4,8,428.59,5,9,6,1.137,0,0,0,4,0,0.076,36.5
5.0,45,40,58.5,10,8.3,29,19,32,46.023,72.483,48.398,81.145,77,72,6,11,560.74,8,26,25,1.127,0,0,0,4,0,0.104,40.3
7.432,45,40,58.0,11,10.8,30,19,34,46.449,73.956,48.853,83.803,79,74,8,10,538.72,10,21,16,1.132,0,0,0,2,0,0.127,40.5
7.114,45,40,58.0,10,11.1,29,19,32,45.637,72.4,47.546,81.597,77,72,8,11,540.69,10,21,16,1.133,0,0,0,3,0,0.13,40.3
5.691,34,32,42.0,8,6.7,22,14,28,36.696,60.974,37.887,68.232,62,60,4,10,444.54,12,14,12,1.137,0,0,0,6,0,0.194,36.7
5.8,18,16,25.0,0,10.0,10,10,4,16.653,21.022,17.352,21.844,22,20,2,6,271.13,0,12,10,1.092,0,2,2,1,0,0.0,50.0
7.638,44,39,57.0,10,11.3,29,19,32,44.922,71.072,47.091,80.388,76,71,8,10,524.69,9,21,16,1.132,0,0,0,2,0,0.118,40.8
7.658,45,40,58.0,9,11.6,28,19,29,44.494,70.029,45.722,78.522,74,69,8,12,544.65,9,21,16,1.138,0,0,1,3,1,0.122,40.6
8.137,37,34,43.0,15,7.2,24,9,35,40.583,69.4,42.722,78.767,72,69,5,10,473.64,5,9,6,1.142,0,0,0,5,0,0.069,34.8
7.377,35,32,41.0,14,6.3,23,9,32,38.035,64.414,39.955,72.853,67,64,4,9,444.59,5,9,6,1.138,0,0,0,5,0,0.075,35.9
7.352,35,32,41.0,13,7.9,22,9,31,37.529,63.632,39.199,71.936,66,63,5,10,445.58,5,9,6,1.142,0,0,0,5,0,0.076,34.9
7.538,44,39,57.0,10,11.3,29,19,32,44.922,71.072,47.091,80.388,76,71,8,10,524.69,9,21,16,1.132,0,0,0,2,0,0.118,40.8
7.538,36,33,45.0,10,6.3,25,15,30,38.793,63.203,40.739,71.228,66,63,4,8,450.59,5,15,12,1.131,0,0,0,4,0,0.076,39.7
7.939,36,33,42.0,14,7.6,23,9,33,39.056,66.516,40.961,75.351,69,66,5,10,459.61,5,9,6,1.142,0,0,0,5,0,0.072,34.8
7.523,35,32,42.0,12,6.5,23,11,30,37.508,62.531,39.193,70.438,65,62,4,9,442.57,5,10,6,1.136,0,0,0,5,0,0.077,37.1
8.092,39,36,46.0,14,7.2,24,10,33,41.486,70.171,42.87,78.77,72,69,5,12,503.62,6,10,6,1.142,0,0,0,7,0,0.083,34.8
7.155,32,29,38.0,11,7.3,20,9,26,33.454,55.763,34.671,62.607,58,55,4,9,402.5,4,9,6,1.138,0,0,0,5,0,0.069,36.4
4.793,30,28,40.0,4,3.8,23,19,24,32.982,51.905,34.75,58.192,54,52,2,5,376.49,5,19,18,1.119,0,0,0,3,0,0.093,44.2
4.352,24,24,28.0,12,3.7,19,7,30,31.315,53.432,34.603,61.322,54,54,2,5,373.41,10,7,6,1.136,0,2,2,1,0,0.185,35.2
4.643,24,23,31.0,5,4.7,18,13,20,27.681,43.014,29.796,48.246,44,43,2,5,351.3,5,13,12,1.122,0,2,2,1,0,0.114,41.9
4.328,16,15,19.0,7,10.0,10,3,15,18.127,30.011,19.688,34.116,31,30,3,5,225.35,2,3,0,1.137,0,0,0,1,0,0.065,33.3
4.336,20,20,24.0,8,4.8,15,7,22,25.207,41.898,27.557,47.661,42,42,2,5,317.29,5,7,6,1.135,0,2,2,1,0,0.119,35.7
4.301,29,27,39.0,4,3.9,23,19,24,32.74,50.327,35.489,56.693,53,51,2,4,376.56,5,19,18,1.112,0,0,0,1,0,0.094,45.1
4.488,24,23,31.0,5,4.5,18,13,21,28.04,43.767,30.586,49.222,45,44,2,5,348.93,6,13,12,1.119,0,1,1,1,0,0.133,40.9
4.316,22,21,26.0,9,4.7,16,7,22,26.207,42.898,28.557,48.661,44,43,2,5,329.3,5,7,6,1.132,0,2,2,1,0,0.114,37.2
5.851,29,27,39.0,2,4.4,21,19,18,30.897,45.396,32.762,50.147,47,45,2,6,400.93,5,19,18,1.114,0,1,2,1,1,0.106,46.7
5.728,29,27,39.0,2,4.4,21,19,18,31.094,45.302,33.256,50.044,47,45,2,6,445.38,5,19,18,1.112,0,0,2,1,1,0.106,46.7
6.387,25,24,32.0,5,4.5,18,13,20,28.395,44.342,30.25,49.455,45,44,2,6,367.3,6,13,12,1.124,0,2,2,2,0,0.133,40.9
5.635,26,25,33.0,7,4.1,20,13,24,30.734,48.782,33.319,55.076,50,49,2,5,379.36,6,13,12,1.124,0,2,2,1,0,0.12,40.8
4.301,25,24,32.0,5,4.5,18,13,20,29.263,43.902,32.432,48.961,45,44,2,6,472.27,6,13,12,1.113,0,0,2,1,0,0.133,40.9
4.805,29,27,39.0,3,4.2,22,19,21,31.596,47.956,33.665,53.618,50,48,2,5,380.52,5,19,18,1.117,0,0,1,1,1,0.1,45.8
5.016,30,28,40.0,2,4.4,21,19,17,31.252,45.971,32.426,50.38,47,45,2,7,419.3,5,19,18,1.12,0,2,3,2,1,0.106,46.7
5.41,17,16,23.0,1,12.5,10,9,8,16.93,24.873,17.341,27.21,25,24,3,6,237.28,3,9,6,1.134,0,0,1,1,1,0.12,41.7
5.561,17,16,23.0,1,12.5,10,9,8,17.374,24.684,18.261,26.814,25,24,3,6,253.73,3,9,6,1.117,0,1,1,1,0,0.12,41.7
4.813,24,23,31.0,4,5.0,17,13,17,26.537,40.643,27.972,45.171,41,40,2,6,355.26,5,13,12,1.129,0,2,3,1,1,0.122,42.5
5.478,24,23,31.0,4,5.0,17,13,17,26.981,40.454,28.892,44.775,41,40,2,6,371.71,5,13,12,1.119,0,3,3,1,0,0.122,42.5
5.588,24,23,31.0,4,5.0,17,13,17,27.179,40.36,29.387,44.672,41,40,2,6,416.16,5,13,12,1.117,0,2,3,1,0,0.122,42.5
4.566,26,25,35.0,4,7.1,17,13,17,28.078,43.004,29.188,47.333,43,42,3,8,382.27,6,15,12,1.127,0,2,2,3,0,0.14,40.5
4.301,26,25,30.0,11,5.8,18,7,27,30.997,52.094,33.54,59.199,53,52,3,7,388.38,8,7,6,1.138,0,2,2,2,0,0.151,34.6
4.587,24,23,31.0,5,4.7,18,13,20,27.681,43.014,29.796,48.246,44,43,2,5,351.3,6,13,12,1.122,0,2,2,1,0,0.136,41.9
4.301,28,28,32.0,16,3.0,23,7,38,37.422,64.967,41.648,74.983,66,66,2,5,429.53,15,7,6,1.136,0,2,2,1,0,0.227,34.8
4.522,20,20,24.0,8,4.8,15,7,22,25.207,41.898,27.557,47.661,42,42,2,5,317.29,7,7,6,1.135,0,2,2,1,0,0.167,35.7
5.4,36,31,51.0,2,14.0,23,21,19,34.498,50.091,36.256,55.899,55,50,7,8,425.56,4,30,30,1.118,0,0,0,0,0,0.073,46.0
4.989,17,16,23.0,1,12.5,10,9,8,17.572,24.589,18.756,26.712,25,24,3,6,298.18,3,9,6,1.113,0,0,1,1,0,0.12,41.7
4.734,29,27,39.0,3,4.1,22,19,22,31.455,49.022,32.989,54.777,51,49,2,5,362.46,5,19,18,1.118,0,0,0,3,0,0.098,44.9
5.656,30,28,40.0,2,4.3,21,19,18,31.583,46.785,32.943,51.25,48,46,2,7,417.31,5,19,18,1.114,0,2,2,3,0,0.104,45.7
4.498,17,16,23.0,2,11.1,11,9,11,18.073,27.244,19.165,30.285,28,27,3,5,233.32,3,9,6,1.122,0,0,0,1,0,0.107,40.7
5.575,29,27,39.0,2,4.3,21,19,19,30.954,46.367,32.58,51.203,48,46,2,6,427.32,5,19,18,1.113,0,0,1,3,0,0.104,45.7
4.301,25,24,32.0,5,4.5,18,13,20,28.791,44.152,31.239,49.251,45,44,2,6,456.2,6,13,12,1.119,0,0,2,2,0,0.133,40.9
5.428,19,18,25.0,1,12.0,10,9,7,19.312,26.145,20.563,27.763,26,25,3,8,393.07,3,9,6,1.111,0,0,2,2,0,0.115,40.0
5.159,17,16,23.0,1,12.0,10,9,9,17.261,25.687,17.858,28.079,26,25,3,6,235.29,3,9,6,1.123,0,0,0,2,0,0.115,40.0
4.663,17,16,23.0,1,12.5,10,9,8,16.93,24.873,17.341,27.21,25,24,3,6,237.28,3,9,6,1.134,0,0,1,1,1,0.12,41.7
4.301,24,23,31.0,5,4.5,18,13,21,27.766,43.923,29.887,49.409,45,44,2,5,377.31,6,13,12,1.123,0,0,1,2,0,0.133,40.9
4.301,25,24,32.0,7,4.0,20,13,26,29.794,49.461,32.057,56.398,51,50,2,4,326.48,6,13,12,1.128,0,0,0,2,0,0.118,40.0
4.301,14,13,17.0,5,12.5,8,3,11,15.073,24.244,16.165,27.285,25,24,3,5,197.29,2,3,0,1.137,0,0,0,1,0,0.08,33.3
4.424,19,18,27.0,1,15.4,10,9,8,18.471,27.233,18.557,29.372,27,26,4,8,264.29,4,11,6,1.13,0,0,0,3,0,0.148,38.5
4.555,17,16,23.0,1,12.0,10,9,9,17.261,25.687,17.858,28.079,26,25,3,6,235.29,3,9,6,1.123,0,0,0,2,0,0.115,40.0
4.301,13,12,16.0,4,14.3,7,3,9,13.547,21.36,14.404,23.87,22,21,3,5,183.26,2,3,0,1.137,0,0,0,1,0,0.091,33.3
4.301,15,14,18.0,6,11.1,9,3,13,16.6,27.127,17.926,30.7,28,27,3,5,211.32,2,3,0,1.137,0,0,0,1,0,0.071,33.3
5.91,30,28,40.0,2,4.3,21,19,18,32.056,46.534,34.137,50.96,48,46,2,7,433.38,5,19,18,1.108,0,2,2,2,0,0.104,45.7
4.301,24,23,31.0,6,4.3,19,13,24,28.74,46.327,31.489,52.693,48,47,2,4,328.52,6,13,12,1.121,0,0,0,1,0,0.125,40.4
4.4,25,24,32.0,5,4.5,18,13,20,28.868,44.091,31.443,49.166,45,44,2,6,383.37,6,13,12,1.117,0,2,2,1,0,0.133,40.9
4.921,22,21,32.0,0,3.2,16,15,10,22.627,31.825,23.034,34.147,32,31,1,5,299.72,3,15,12,1.102,1,1,1,3,0,0.094,51.6
4.301,24,23,31.0,5,4.5,18,13,21,27.568,44.018,29.392,49.511,45,44,2,5,332.86,6,13,12,1.125,0,1,1,2,0,0.133,40.9
4.301,24,23,31.0,6,4.3,19,13,24,28.267,46.578,30.296,52.983,48,47,2,4,312.45,6,13,12,1.127,0,0,0,2,0,0.125,40.4
4.301,25,24,32.0,5,4.5,18,13,20,28.395,44.342,30.25,49.455,45,44,2,6,367.3,6,13,12,1.124,0,2,2,2,0,0.133,40.9
5.614,17,16,23.0,1,12.5,10,9,8,17.572,24.589,18.756,26.712,25,24,3,6,298.18,3,9,6,1.113,0,0,1,1,0,0.12,41.7
5.65,30,28,40.0,2,4.3,21,19,18,32.451,46.345,35.125,50.755,48,46,2,7,522.28,5,19,18,1.103,0,0,2,2,0,0.104,45.7
5.8,37,32,52.0,3,13.2,24,21,21,36.024,52.974,38.017,59.315,58,53,7,8,439.59,5,30,30,1.119,0,0,0,0,0,0.086,45.3
4.843,17,16,23.0,1,12.5,10,9,8,17.374,24.684,18.261,26.814,25,24,3,6,253.73,3,9,6,1.117,0,1,1,1,0,0.12,41.7
4.342,18,17,24.0,2,10.7,11,9,11,18.788,28.571,19.619,31.495,29,28,3,6,249.32,4,9,6,1.125,0,0,0,2,0,0.138,39.3
5.188,30,28,40.0,2,4.4,21,19,17,31.724,45.72,33.62,50.091,47,45,2,7,435.37,5,19,18,1.113,0,2,3,1,1,0.106,46.7
5.172,30,28,40.0,2,4.4,21,19,17,32.12,45.531,34.608,49.886,47,45,2,7,524.27,5,19,18,1.109,0,0,3,1,1,0.106,46.7
4.301,30,28,40.0,4,3.9,23,19,23,32.651,51.091,34.233,57.322,53,51,2,5,378.48,5,19,18,1.124,0,0,1,2,1,0.094,45.1
5.644,29,27,39.0,2,4.3,21,19,19,30.756,46.462,32.085,51.306,48,46,2,6,382.87,5,19,18,1.115,0,1,1,3,0,0.104,45.7
4.422,30,28,40.0,4,3.9,23,19,23,33.123,50.84,35.427,57.033,53,51,2,5,394.55,5,19,18,1.118,0,0,1,1,1,0.094,45.1
4.509,17,16,20.0,8,9.1,11,3,17,19.654,32.894,21.449,37.531,34,33,3,5,239.38,2,3,0,1.137,0,0,0,1,0,0.059,33.3
5.024,30,28,40.0,4,3.8,23,19,24,33.454,51.654,35.944,57.903,54,52,2,5,392.56,5,19,18,1.114,0,0,0,2,0,0.093,44.2
5.462,29,27,39.0,2,4.4,21,19,18,30.424,45.647,31.568,50.436,47,45,2,6,384.86,5,19,18,1.121,0,1,2,2,1,0.106,46.7
5.287,29,27,39.0,2,4.4,21,19,18,30.622,45.552,32.063,50.334,47,45,2,6,429.31,5,19,18,1.119,0,0,2,2,1,0.106,46.7
6.377,18,17,24.0,1,12.0,10,9,8,18.287,25.916,19.21,27.921,26,25,3,7,314.18,3,9,6,1.117,0,0,1,2,0,0.115,40.0
6.456,29,27,39.0,2,4.3,21,19,19,31.228,46.211,33.279,51.016,48,46,2,6,398.94,5,19,18,1.109,0,1,1,2,0,0.104,45.7
5.75,18,17,24.0,1,12.0,10,9,8,18.089,26.011,18.716,28.023,26,25,3,7,269.73,3,9,6,1.121,0,1,1,2,0,0.115,40.0
5.346,19,18,25.0,1,12.0,10,9,7,18.916,26.335,19.574,27.967,26,25,3,8,304.17,3,9,6,1.119,0,2,2,2,0,0.115,40.0
5.234,17,16,23.0,2,11.1,11,9,11,18.073,27.244,19.165,30.285,28,27,3,5,233.32,3,9,6,1.122,0,0,0,1,0,0.107,40.7
5.038,18,17,24.0,2,10.7,11,9,11,18.788,28.571,19.619,31.495,29,28,3,6,249.32,4,9,6,1.125,0,0,0,2,0,0.138,39.3
4.89,24,23,31.0,4,5.0,17,13,17,26.981,40.454,28.892,44.775,41,40,2,6,371.71,5,13,12,1.119,0,3,3,1,0,0.122,42.5
5.41,24,23,31.0,4,5.0,17,13,17,26.537,40.643,27.972,45.171,41,40,2,6,355.26,5,13,12,1.129,0,2,3,1,1,0.122,42.5
5.0,46,41,59.5,10,8.0,31,21,34,47.835,75.04,50.705,84.351,80,75,6,10,570.78,10,27,27,1.125,0,0,0,3,0,0.125,41.3
5.0,49,44,62.5,10,8.0,31,21,31,48.985,76.578,50.517,85.37,80,75,6,13,624.75,10,27,27,1.138,0,0,3,3,3,0.125,41.3
7.42,45,40,58.5,9,8.5,30,21,31,46.421,71.152,49.347,79.67,76,71,6,10,575.19,9,27,27,1.122,0,1,1,2,0,0.118,42.3
5.638,45,40,58.5,9,8.5,30,21,31,46.421,71.152,49.347,79.67,76,71,6,10,575.19,9,27,27,1.122,0,1,1,2,0,0.118,42.3
5.658,44,39,57.5,9,8.5,30,21,32,45.593,70.829,48.489,79.726,76,71,6,9,540.75,9,27,27,1.123,0,0,0,2,0,0.118,42.3
5.638,45,40,58.5,9,8.3,30,21,32,46.308,72.156,48.944,80.936,77,72,6,10,556.75,9,27,27,1.124,0,0,0,3,0,0.117,41.7
6.886,46,41,59.5,10,8.0,31,21,34,47.835,75.04,50.705,84.351,80,75,6,10,570.78,10,27,27,1.125,0,0,0,3,0,0.125,41.3
5.0,45,40,58.5,9,8.5,30,21,31,45.977,71.341,48.427,80.066,76,71,6,10,558.74,9,27,27,1.128,0,0,1,2,1,0.118,42.3
8.301,46,41,59.5,10,8.0,31,21,34,47.835,75.04,50.705,84.351,80,75,6,10,570.78,10,27,27,1.125,0,0,0,3,0,0.125,41.3
5.0,48,43,61.5,10,8.1,31,21,31,48.27,75.25,50.063,84.161,79,74,6,12,608.75,9,27,27,1.137,0,0,3,2,3,0.114,41.9
5.0,48,43,61.5,10,8.1,31,21,31,48.27,75.25,50.063,84.161,79,74,6,12,608.75,9,27,27,1.137,0,0,3,2,3,0.114,41.9
5.0,46,41,59.5,9,8.5,30,21,30,46.804,71.665,49.284,80.01,76,71,6,11,593.18,9,27,27,1.127,0,1,2,2,1,0.118,42.3
5.0,46,41,59.5,10,8.0,31,21,34,47.835,75.04,50.705,84.351,80,75,6,10,570.78,10,27,27,1.125,0,0,0,3,0,0.125,41.3
7.328,46,41,59.5,10,8.0,31,21,34,47.835,75.04,50.705,84.351,80,75,6,10,570.78,10,27,27,1.125,0,0,0,3,0,0.125,41.3
5.0,45,40,58.5,9,8.5,30,21,31,46.421,71.152,49.347,79.67,76,71,6,10,575.19,9,27,27,1.122,0,1,1,2,0,0.118,42.3
6.523,45,40,58.5,9,8.5,30,21,31,45.977,71.341,48.427,80.066,76,71,6,10,558.74,9,27,27,1.128,0,0,1,2,1,0.118,42.3
5.62,45,40,58.5,9,8.5,30,21,31,45.977,71.341,48.427,80.066,76,71,6,10,558.74,9,27,27,1.128,0,0,1,2,1,0.118,42.3
5.0,45,40,58.5,9,8.5,30,21,31,45.977,71.341,48.427,80.066,76,71,6,10,558.74,9,27,27,1.128,0,0,1,2,1,0.118,42.3
5.444,45,40,58.5,9,8.3,30,21,32,46.308,72.156,48.944,80.936,77,72,6,10,556.75,9,27,27,1.124,0,0,0,3,0,0.117,41.7
5.229,45,40,58.5,10,8.1,31,21,34,47.12,73.712,50.25,83.141,79,74,6,9,554.78,9,27,27,1.124,0,0,0,2,0,0.114,41.9
6.31,45,40,58.5,10,8.1,31,21,34,47.12,73.712,50.25,83.141,79,74,6,9,554.78,9,27,27,1.124,0,0,0,2,0,0.114,41.9
7.0,44,39,57.5,9,8.5,30,21,32,45.593,70.829,48.489,79.726,76,71,6,9,540.75,9,27,27,1.123,0,0,0,2,0,0.118,42.3
7.495,45,40,58.5,10,8.1,31,21,34,47.12,73.712,50.25,83.141,79,74,6,9,554.78,9,27,27,1.124,0,0,0,2,0,0.114,41.9
5.0,45,40,58.5,9,8.5,30,21,31,46.421,71.152,49.347,79.67,76,71,6,10,575.19,9,27,27,1.122,0,1,1,2,0,0.118,42.3
7.824,32,30,41.5,5,8.0,20,15,20,32.897,51.505,33.489,56.851,52,50,4,10,434.89,9,18,17,1.137,0,1,2,4,1,0.173,40.0
7.616,34,32,43.5,7,7.1,22,15,24,36.423,57.022,38.205,63.392,58,56,4,10,479.02,11,18,17,1.132,0,1,2,3,1,0.19,39.3
5.699,36,34,47.5,7,6.9,22,15,24,37.852,59.676,39.114,65.811,60,58,4,12,511.02,11,20,17,1.135,0,1,2,5,1,0.183,37.9
6.647,33,31,42.5,8,6.8,23,15,28,36.266,59.32,37.978,66.813,61,59,4,8,424.55,12,18,17,1.132,0,0,0,4,0,0.197,39.0
6.32,35,33,44.5,8,6.8,23,15,26,37.477,60.156,38.773,67.097,61,59,4,10,476.98,12,18,17,1.137,0,1,2,4,1,0.197,39.0
6.53,34,32,43.5,8,6.8,23,15,27,36.65,59.832,37.915,67.153,61,59,4,9,442.54,12,18,17,1.138,0,0,1,4,1,0.197,39.0
4.819,32,29,43.0,3,4.3,21,18,17,32.148,46.978,34.034,51.086,49,46,2,8,504.3,5,19,16,1.111,0,0,1,5,0,0.102,45.7
7.975,30,28,39.5,3,9.1,18,15,16,29.843,45.738,29.966,50.021,46,44,4,10,406.83,7,18,17,1.137,0,1,2,4,1,0.152,40.9
7.62,37,35,46.5,9,6.3,24,15,28,39.719,64.367,40.989,71.722,65,63,4,11,507.01,14,18,17,1.138,0,1,2,5,1,0.215,38.1
7.907,31,29,40.5,4,8.5,19,15,18,31.37,48.622,31.727,53.436,49,47,4,10,420.86,8,18,17,1.137,0,1,2,4,1,0.163,40.4
7.697,36,34,46.5,7,8.5,23,16,25,37.972,60.374,39.017,67.18,61,59,5,11,489.98,11,19,17,1.139,0,1,2,4,1,0.18,39.0
7.699,33,31,42.5,6,7.5,21,15,22,34.424,54.389,35.25,60.267,55,53,4,10,448.92,10,18,17,1.137,0,1,2,4,1,0.182,39.6
7.418,33,31,44.5,6,7.3,23,15,24,35.213,55.552,36.455,61.983,57,55,4,8,420.51,10,19,17,1.127,2,0,0,4,0,0.175,41.8
7.721,34,32,43.5,7,7.1,22,15,24,35.95,57.272,37.012,63.682,58,56,4,10,462.95,11,18,17,1.137,0,1,2,4,1,0.19,39.3
6.757,35,33,44.5,9,6.5,24,15,29,38.176,62.716,39.676,70.568,64,62,4,9,456.57,12,18,17,1.138,0,0,1,4,1,0.188,38.7
6.254,35,33,44.5,9,6.5,24,15,29,38.621,62.527,40.597,70.172,64,62,4,9,473.02,12,18,17,1.132,0,1,1,4,0,0.188,38.7
7.148,34,32,43.5,7,7.1,22,15,24,35.95,57.272,37.012,63.682,58,56,4,10,462.95,11,18,17,1.137,0,1,2,4,1,0.19,39.3
7.287,34,32,45.5,7,6.9,24,15,26,36.74,58.436,38.216,65.398,60,58,4,8,434.54,11,19,17,1.128,2,0,0,4,0,0.183,41.4
7.804,34,32,45.5,7,6.9,24,15,26,36.74,58.436,38.216,65.398,60,58,4,8,434.54,11,19,17,1.128,2,0,0,4,0,0.183,41.4
7.116,35,33,46.5,7,6.9,24,15,25,37.123,58.949,38.154,65.738,60,58,4,9,452.53,11,19,17,1.133,2,0,1,4,1,0.183,41.4
7.996,43,40,55.5,8,5.7,29,21,30,45.246,71.251,46.75,79.137,73,70,4,11,569.08,14,24,23,1.131,0,1,2,5,1,0.192,41.4
5.699,34,32,43.5,9,6.5,24,15,30,37.793,62.203,39.739,70.228,64,62,4,8,438.58,12,18,17,1.133,0,0,0,4,0,0.188,38.7
7.416,32,30,43.5,5,7.7,22,15,22,33.686,52.669,34.693,58.568,54,52,4,8,406.48,9,19,17,1.126,2,0,0,4,0,0.167,42.3
4.418,29,27,39.0,3,4.2,22,19,21,31.124,48.207,32.472,53.907,50,48,2,5,364.45,5,19,18,1.123,0,0,1,2,1,0.1,45.8
5.726,24,23,31.0,5,4.7,18,13,20,27.681,43.014,29.796,48.246,44,43,2,5,351.3,5,13,12,1.122,0,2,2,1,0,0.114,41.9
5.0,33,30,41.5,7,9.6,21,14,22,34.128,52.832,35.75,59.081,55,52,5,9,450.38,5,17,17,1.136,0,2,3,1,1,0.091,40.4
5.344,30,28,40.0,2,4.3,21,19,18,31.979,46.596,33.932,51.045,48,46,2,7,506.21,5,19,18,1.11,0,0,2,3,0,0.104,45.7
5.445,18,17,24.0,1,12.0,10,9,8,17.645,26.2,17.796,28.419,26,25,3,7,253.28,3,9,6,1.137,0,0,1,2,1,0.115,40.0
4.402,22,22,26.0,10,4.2,17,7,26,28.261,47.665,31.08,54.492,48,48,2,5,345.35,8,7,6,1.135,0,2,2,1,0,0.167,35.4
6.456,28,26,37.5,4,4.3,21,17,20,30.681,46.014,32.796,51.246,48,46,2,5,387.33,5,18,17,1.114,0,2,2,1,0,0.104,45.7
4.906,30,28,40.0,2,4.4,21,19,17,31.647,45.782,33.415,50.175,47,45,2,7,508.2,5,19,18,1.115,0,0,3,2,1,0.106,46.7
6.18,29,27,39.0,2,4.3,21,19,19,31.426,46.116,33.773,50.914,48,46,2,6,443.39,5,19,18,1.107,0,0,1,2,0,0.104,45.7
7.362,32,30,41.5,6,7.7,21,15,22,33.709,53.062,34.796,59.057,54,52,4,9,432.92,10,18,17,1.136,0,1,2,3,1,0.185,40.4
5.0,45,40,58.5,9,8.3,30,21,32,46.308,72.156,48.944,80.936,77,72,6,10,556.75,9,27,27,1.124,0,0,0,3,0,0.117,41.7
5.073,19,18,27.0,1,15.4,10,9,8,18.471,27.233,18.557,29.372,27,26,4,8,264.29,4,11,6,1.13,0,0,0,3,0,0.148,38.5
5.002,24,23,31.0,4,5.0,17,13,17,27.179,40.36,29.387,44.672,41,40,2,6,416.16,5,13,12,1.117,0,2,3,1,0,0.122,42.5
5.147,29,27,39.0,3,4.1,22,19,22,31.928,48.771,34.182,54.487,51,49,2,5,378.53,5,19,18,1.112,0,0,0,2,0,0.098,44.9
6.745,45,40,58.5,9,8.5,30,21,31,46.421,71.152,49.347,79.67,76,71,6,10,575.19,9,27,27,1.122,0,1,1,2,0,0.118,42.3
5.158,45,40,58.5,9,8.5,30,21,31,45.977,71.341,48.427,80.066,76,71,6,10,558.74,9,27,27,1.128,0,0,1,2,1,0.118,42.3
5.699,23,21,34.0,0,7.1,12,12,7,21.882,29.546,22.761,30.761,30,28,2,9,387.25,2,17,12,1.099,0,0,1,4,0,0.067,42.9
4.876,32,29,43.0,3,4.3,21,18,17,31.856,47.138,32.727,51.207,49,46,2,8,457.3,5,19,16,1.113,0,0,1,5,0,0.102,45.7
7.556,34,32,43.5,9,6.5,24,15,30,37.793,62.203,39.739,70.228,64,62,4,8,438.58,12,18,17,1.133,0,0,0,4,0,0.188,38.7
4.403,24,23,31.0,5,4.5,18,13,21,28.238,43.672,31.08,49.12,45,44,2,5,393.38,6,13,12,1.116,0,0,1,1,0,0.133,40.9
5.072,32,29,43.0,3,4.3,21,18,17,31.215,47.422,31.313,51.705,49,46,2,8,396.4,5,19,16,1.124,0,0,1,5,1,0.102,45.7
6.108,45,40,58.5,9,8.3,30,21,32,46.308,72.156,48.944,80.936,77,72,6,10,556.75,9,27,27,1.124,0,0,0,3,0,0.117,41.7
5.91,35,33,47.5,5,8.9,24,18,23,37.015,56.836,38.347,63.346,58,56,5,9,467.97,8,20,17,1.131,1,1,2,2,1,0.138,42.9
5.0,29,26,40.5,2,9.8,19,17,15,28.504,41.687,29.358,45.847,44,41,4,7,366.83,3,22,21,1.118,0,1,1,2,0,0.068,46.3
5.451,25,22,33.0,0,0.0,14,14,6,21.299,30.269,19.92,30.921,31,28,0,8,302.2,0,14,12,1.104,0,0,0,8,0,0.0,50.0
5.039,33,31,42.0,10,1.7,25,15,29,38.701,59.476,44.108,66.796,62,60,1,6,645.35,11,17,16,1.113,0,0,2,3,0,0.177,41.7
5.18,29,28,40.0,4,2.1,20,16,19,30.766,48.345,31.04,52.701,48,47,1,8,385.4,11,17,12,1.121,0,0,0,7,0,0.229,42.6
5.42,27,26,37.5,4,2.3,18,14,17,28.239,44.462,28.278,48.286,44,43,1,8,359.36,11,16,11,1.123,0,0,0,7,0,0.25,41.9
5.429,40,35,51.5,8,9.8,26,18,26,39.541,61.429,41.012,68.77,66,61,6,9,470.58,4,20,17,1.127,0,0,0,3,0,0.061,42.6
6.456,40,36,51.5,7,11.5,25,18,25,40.058,62.04,41.358,69.343,65,61,7,11,510.02,5,20,17,1.137,0,1,2,2,1,0.077,41.0
7.0,48,42,64.5,6,11.4,31,25,28,46.584,70.632,48.023,78.767,76,70,8,11,560.67,6,30,27,1.125,0,0,0,3,0,0.079,44.3
7.0,48,42,64.5,6,9.9,32,26,29,47.089,71.414,48.779,79.684,77,71,7,10,559.68,6,30,27,1.122,0,0,0,3,0,0.078,45.1
5.0,22,20,30.5,2,5.9,16,14,14,22.633,34.16,23.489,37.907,36,34,2,4,266.32,3,17,17,1.115,0,0,0,2,0,0.083,47.1
5.602,30,27,40.5,2,11.9,19,17,15,29.193,42.974,29.847,47.476,45,42,5,8,383.84,3,19,17,1.13,0,1,2,1,1,0.067,45.2
6.297,40,36,51.5,7,11.5,25,18,25,40.058,62.04,41.358,69.343,65,61,7,11,510.02,4,20,17,1.137,0,1,2,2,1,0.062,41.0
6.566,39,36,50.5,7,11.1,25,18,27,40.585,63.923,42.12,71.758,66,63,7,11,512.04,9,20,17,1.139,0,1,2,2,1,0.136,39.7
5.907,41,37,52.5,7,11.3,25,18,25,40.773,63.367,41.813,70.552,66,62,7,12,526.02,7,20,17,1.138,0,1,2,3,1,0.106,40.3
5.917,38,34,49.5,5,11.1,23,18,20,36.698,55.498,37.284,61.223,58,54,6,11,482.94,4,20,17,1.134,0,1,2,3,1,0.069,42.6
6.301,41,37,54.5,7,10.9,27,18,27,41.562,64.531,43.017,72.268,68,64,7,10,497.61,7,21,17,1.129,2,0,0,3,0,0.103,42.2
4.713,23,21,29.0,5,5.0,17,12,19,25.799,39.556,28.37,44.597,42,40,2,4,318.9,4,12,12,1.115,0,1,1,0,0,0.095,42.5
4.678,22,20,30.5,3,5.7,17,14,15,23.756,34.618,25.694,38.745,37,35,2,3,327.24,1,17,17,1.107,0,0,1,0,0,0.027,48.6
4.708,33,30,39.0,10,5.4,22,12,26,34.964,56.734,36.83,64.041,59,56,3,8,437.58,6,12,12,1.144,0,0,3,1,3,0.102,39.3
5.244,15,15,22.0,0,8.7,10,9,8,16.24,23.585,16.852,25.581,23,23,2,5,220.27,2,9,6,1.112,1,0,0,2,0,0.087,43.5
4.857,26,24,34.5,3,5.1,18,15,15,27.455,39.571,29.131,43.36,41,39,2,6,381.7,6,17,17,1.112,0,3,3,1,0,0.146,46.2
5.53,30,28,40.0,6,1.8,26,20,29,35.111,55.8,38.12,63.521,59,57,1,2,371.56,8,19,18,1.114,0,0,0,1,0,0.136,45.6
5.155,26,24,34.0,6,2.1,21,15,23,29.246,46.476,31.29,52.484,49,47,1,3,321.45,3,14,12,1.117,0,0,0,2,0,0.061,44.7
4.0,19,17,26.5,1,6.9,14,13,12,19.392,28.949,20.273,32.282,31,29,2,3,224.28,1,13,11,1.113,0,0,0,1,0,0.032,48.3
4.79,26,24,34.0,5,2.3,20,15,20,28.547,43.916,30.387,49.013,46,44,1,4,341.86,3,14,12,1.114,0,1,1,2,0,0.065,45.5
4.039,21,19,28.5,2,3.1,15,13,13,22.271,31.884,24.324,35.039,34,32,1,4,287.43,2,13,11,1.095,0,0,0,1,0,0.059,46.9
4.0,26,23,34.0,4,4.9,19,15,18,26.687,40.927,28.012,45.737,44,41,2,4,306.39,2,14,12,1.116,0,0,0,2,0,0.045,46.3
4.0,19,17,26.5,1,6.9,14,13,12,19.392,28.949,20.273,32.282,31,29,2,3,224.28,1,13,11,1.113,0,0,0,1,0,0.032,48.3
5.0,19,17,27.5,0,7.7,14,14,9,18.978,26.062,19.915,28.601,28,26,2,3,240.7,1,17,17,1.1,0,1,1,0,0,0.036,53.8
5.067,14,13,19.5,0,5.6,9,9,5,14.95,18.218,18.063,19.395,19,18,1,4,396.95,0,11,11,1.077,0,0,2,1,0,0.0,50.0
4.0,18,16,25.5,0,7.7,13,13,10,17.865,26.065,18.512,28.867,28,26,2,3,210.25,1,13,11,1.11,0,0,0,1,0,0.036,50.0
4.0,20,18,28.0,0,3.6,15,15,10,20.395,28.076,21.62,30.625,30,28,1,3,300.16,1,14,12,1.094,0,0,1,1,0,0.033,53.6
4.0,23,21,31.0,3,5.1,18,15,18,24.972,38.6,26.557,43.528,41,39,2,3,278.38,2,14,12,1.116,0,0,0,1,0,0.049,46.2
4.0,25,23,33.5,4,4.9,18,14,18,26.402,41.254,27.466,45.946,43,41,2,5,310.38,4,14,11,1.121,0,0,0,3,0,0.093,43.9
4.818,27,25,35.0,5,2.3,20,15,19,29.572,44.145,31.739,48.855,46,44,1,5,420.75,3,14,12,1.11,0,1,2,2,0,0.065,45.5
4.879,25,23,33.0,5,2.3,20,15,21,27.719,43.592,29.529,49.069,46,44,1,3,307.42,3,14,12,1.115,0,0,0,2,0,0.065,45.5
5.0,27,24,35.0,4,4.9,19,15,17,27.712,41.156,29.364,45.579,44,41,2,5,385.28,2,14,12,1.112,0,0,1,2,0,0.045,46.3
5.0,20,18,28.5,0,7.1,14,14,10,19.58,28.393,19.966,31.076,30,28,2,4,238.26,1,17,17,1.11,0,0,0,2,0,0.033,50.0
4.0,19,17,26.5,0,7.7,13,13,9,18.248,26.578,18.449,29.207,28,26,2,4,228.24,1,13,11,1.123,0,0,1,1,1,0.036,50.0
4.0,21,19,28.5,2,6.3,15,13,13,21.302,32.345,21.972,36.037,34,32,2,4,256.3,1,13,11,1.126,0,0,1,1,1,0.029,46.9
4.0,21,19,30.5,0,10.7,13,13,9,19.789,28.938,19.665,31.369,30,28,3,6,255.25,2,15,11,1.12,0,0,0,3,0,0.067,46.4
4.0,19,17,26.5,0,12.0,12,12,8,18.187,25.607,18.614,27.894,27,25,3,5,245.68,1,13,11,1.116,0,1,1,1,0,0.037,48.0
4.721,26,24,34.0,5,2.3,20,15,20,28.744,43.822,30.881,48.911,46,44,1,4,386.31,3,14,12,1.112,0,0,1,2,0,0.065,45.5
4.0,19,17,26.5,0,4.0,13,13,8,19.056,25.269,20.506,27.13,27,25,1,4,306.19,1,13,11,1.085,0,0,1,1,0,0.037,52.0
4.0,21,19,29.0,1,3.1,16,15,13,21.612,32.058,22.483,35.408,34,32,1,3,251.3,2,14,12,1.107,0,0,0,2,0,0.059,50.0
4.301,29,26,38.0,4,6.8,20,16,18,29.733,44.258,31.37,49.077,47,44,3,6,412.31,2,15,12,1.115,0,0,1,2,0,0.043,45.5
4.0,29,26,38.0,5,6.4,21,16,21,30.235,46.912,31.779,52.651,50,47,3,5,347.45,2,15,12,1.12,0,0,0,2,0,0.04,44.7
4.0,24,22,32.5,3,5.3,17,14,16,24.875,38.371,25.705,42.531,40,38,2,5,296.35,4,14,11,1.119,0,0,0,3,0,0.1,44.7
4.0,21,19,28.5,3,5.7,16,13,16,22.445,34.716,23.796,39.112,37,35,2,3,252.34,1,13,11,1.117,0,0,0,1,0,0.027,45.7
4.188,28,26,36.0,8,1.9,23,15,27,32.299,52.243,34.813,59.315,55,53,1,3,349.51,3,14,12,1.119,0,0,0,2,0,0.055,43.4
4.0,20,18,27.5,1,10.7,13,12,10,19.714,28.491,20.375,31.309,30,28,3,5,259.71,1,13,11,1.118,0,1,1,1,0,0.033,46.4
4.0,19,17,26.5,1,3.6,14,13,11,19.085,28.174,19.722,30.993,30,28,1,3,225.26,1,13,11,1.107,0,0,0,2,0,0.033,50.0
4.0,20,18,27.5,1,3.4,14,13,11,20.744,29.0,22.563,31.624,31,29,1,4,273.4,2,13,11,1.09,0,0,0,1,0,0.065,48.3
5.086,27,25,35.0,6,2.1,21,15,22,30.073,46.8,32.148,52.428,49,47,1,4,355.89,3,14,12,1.115,0,1,1,2,0,0.061,44.7
4.0,23,21,31.0,3,5.1,18,15,18,24.972,38.6,26.557,43.528,41,39,2,3,278.38,2,14,12,1.116,0,0,0,1,0,0.049,46.2
4.177,27,24,35.0,5,4.5,20,15,20,28.214,43.811,29.773,49.152,47,44,2,4,320.42,2,14,12,1.117,0,0,0,2,0,0.043,45.5
7.137,33,30,44.5,6,9.6,23,15,22,34.588,52.018,36.688,58.279,55,52,5,7,464.4,4,19,17,1.121,2,0,1,1,0,0.073,44.2
4.562,27,25,35.5,3,5.1,18,15,14,28.282,39.895,29.989,43.304,41,39,2,7,416.14,6,17,17,1.11,0,4,4,1,0,0.146,46.2
7.481,28,26,39.5,2,9.8,19,15,15,28.701,41.593,29.853,45.745,43,41,4,7,411.28,4,19,17,1.116,2,0,1,2,0,0.093,46.3
4.59,28,26,38.5,2,11.4,19,17,18,29.535,44.251,31.165,49.449,46,44,5,7,412.32,5,19,17,1.124,0,0,1,1,0,0.109,43.2
6.947,31,29,42.5,5,9.8,22,15,22,33.588,51.018,35.688,57.279,53,51,5,7,452.39,5,19,17,1.123,2,0,1,1,0,0.094,43.1
5.0,40,35,53.0,8,6.3,28,20,28,40.552,62.992,42.523,70.604,68,63,4,7,468.6,2,23,20,1.121,0,0,0,3,0,0.029,44.4
6.423,26,24,37.5,1,10.8,18,15,13,26.46,37.382,27.637,41.12,39,37,4,6,381.25,3,19,17,1.111,2,0,1,1,0,0.077,48.6
5.934,31,29,41.5,5,9.4,22,17,24,34.115,52.901,36.449,59.695,55,53,5,7,454.41,8,19,17,1.126,0,0,1,1,0,0.145,41.5
4.817,26,24,36.5,1,10.3,18,17,15,26.986,39.265,28.398,43.535,41,39,4,6,383.27,4,19,17,1.116,0,0,1,1,0,0.098,46.2
6.0,37,33,49.5,7,10.7,24,16,23,37.127,56.542,38.654,63.089,60,56,6,9,462.98,6,22,21,1.127,1,1,1,2,0,0.1,42.9
6.738,35,32,46.5,7,10.5,24,15,25,37.136,57.003,39.455,64.193,60,57,6,8,493.45,5,19,17,1.126,2,0,1,1,0,0.083,42.1
6.0,28,25,40.5,1,13.5,18,16,12,26.757,37.694,27.387,41.306,40,37,5,7,349.8,3,22,21,1.116,1,1,1,1,0,0.075,48.6
5.347,47,44,60.0,14,7.5,29,15,36,49.464,81.811,50.546,91.102,83,80,6,15,612.71,16,21,16,1.139,0,0,0,9,0,0.193,36.3
6.0,37,33,49.5,8,10.2,25,16,26,37.826,59.101,39.557,66.561,63,59,6,8,442.57,6,22,21,1.128,1,0,0,2,0,0.095,42.4
5.845,33,31,43.5,7,8.5,24,17,28,37.169,58.669,39.972,66.525,61,59,5,7,482.47,10,19,17,1.128,0,0,1,1,0,0.164,40.7
5.054,28,26,38.5,2,9.3,19,17,17,29.228,43.476,30.614,48.16,45,43,4,7,413.3,6,19,17,1.12,0,0,1,2,0,0.133,44.2
5.297,31,28,41.5,4,10.4,21,17,20,32.061,48.134,33.927,53.864,51,48,5,7,438.36,4,19,17,1.122,0,0,1,1,0,0.078,43.8
6.79,33,31,44.5,7,8.8,24,15,26,36.642,56.785,39.211,64.11,59,57,5,7,480.45,6,19,17,1.125,2,0,1,1,0,0.102,42.1
6.914,30,28,41.5,3,8.9,20,15,17,30.943,45.803,32.068,50.369,47,45,4,8,441.31,6,19,17,1.119,2,0,1,3,0,0.128,44.4
6.0,41,37,53.5,9,10.6,26,16,29,41.804,66.741,43.233,74.893,70,66,7,11,503.62,9,22,21,1.135,1,0,0,4,0,0.129,39.4
7.276,33,30,44.5,5,10.0,22,15,20,33.776,50.462,35.381,56.074,53,50,5,8,466.37,4,19,17,1.121,2,0,1,2,0,0.075,44.0
4.039,26,24,36.5,1,10.3,18,17,15,26.986,39.265,28.398,43.535,41,39,4,6,383.27,4,19,17,1.116,0,0,1,1,0,0.098,46.2
5.552,33,30,43.5,5,9.6,22,17,22,34.775,52.094,37.336,58.199,55,52,5,8,484.46,6,19,17,1.119,0,0,1,1,0,0.109,42.3
4.806,32,29,45.0,1,13.0,21,20,17,32.029,46.469,33.409,51.532,49,46,6,8,449.34,6,24,22,1.12,0,0,1,1,0,0.122,45.7
6.383,31,29,41.5,4,9.8,21,17,22,33.303,51.345,35.142,57.489,53,51,5,8,456.38,8,19,17,1.127,0,0,1,2,0,0.151,41.2
6.932,35,32,46.5,7,8.9,24,15,24,36.83,56.229,38.904,62.904,59,56,5,8,494.43,6,19,17,1.123,2,0,1,2,0,0.102,42.9
5.682,34,31,42.5,8,7.3,22,14,24,35.236,55.945,36.557,62.472,58,55,4,9,446.95,8,17,17,1.136,0,1,2,3,1,0.138,40.0
6.521,29,27,39.5,3,10.6,20,17,20,31.061,47.134,32.927,52.864,49,47,5,7,426.35,6,19,17,1.125,0,0,1,1,0,0.122,42.6
7.796,27,25,38.5,1,10.5,18,15,13,27.174,38.709,28.091,42.33,40,38,4,7,397.25,3,19,17,1.114,2,0,1,2,0,0.075,47.4
6.339,33,30,43.5,5,9.6,22,17,22,34.303,52.345,36.142,58.489,55,52,5,8,468.39,6,19,17,1.125,0,0,1,2,0,0.109,42.3
5.807,33,30,43.5,6,9.3,23,17,24,35.115,53.901,37.449,60.695,57,54,5,7,466.42,6,19,17,1.124,0,0,1,1,0,0.105,42.6
5.4,41,37,54.0,7,10.3,29,22,31,43.186,67.643,45.631,76.68,72,68,7,8,493.67,7,25,24,1.128,0,0,0,1,0,0.097,42.6
5.798,40,36,50.5,11,8.7,28,17,33,43.244,68.538,46.501,77.854,73,69,6,8,549.57,7,19,17,1.128,0,0,1,1,0,0.096,40.6
5.379,32,29,42.5,4,10.2,21,17,20,32.776,49.462,34.381,55.074,52,49,5,8,454.36,5,19,17,1.124,0,0,1,2,0,0.096,42.9
6.0,31,28,43.5,3,11.1,20,16,17,30.412,45.793,30.96,50.611,48,45,5,8,375.42,5,22,21,1.125,1,0,0,3,0,0.104,44.4
4.93,33,31,45.5,6,5.6,24,15,23,35.191,54.451,36.449,60.485,56,54,3,7,417.5,10,19,17,1.12,3,0,0,4,0,0.179,44.4
5.778,31,29,41.0,6,1.8,26,20,28,35.939,56.123,38.978,63.465,59,57,1,3,406.0,9,19,18,1.113,0,1,1,1,0,0.153,45.6
5.8,29,26,37.5,6,10.9,19,13,20,29.42,46.418,30.512,52.362,49,46,5,7,353.44,4,17,17,1.138,0,0,1,1,1,0.082,41.3
5.772,39,36,51.5,7,8.2,26,18,25,40.257,62.047,41.563,68.971,64,61,5,10,510.01,9,20,17,1.131,1,1,2,3,1,0.141,42.6
6.0,29,26,41.5,1,13.5,18,16,11,27.782,37.924,28.739,41.147,40,37,5,8,428.69,3,22,21,1.112,1,1,2,1,0,0.075,48.6
6.0,27,24,39.5,0,15.2,17,16,9,25.54,33.713,26.523,36.523,36,33,5,7,398.66,2,22,21,1.107,1,1,2,0,0,0.056,51.5
6.0,40,36,52.5,9,9.4,26,16,28,40.782,64.64,42.228,72.395,68,64,6,10,488.6,8,22,21,1.131,1,0,0,4,0,0.118,40.6
4.0,23,21,28.0,10,0.0,18,8,22,25.939,42.702,27.739,48.195,45,43,0,3,286.4,2,5,0,1.121,0,0,0,3,0,0.044,41.9
4.833,36,33,46.5,8,7.0,24,15,24,37.236,57.945,38.557,64.472,60,57,4,9,470.97,8,18,17,1.131,1,1,2,3,1,0.133,42.1
