pXC50,nHet,nCsp3,Sp,nBO,nBT,Si,nAT,nH,nC,Sv,nCsp,MW,SCBO,nTB,Se,nSK,nO,nCsp2,nN
6.839,13,7,40.278,39,64,70.319,62,25,24,40.093,0,511.54,52.0,0,63.963,37,8,17,5
9.699,16,11,53.37,52,85,91.933,81,33,32,52.518,2,655.74,69.0,1,82.811,48,7,19,9
6.509,11,7,40.131,37,64,70.315,62,27,24,39.191,0,481.56,48.0,0,63.192,35,6,17,5
6.208,10,8,42.887,39,67,73.232,65,28,27,41.696,2,504.59,52.0,1,65.974,37,6,17,4
6.469,12,7,39.0,38,62,68.496,60,24,24,38.936,0,502.52,49.0,0,62.116,36,6,17,4
6.237,12,6,39.239,39,61,67.081,59,22,25,39.409,2,512.51,52.5,1,61.232,37,6,17,4
6.319,13,7,40.938,41,64,70.836,62,23,26,41.319,2,544.53,54.0,1,64.629,39,6,17,4
5.921,14,9,48.79,47,76,81.232,72,29,29,47.42,2,603.72,64.0,1,73.472,43,6,18,7
6.432,11,7,39.063,37,62,68.157,60,25,24,38.552,0,484.53,48.0,0,61.603,35,6,17,4
6.783,10,5,37.602,36,58,62.986,56,22,24,37.116,2,462.5,49.0,1,57.323,34,6,17,4
9.149,14,9,48.79,47,76,81.232,72,29,29,47.42,2,603.72,64.0,1,73.472,43,6,18,7
6.301,11,7,39.58,37,63,69.026,61,26,24,38.884,0,482.54,48.0,0,62.418,35,7,17,4
6.538,11,6,40.369,38,63,68.9,61,25,25,39.664,2,491.55,51.0,1,62.309,36,6,17,5
4.602,11,7,40.58,38,64,70.026,62,26,25,39.884,0,494.55,50.0,0,63.418,36,7,18,4
4.931,12,7,40.068,38,64,70.655,62,26,24,39.574,0,499.55,49.0,0,63.705,36,6,17,5
8.046,12,5,38.546,38,60,65.824,58,22,24,38.52,2,495.51,51.0,1,59.938,36,6,17,5
5.03,11,5,35.54,35,56,61.326,54,21,22,35.499,0,456.47,46.0,0,55.836,33,6,17,4
7.367,12,7,39.0,38,62,68.496,60,24,24,38.936,0,502.52,49.0,0,62.116,36,6,17,4
7.237,12,6,39.756,39,62,67.951,60,23,25,39.74,2,510.52,52.0,1,62.047,37,7,17,4
6.585,11,7,39.58,37,63,69.026,61,26,24,38.884,0,482.54,48.0,0,62.418,35,7,17,4
5.423,11,5,35.54,35,56,61.326,54,21,22,35.499,0,456.47,46.0,0,55.836,33,6,17,4
5.446,12,7,39.517,38,63,69.366,61,25,24,39.267,0,500.53,49.0,0,62.931,36,7,17,4
5.535,11,6,37.301,36,59,64.741,57,23,23,37.026,0,470.5,47.0,0,58.72,34,6,17,4
6.009,12,8,41.279,39,66,72.781,64,27,25,40.794,0,514.56,50.0,0,65.814,37,7,17,4
4.889,11,9,43.102,39,69,75.857,67,30,26,41.938,0,510.6,50.0,0,68.185,37,7,17,4
6.268,11,8,41.341,38,66,72.441,64,28,25,40.411,0,496.57,49.0,0,65.302,36,7,17,4
6.62,11,7,39.063,37,62,68.157,60,25,24,38.552,0,484.53,48.0,0,61.603,35,6,17,4
6.658,12,7,39.517,38,63,69.366,61,25,24,39.267,0,500.53,49.0,0,62.931,36,7,17,4
6.229,12,8,41.279,39,66,72.781,64,27,25,40.794,0,514.56,50.0,0,65.814,37,7,17,4
7.347,11,7,39.063,37,62,68.157,60,25,24,38.552,0,484.53,48.0,0,61.603,35,6,17,4
6.495,10,8,40.887,37,65,71.232,63,28,25,39.696,0,480.57,48.0,0,63.974,35,6,17,4
7.444,12,6,39.756,39,62,67.951,60,23,25,39.74,2,510.52,52.0,1,62.047,37,7,17,4
6.036,11,6,40.58,38,64,70.026,62,26,25,39.884,0,494.55,50.0,0,63.418,36,7,19,4
5.757,12,7,39.0,38,62,68.496,60,24,24,38.936,0,502.52,49.0,0,62.116,36,6,17,4
5.287,11,6,40.063,38,63,69.157,61,25,25,39.552,0,496.54,50.0,0,62.603,36,6,19,4
5.754,11,7,40.773,37,63,68.737,61,26,24,39.356,0,498.61,48.0,0,62.167,35,6,17,4
9.066,15,8,47.727,46,74,80.571,71,28,28,46.804,2,609.7,62.0,1,72.985,43,6,18,7
6.854,10,7,41.125,38,64,69.817,62,26,26,40.169,2,490.56,51.0,1,63.091,36,6,17,4
6.167,11,7,39.063,37,62,68.157,60,25,24,38.552,0,484.53,48.0,0,61.603,35,6,17,4
7.108,12,7,39.517,38,63,69.366,61,25,24,39.267,0,500.53,49.0,0,62.931,36,7,17,4
4.699,10,6,37.364,35,59,64.402,57,24,23,36.642,0,452.51,46.0,0,58.207,33,6,17,4
6.721,11,8,41.341,38,66,72.441,64,28,25,40.411,0,496.57,49.0,0,65.302,36,7,17,4
6.108,12,7,40.034,38,64,70.236,62,26,24,39.599,0,498.54,49.0,0,63.745,36,8,17,4
6.066,11,6,38.369,36,61,66.9,59,25,23,37.664,0,467.53,47.0,0,60.309,34,6,17,5
6.319,12,7,43.585,41,68,74.525,66,27,27,42.905,2,533.59,55.0,1,67.52,39,7,18,5
6.921,11,7,39.983,37,62,67.761,60,25,24,38.997,0,500.98,48.0,0,61.414,35,6,17,4
7.959,12,7,43.585,41,68,74.525,66,27,27,42.905,2,533.59,55.5,1,67.52,39,7,18,5
7.854,12,8,45.347,42,71,77.94,69,29,28,44.432,2,547.62,56.5,1,70.403,40,7,18,5
6.818,12,8,43.347,40,69,75.94,67,29,26,42.432,0,523.6,52.5,0,68.403,38,7,18,5
8.367,13,8,45.284,43,71,78.279,69,28,28,44.815,2,565.61,57.5,1,70.916,41,7,18,5
7.745,12,8,52.87,49,82,88.77,79,33,34,51.486,2,623.72,66.5,1,80.171,46,7,24,5
7.854,12,7,51.108,48,79,85.355,76,31,33,49.959,2,609.69,65.5,1,77.287,45,7,24,5
6.928,10,10,46.961,41,74,81.351,72,33,29,45.056,2,531.67,54.5,1,72.516,39,5,17,5
8.0,14,8,47.256,45,74,81.359,72,29,29,46.862,2,591.63,60.5,1,74.058,43,9,19,5
7.658,13,8,45.801,43,72,79.149,70,29,28,45.147,2,563.62,57.5,1,71.731,41,8,18,5
4.914,11,5,28.42,28,45,48.717,43,17,15,27.899,0,384.31,35.0,0,44.865,26,8,10,2
5.489,11,6,30.182,29,48,52.132,46,19,16,29.426,0,398.34,36.0,0,47.749,27,8,10,2
4.481,12,6,30.636,30,49,53.342,47,19,16,30.141,0,414.34,37.0,0,49.076,28,9,10,2
4.947,12,5,29.426,29,47,51.215,45,18,15,28.921,0,399.33,36.0,0,46.967,27,8,10,3
4.951,12,6,38.159,37,60,64.172,57,23,22,37.194,0,490.44,47.0,0,58.844,34,9,16,2
5.893,12,5,28.875,29,46,49.927,44,17,15,28.614,0,400.31,36.0,0,46.193,27,9,10,2
4.319,12,7,32.949,31,53,58.046,51,22,17,31.974,0,427.39,38.0,0,52.734,29,8,10,3
4.01,12,5,29.665,30,46,49.8,44,16,16,29.394,1,409.32,39.0,1,46.084,28,8,10,3
4.03,14,6,29.994,32,48,53.151,46,16,16,30.576,0,452.31,39.0,0,49.287,30,8,10,2
5.893,13,5,30.881,31,49,53.425,47,18,16,30.636,0,427.34,39.0,0,49.295,29,9,11,3
4.535,12,5,29.773,29,45,48.559,43,16,15,28.925,0,463.2,36.0,0,45.095,27,8,10,2
4.336,13,6,32.091,32,51,55.551,49,19,17,31.856,0,442.35,40.0,0,51.404,30,10,11,2
5.691,13,6,24.119,24,40,45.01,39,16,10,24.109,0,353.26,28.0,0,41.411,23,9,4,3
5.186,13,5,24.562,23,36,40.106,35,13,9,23.184,0,449.12,27.0,0,37.269,22,8,4,3
5.854,13,5,21.841,23,36,40.725,35,13,9,22.25,0,341.22,27.0,0,37.713,22,8,4,3
5.401,12,5,21.903,22,36,40.385,35,14,9,21.867,0,323.23,26.0,0,37.2,21,8,4,3
4.465,13,5,23.256,23,36,40.227,35,13,9,22.892,0,402.12,27.0,0,37.429,22,8,4,3
5.074,13,5,22.761,23,36,40.329,35,13,9,22.695,0,357.67,27.0,0,37.524,22,8,4,3
9.398,18,12,58.671,55,93,103.146,91,38,35,58.135,2,734.79,72.5,1,93.676,53,12,21,6
9.201,22,14,66.563,63,106,118.103,104,43,39,66.354,2,849.89,82.5,1,107.527,61,15,23,7
9.569,22,15,68.324,64,109,121.518,107,45,40,67.881,2,863.92,83.5,1,110.411,62,15,23,7
9.013,18,11,56.909,54,90,99.731,88,36,34,56.608,2,720.76,71.5,1,90.792,52,12,21,6
6.854,16,5,25.835,26,39,43.704,38,13,9,25.296,0,422.25,31.0,0,41.2,25,10,4,2
7.301,9,9,49.461,43,76,82.165,73,33,31,46.761,2,557.15,57.0,1,72.96,40,2,20,6
6.807,8,4,40.142,37,59,62.489,56,22,26,38.303,2,516.43,51.5,1,56.345,34,2,20,5
8.284,17,8,45.744,46,71,79.219,69,25,27,46.152,2,639.64,61.5,1,72.531,44,7,17,5
7.301,10,10,51.466,46,80,85.664,76,34,32,48.782,2,584.18,60.0,1,76.061,42,2,20,7
8.62,13,8,44.415,43,70,76.316,67,27,27,43.682,2,546.62,58.0,1,68.472,40,4,17,8
7.824,13,7,42.654,42,67,72.901,64,25,26,42.155,2,532.59,57.0,1,65.589,39,4,17,8
8.046,14,8,53.455,50,82,89.03,79,32,33,52.056,2,661.77,68.5,1,80.76,47,7,23,5
8.854,15,9,48.279,46,75,81.86,72,29,28,47.11,2,608.72,62.0,1,73.76,43,5,17,8
8.167,14,8,53.455,50,82,89.03,79,32,33,52.056,2,661.77,68.5,1,80.76,47,7,23,5
8.745,15,6,42.994,43,66,71.615,63,23,25,42.53,2,566.63,59.0,1,65.109,40,5,17,8
8.854,13,7,42.654,42,67,72.901,64,25,26,42.155,2,532.59,57.0,1,65.589,39,4,17,8
7.848,14,9,55.216,51,85,92.445,82,34,34,53.583,2,675.8,69.5,1,83.643,48,7,23,5
8.268,14,6,43.75,43,67,72.532,64,24,26,43.035,2,565.64,59.0,1,65.891,40,5,18,7
8.495,11,8,42.824,40,67,73.572,65,27,27,42.079,2,522.58,53.5,1,66.487,38,6,17,4
7.194,14,7,51.693,49,79,85.615,76,30,32,50.529,2,647.74,67.5,1,77.876,46,7,23,5
8.252,13,8,44.477,41,69,75.99,67,28,26,43.288,2,557.66,55.5,1,68.665,39,6,16,5
8.357,14,8,45.932,43,71,78.199,69,28,27,45.003,2,585.67,58.5,1,70.992,41,7,17,5
8.79,14,8,47.273,45,73,79.362,70,28,28,46.089,2,593.7,60.0,1,71.658,42,5,18,7
8.658,14,9,47.693,44,74,81.615,72,30,28,46.529,2,599.7,59.5,1,73.876,42,7,17,5
8.268,14,9,47.693,44,74,81.615,72,30,28,46.529,2,599.7,59.5,1,73.876,42,7,17,5
8.62,14,10,49.455,45,77,85.03,75,32,29,48.056,2,613.73,60.5,1,76.76,43,7,17,5
8.046,11,7,41.063,39,64,70.157,62,25,26,40.552,2,508.55,52.5,1,63.603,37,6,17,4
5.721,13,6,35.091,36,55,58.551,52,19,20,34.856,0,478.38,46.0,0,54.404,33,10,14,2
5.292,13,8,33.852,33,54,58.966,52,21,18,33.383,0,456.38,41.0,0,54.287,31,10,10,2
6.658,11,4,35.489,34,54,58.491,52,20,21,34.776,0,456.52,45.5,0,53.516,32,6,17,4
5.229,15,11,45.244,43,71,77.2,68,28,25,44.007,0,599.98,53.0,0,70.433,40,9,14,3
5.975,17,11,39.182,38,63,70.077,61,25,19,38.69,0,554.9,46.5,0,64.094,36,10,8,4
4.921,11,4,34.296,34,54,58.781,52,20,21,34.304,0,440.45,45.5,0,53.767,32,7,17,4
5.009,12,4,36.301,36,57,62.279,55,21,22,36.325,0,467.48,48.5,0,56.869,34,7,18,5
7.689,12,5,39.466,38,60,65.429,58,22,24,38.964,2,511.96,51.5,1,59.749,36,6,17,5
5.495,11,5,39.921,37,63,69.189,61,26,24,38.97,0,478.56,49.5,0,62.083,35,5,19,6
5.301,12,5,39.466,38,60,65.429,58,22,24,38.964,2,511.96,51.5,1,59.749,36,6,17,5
5.357,11,5,39.159,37,61,66.774,59,24,24,38.444,2,476.54,50.5,1,60.2,35,5,17,6
5.066,11,5,38.608,37,60,65.485,58,23,24,38.137,2,477.52,50.5,1,59.425,35,6,17,5
5.136,12,5,23.557,22,34,37.607,33,12,9,22.163,0,434.1,26.0,0,35.167,21,8,4,2
5.824,12,5,22.25,22,34,37.728,33,12,9,21.871,0,387.1,26.0,0,35.327,21,8,4,2
5.432,12,6,23.114,23,38,42.511,37,15,10,23.087,0,338.24,27.0,0,39.309,22,9,4,2
8.337,14,9,49.017,46,77,84.774,75,31,30,48.389,2,605.66,61.5,1,76.942,44,9,19,5
9.0,15,9,48.637,47,77,84.439,74,30,29,47.945,2,603.68,63.0,1,75.785,44,5,18,9
8.73,17,10,52.307,51,83,91.273,80,32,31,51.901,2,661.72,68.0,1,82.323,48,7,19,9
6.076,13,4,49.364,48,74,78.481,70,26,31,47.959,2,606.72,67.5,1,71.152,44,4,25,8
5.377,10,5,43.466,41,67,71.979,64,26,28,42.256,2,510.6,57.5,1,64.756,38,4,21,6
7.0,11,6,39.818,38,62,67.611,60,24,25,39.357,2,492.53,51.5,1,61.534,36,7,17,4
6.796,13,9,51.358,48,81,88.399,78,33,32,50.176,2,616.71,64.5,1,79.458,45,6,21,6
6.959,13,5,50.057,49,75,79.737,71,26,32,48.847,2,623.72,68.5,1,72.447,45,4,25,7
7.699,11,5,38.608,37,60,65.485,58,23,24,38.137,2,477.52,50.5,1,59.425,35,6,17,5
6.319,12,4,48.358,47,72,75.983,68,25,31,46.937,2,591.7,66.5,1,69.051,43,4,25,7
6.854,11,7,46.926,44,73,79.15,70,29,30,45.692,2,556.65,60.5,1,71.036,41,4,21,6
6.699,12,10,53.216,48,84,91.893,81,36,33,51.294,2,613.76,64.5,1,81.789,45,4,21,7
7.143,11,5,42.852,42,66,71.03,63,24,28,42.332,2,529.57,58.5,1,64.494,39,5,21,5
9.217,15,10,50.716,48,80,88.529,78,32,31,50.299,2,637.68,63.5,1,80.338,46,9,19,5
8.31,16,9,50.608,49,80,87.518,77,31,30,49.991,2,629.7,66.0,1,78.927,46,7,19,9
6.959,12,10,52.455,49,83,89.478,79,34,33,50.767,2,611.74,65.5,1,79.905,45,4,21,7
5.77,10,4,41.705,40,64,68.564,61,24,27,40.729,2,496.57,56.5,1,61.872,37,4,21,6
6.046,11,9,50.756,47,80,85.723,76,33,32,48.857,2,579.72,63.5,1,76.509,43,4,21,7
5.481,13,4,48.813,48,73,77.192,69,25,31,47.652,2,607.7,67.5,1,70.378,44,5,25,7
7.553,13,12,49.12,45,80,87.814,77,35,29,47.702,0,582.7,56.5,0,78.341,42,6,17,6
6.62,13,6,47.023,45,71,76.318,68,26,29,45.872,2,586.68,61.5,1,69.487,42,6,21,6
6.42,11,8,48.443,46,76,81.019,72,30,31,47.024,2,566.67,62.5,1,72.851,42,5,21,6
7.076,11,7,44.926,42,71,77.15,68,29,28,43.692,0,532.63,56.5,0,69.036,39,4,21,6
7.097,11,5,40.852,40,64,69.03,61,24,26,40.332,0,505.55,54.5,0,62.494,37,5,21,5
6.222,11,8,48.443,46,76,81.019,72,30,31,47.024,2,566.67,62.5,1,72.851,42,5,21,6
6.523,10,4,41.154,40,63,67.275,60,23,27,40.422,2,497.55,56.5,1,61.098,37,5,21,5
7.886,12,8,45.347,42,71,77.94,69,29,28,44.432,2,547.62,56.5,1,70.403,40,7,18,5
7.569,14,9,49.017,46,77,84.774,75,31,30,48.389,2,605.66,61.5,1,76.942,44,9,19,5
8.699,15,10,48.716,46,78,86.529,76,32,29,48.299,0,613.66,59.5,0,78.338,44,9,19,5
8.189,14,10,50.779,47,80,88.189,78,33,31,49.915,2,619.69,62.5,1,79.825,45,9,19,5
6.553,11,5,39.369,37,62,67.9,60,25,24,38.664,0,479.54,49.5,0,61.309,35,6,19,5
4.602,10,4,33.841,33,53,57.571,51,20,21,33.589,0,424.45,44.5,0,52.44,31,6,17,4
7.432,14,9,49.017,46,77,84.774,75,31,30,48.389,2,605.66,61.5,1,76.942,44,9,19,5
7.841,11,6,39.301,38,61,66.741,59,23,25,39.026,2,494.52,51.0,1,60.72,36,6,17,4
7.523,11,8,36.37,34,59,64.9,57,25,21,35.664,0,443.51,43.0,0,58.309,32,6,13,5
8.699,14,10,50.779,47,80,88.189,78,33,31,49.915,2,619.69,62.5,1,79.825,45,9,19,5
8.337,14,9,49.017,46,77,84.774,75,31,30,48.389,2,605.66,61.5,1,76.942,44,9,19,5
9.217,15,10,50.716,48,80,88.529,78,32,31,50.299,2,637.68,63.5,1,80.338,46,9,19,5
7.921,12,8,45.347,42,71,77.94,69,29,28,44.432,2,547.62,56.5,1,70.403,40,7,18,5
9.229,15,9,48.955,47,77,85.113,75,30,30,48.772,2,623.65,62.5,1,77.454,45,9,19,5
6.841,10,5,37.602,36,58,62.986,56,22,24,37.116,2,462.5,49.5,1,57.323,34,6,17,4
4.86,10,4,34.483,33,52,55.993,50,19,21,33.755,0,441.5,44.5,0,51.414,31,6,17,3
8.329,23,15,65.21,61,104,116.023,102,43,36,64.541,0,845.93,78.0,0,105.603,59,15,21,7
7.292,10,6,40.557,37,61,66.112,59,24,25,39.115,2,492.6,50.5,1,59.956,35,5,17,4
5.046,7,2,15.051,17,24,26.42,23,7,9,15.866,0,226.18,22.0,0,24.676,16,4,7,2
5.032,6,2,16.358,17,26,28.625,25,9,10,16.678,0,224.21,22.0,0,26.233,16,3,8,2
5.26,8,4,18.028,19,30,33.459,29,11,10,18.634,0,258.23,23.0,0,30.771,18,5,6,2
6.959,10,5,38.796,36,58,62.697,56,22,24,37.588,2,478.57,49.5,1,57.073,34,5,17,4
7.721,11,5,39.801,37,60,65.195,58,23,24,38.609,2,493.59,50.5,1,59.174,35,5,17,5
5.372,11,6,36.608,35,58,63.485,56,23,22,36.137,0,453.5,46.0,0,57.425,33,6,16,5
7.62,12,11,50.631,45,80,88.185,78,35,31,49.013,2,589.71,59.5,1,79.054,43,7,18,5
4.921,15,8,37.347,38,60,65.093,57,22,20,37.094,0,512.43,47.0,0,59.676,35,9,12,4
5.078,5,0,7.619,9,12,14.17,12,3,4,8.383,0,130.09,12.0,0,13.255,9,2,4,2
6.277,11,6,36.25,34,56,60.906,54,22,21,35.303,0,458.54,45.0,0,55.4,32,6,15,4
6.469,11,5,33.847,33,54,59.07,52,21,20,33.61,0,427.46,44.0,0,53.542,31,6,15,5
4.959,11,9,40.131,37,64,70.315,62,27,24,39.191,2,481.56,48.0,1,63.192,35,6,13,5
4.0,11,4,34.847,34,55,60.07,53,21,21,34.61,0,439.47,45.5,0,54.542,32,6,17,5
6.086,11,9,51.517,46,81,88.139,78,35,32,49.384,2,581.74,62.5,1,78.392,43,4,21,7
5.137,8,4,19.824,16,29,33.202,29,13,8,18.303,0,259.4,20.5,0,29.524,16,1,4,5
5.235,11,4,34.847,34,55,60.07,53,21,21,34.61,0,439.47,45.5,0,54.542,32,6,17,5
7.301,10,6,39.364,37,61,66.402,59,24,25,38.642,2,476.53,50.5,1,60.207,35,6,17,4
8.056,15,9,46.955,45,75,83.113,73,30,28,46.772,0,599.63,58.5,0,75.454,43,9,19,5
7.77,12,9,47.108,43,74,81.355,72,31,29,45.959,2,561.65,57.5,1,73.287,41,7,18,5
7.319,8,5,42.489,40,64,68.402,61,24,29,41.188,3,493.58,56.5,2,61.512,37,2,21,5
5.848,7,4,37.239,35,57,60.358,54,22,25,35.971,2,426.51,49.0,1,54.342,32,3,19,4
8.398,15,10,50.716,48,80,88.529,78,32,31,50.299,2,637.68,63.5,1,80.338,46,9,19,5
9.398,26,18,77.977,73,125,139.89,123,52,45,77.627,2,993.05,94.5,1,127.145,71,18,25,8
7.167,11,6,39.818,38,62,67.611,60,24,25,39.357,2,492.53,51.0,1,61.534,36,7,17,4
7.796,14,9,49.568,46,78,86.063,76,32,30,48.695,2,604.68,61.5,1,77.716,44,8,19,6
5.646,6,6,35.546,31,55,59.564,53,24,23,33.783,2,388.51,42.5,1,52.898,29,2,15,4
8.523,11,5,38.608,37,60,65.485,58,23,24,38.137,2,477.52,50.5,1,59.425,35,6,17,5
7.051,9,4,41.392,40,63,67.323,60,23,28,40.596,2,498.55,55.5,1,61.065,37,4,22,4
6.284,9,4,40.699,39,62,66.066,59,23,27,39.707,2,481.55,55.5,1,59.771,36,4,21,5
6.959,9,5,39.375,37,59,62.907,56,22,25,37.848,2,475.59,51.0,1,56.705,34,2,18,5
6.824,8,5,35.693,33,55,59.568,53,22,23,34.686,2,418.49,45.5,1,53.669,31,4,16,4
7.174,10,6,39.915,37,62,67.691,60,25,25,38.949,2,475.55,50.5,1,60.982,35,5,17,5
7.469,8,4,41.455,39,63,66.983,60,24,28,40.213,2,480.56,54.5,1,60.552,36,4,22,4
6.119,8,4,37.676,35,56,59.152,53,21,24,35.938,2,443.57,49.0,1,53.309,32,2,18,5
7.237,8,7,39.216,35,61,66.398,59,26,25,37.74,2,446.55,47.5,1,59.436,33,4,16,4
6.553,7,4,40.79,38,61,64.647,58,23,28,39.278,3,461.56,54.5,2,58.116,35,2,21,5
7.0,9,5,39.375,37,59,62.907,56,22,25,37.848,2,475.59,51.0,1,56.705,34,2,18,5
7.357,10,5,42.398,41,65,69.821,62,24,28,41.617,2,513.57,57.5,1,63.167,38,4,21,5
8.421,27,18,74.864,70,120,134.395,118,50,41,74.288,0,975.06,89.0,0,122.338,68,18,23,8
7.377,11,5,44.369,43,68,72.9,65,25,29,43.664,2,539.59,60.5,1,66.309,40,6,22,5
5.114,7,4,40.404,37,60,63.508,57,23,27,38.611,2,470.99,51.5,1,57.222,34,2,21,4
5.764,8,4,37.676,35,56,59.152,53,21,24,35.938,2,443.57,49.0,1,53.309,32,2,18,5
6.114,8,5,39.438,36,59,62.567,56,23,25,37.465,2,457.6,50.0,1,56.192,33,2,18,5
4.789,11,8,41.341,38,66,72.441,64,28,25,40.411,0,496.57,49.0,0,65.302,36,7,17,4
6.674,12,5,21.756,22,34,37.831,33,12,9,21.673,0,342.65,26.0,0,35.422,21,8,4,2
4.921,11,8,36.37,34,59,64.9,57,25,21,35.664,0,443.51,43.0,0,58.309,32,6,13,5
7.456,12,10,48.108,45,76,82.355,73,31,30,46.959,2,573.66,59.5,1,74.287,42,7,18,5
7.745,14,11,52.54,48,83,91.604,81,35,32,51.442,2,633.72,63.5,1,82.709,46,9,19,5
5.733,11,8,39.773,36,62,67.737,60,26,23,38.356,0,486.6,47.0,0,61.167,34,6,15,4
7.959,14,10,50.779,47,80,88.189,78,33,31,49.915,2,619.69,62.5,1,79.825,45,9,19,5
8.699,14,9,49.017,46,77,84.774,75,31,30,48.389,2,605.66,61.5,1,76.942,44,9,19,5
5.866,12,6,36.188,35,56,61.246,54,21,21,35.686,0,476.53,46.0,0,55.913,33,6,15,4
8.523,15,11,50.477,47,81,89.944,79,34,30,49.825,0,627.69,60.5,0,81.221,45,9,19,5
6.721,13,7,37.193,36,58,63.744,56,22,21,36.707,0,491.55,47.0,0,58.014,34,6,14,5
6.174,11,6,36.25,34,56,60.906,54,22,21,35.303,0,458.54,45.0,0,55.4,32,6,15,4
7.398,11,6,38.608,37,60,65.485,58,23,24,38.137,2,477.52,50.0,1,59.425,35,6,16,5
8.585,14,11,52.54,48,83,91.604,81,35,32,51.442,2,633.72,63.5,1,82.709,46,9,19,5
8.62,14,9,47.387,47,75,80.395,71,28,29,46.728,2,584.65,63.0,1,72.614,43,6,18,8
9.377,14,11,51.779,49,82,89.189,79,33,32,50.915,2,631.7,64.5,1,80.825,46,9,19,5
4.947,9,3,29.074,30,45,49.338,43,15,19,29.353,2,388.38,40.5,1,44.785,28,2,14,4
6.456,11,6,36.608,35,58,63.485,56,23,22,36.137,0,453.5,46.0,0,57.425,33,6,16,5
8.658,16,11,53.37,52,85,91.933,81,33,32,52.518,2,655.74,69.0,1,82.811,48,7,19,9
9.585,18,12,57.04,56,91,98.767,87,35,34,56.474,2,713.78,74.0,1,89.349,52,9,20,9
9.678,15,11,54.477,51,85,93.944,83,34,34,53.825,4,675.73,68.5,2,85.221,49,9,19,5
8.699,14,10,50.779,47,80,88.189,78,33,31,49.915,2,619.69,62.5,1,79.825,45,9,19,5
6.0,9,4,34.131,31,52,56.361,50,21,20,32.653,2,411.53,43.5,1,50.636,29,3,14,5
4.668,10,5,35.051,34,55,59.698,53,21,22,34.809,0,439.46,45.5,0,54.549,32,7,17,3
5.0,12,4,36.852,36,58,63.568,56,22,22,36.632,0,466.5,48.5,0,57.643,34,6,18,6
6.222,11,5,37.159,35,59,64.774,57,24,22,36.444,0,452.52,46.5,0,58.2,33,5,17,6
6.292,9,3,30.074,31,46,50.338,44,15,20,30.353,2,400.39,42.5,1,45.785,29,2,15,4
5.301,11,4,35.398,34,56,61.358,54,22,21,34.917,0,438.49,45.5,0,55.316,32,5,17,6
7.481,11,5,37.159,35,59,64.774,57,24,22,36.444,0,452.52,46.5,0,58.2,33,5,17,6
5.082,10,6,36.602,36,58,61.986,55,22,23,36.116,0,450.49,47.5,0,56.323,33,6,17,4
5.845,11,6,39.301,38,61,66.741,59,23,25,39.026,2,494.52,51.0,1,60.72,36,6,17,4
6.921,11,6,37.301,36,59,64.741,57,23,23,37.026,0,470.5,47.0,0,58.72,34,6,17,4
6.143,10,7,38.364,37,61,65.402,58,24,24,37.642,0,464.52,48.5,0,59.207,34,6,17,4
5.021,10,6,39.364,37,61,66.402,59,24,25,38.642,2,476.53,50.5,1,60.207,35,6,17,4
4.778,11,5,34.847,34,55,60.07,53,21,21,34.61,0,439.47,45.5,0,54.542,32,6,16,5
5.585,9,5,38.761,36,58,62.638,56,22,25,37.734,2,479.95,49.5,1,57.102,34,5,18,3
4.553,11,4,33.085,33,52,56.654,50,19,20,33.083,0,425.44,44.5,0,51.658,31,6,16,5
8.456,14,11,51.779,49,82,89.189,79,33,32,50.915,2,631.7,64.5,1,80.825,46,9,19,5
6.62,13,6,47.023,45,71,76.318,68,26,29,45.872,2,586.68,61.0,1,69.487,42,6,21,6
5.201,9,6,40.119,37,62,67.319,60,25,26,39.148,2,475.54,50.5,1,60.989,35,6,18,3
5.886,11,7,40.477,37,62,67.658,60,25,24,39.194,0,545.43,48.0,0,61.32,35,6,17,4
5.873,13,6,39.761,39,63,69.449,61,24,24,39.762,0,513.53,51.0,0,63.149,37,7,18,5
5.244,13,6,39.176,40,61,67.421,59,21,25,39.792,2,530.5,53.0,1,61.745,38,6,17,4
7.119,11,6,40.063,38,63,69.157,61,25,25,39.552,0,496.54,50.0,0,62.603,36,6,19,4
9.77,16,11,53.37,52,85,91.933,81,33,32,52.518,2,655.74,69.0,1,82.811,48,7,19,9
9.377,14,11,51.779,49,82,89.189,79,33,32,50.915,2,631.7,64.5,1,80.825,46,9,19,5
6.886,13,6,40.517,40,63,68.904,61,23,25,40.567,2,521.53,55.0,1,63.08,38,8,17,5
6.027,10,7,39.125,36,62,67.817,60,26,24,38.169,0,466.54,47.0,0,61.091,34,6,17,4
7.796,12,10,48.87,44,77,84.77,75,33,30,47.486,2,575.68,58.5,1,76.171,42,7,18,5
7.699,12,10,48.87,44,77,84.77,75,33,30,47.486,2,575.68,58.5,1,76.171,42,7,18,5
7.046,11,6,39.818,38,62,67.611,60,24,25,39.357,2,492.53,51.0,1,61.534,36,7,17,4
8.678,16,11,53.37,52,85,91.933,81,33,32,52.518,2,655.74,69.0,1,82.811,48,7,19,9
8.699,14,9,49.017,46,77,84.774,75,31,30,48.389,2,605.66,61.5,1,76.942,44,9,19,5
6.77,10,7,49.199,45,76,81.936,73,31,32,47.529,2,565.68,61.5,1,73.632,42,5,23,5
6.194,11,6,37.818,36,60,65.611,58,24,23,37.357,0,468.51,47.0,0,59.534,34,7,17,4
6.77,12,6,38.546,38,60,65.824,58,22,24,38.52,1,495.51,51.0,1,59.938,36,6,17,5
7.005,11,6,39.818,38,62,67.611,60,24,25,39.357,2,492.53,51.0,1,61.534,36,7,17,4
7.155,10,8,43.438,39,68,74.521,66,29,27,42.003,2,503.61,52.5,1,66.749,37,5,17,5
7.0,11,6,39.301,38,61,66.741,59,23,25,39.026,2,494.52,51.0,1,60.72,36,6,17,4
7.745,12,8,45.347,42,71,77.94,69,29,28,44.432,2,547.62,56.5,1,70.403,40,7,18,5
9.481,14,11,51.779,49,82,89.189,79,33,32,50.915,2,631.7,64.5,1,80.825,46,9,19,5
6.301,10,7,41.125,38,64,69.817,62,26,26,40.169,2,490.56,51.0,1,63.091,36,6,17,4
7.174,11,7,41.58,39,65,71.026,63,26,26,40.884,2,506.56,52.0,1,64.418,37,7,17,4
7.131,11,6,40.222,38,61,66.346,59,23,25,39.47,2,510.97,51.0,1,60.531,36,6,17,4
6.319,10,6,40.125,37,63,68.817,61,26,25,39.169,0,478.55,49.0,0,62.091,35,6,19,4
7.31,12,9,45.108,41,72,79.355,70,31,27,43.959,0,537.63,53.5,0,71.287,39,7,18,5
7.194,10,7,41.676,38,65,71.106,63,27,26,40.476,2,489.58,51.5,1,63.865,36,5,17,5
7.854,12,9,47.108,43,74,81.355,72,31,29,45.959,2,561.65,57.5,1,73.287,41,7,18,5
8.699,14,10,50.779,47,80,88.189,78,33,31,49.915,2,619.69,62.5,1,79.825,45,9,19,5
7.222,12,5,35.494,34,55,59.99,53,21,20,34.797,0,459.53,45.0,0,54.618,32,6,15,5
5.921,11,6,42.983,40,65,70.761,63,25,27,41.997,2,537.01,54.5,1,64.414,38,6,19,4
7.018,10,5,39.767,37,60,65.136,58,23,25,38.755,2,494.97,50.5,1,59.203,35,5,18,4
6.097,8,7,41.426,37,64,69.524,62,27,27,39.96,2,473.57,50.5,1,62.545,35,5,18,3
5.046,10,6,40.977,38,62,67.263,60,24,26,39.975,2,509.98,51.5,1,61.313,36,6,18,3
5.979,10,7,40.739,37,63,68.678,61,26,25,39.502,0,499.99,48.5,0,62.196,35,6,18,3
6.658,9,6,41.017,37,61,65.951,59,24,26,39.458,2,538.43,50.5,1,59.891,35,5,18,3
7.301,9,10,50.461,45,78,83.165,74,33,32,47.761,2,569.16,59.0,1,73.96,41,2,20,6
9.284,15,8,46.517,45,72,78.445,69,27,27,45.584,2,594.69,61.0,1,70.876,42,5,17,8
9.208,16,8,48.182,47,75,81.781,72,28,28,47.519,2,625.7,64.0,1,74.312,44,7,18,7
8.699,14,6,42.54,42,65,70.405,62,23,25,41.815,2,550.63,57.0,1,63.782,39,4,17,8
8.469,14,9,47.824,45,74,80.651,71,29,28,46.396,2,592.72,60.0,1,72.432,42,4,17,8
7.812,17,8,54.608,53,84,91.532,81,31,33,53.98,2,706.77,73.5,1,83.632,50,9,23,6
7.873,14,8,45.932,43,71,78.199,69,28,27,45.003,2,585.67,58.5,1,70.992,41,7,17,5
8.699,15,7,44.756,44,69,75.03,66,25,26,44.057,2,580.66,60.0,1,67.992,41,5,17,8
8.495,14,11,51.216,46,80,88.445,78,34,30,49.583,2,627.76,61.5,1,79.643,44,7,17,5
8.721,14,9,47.693,44,74,81.615,72,30,28,46.529,2,599.7,59.5,1,73.876,42,7,17,5
8.143,14,8,53.455,50,82,89.03,79,32,33,52.056,2,661.77,68.5,1,80.76,47,7,23,5
8.237,14,7,44.301,43,68,73.821,65,25,26,43.342,2,564.66,58.0,1,66.665,40,4,17,8
8.796,11,10,46.347,42,73,80.402,71,31,29,45.133,2,550.64,55.5,1,72.254,40,6,17,4
6.398,11,6,40.369,38,63,68.9,61,25,25,39.664,2,491.55,51.5,1,62.309,36,6,17,5
4.523,13,5,35.648,35,57,62.94,55,22,20,35.433,0,454.5,46.5,0,56.636,33,5,15,8
6.665,11,5,36.608,35,58,63.485,56,23,22,36.137,0,453.5,46.5,0,57.425,33,6,17,5
7.377,12,9,47.108,43,74,81.355,72,31,29,45.959,2,561.65,57.5,1,73.287,41,7,18,5
8.0,11,5,44.369,43,68,72.9,65,25,29,43.664,2,539.59,60.5,1,66.309,40,6,22,5
5.917,10,4,41.557,40,62,66.01,59,22,27,40.535,2,515.99,56.5,1,60.094,37,4,21,5
6.194,11,7,46.892,44,73,78.73,70,29,30,45.717,2,555.64,60.5,1,71.076,41,6,21,5
9.587,15,11,52.477,49,83,91.944,81,34,32,51.825,2,651.71,64.5,1,83.221,47,9,19,5
7.0,12,9,50.142,48,79,84.774,75,31,32,48.934,2,598.69,64.5,1,76.247,44,5,21,6
7.469,14,9,47.017,44,75,82.774,73,31,28,46.389,0,581.64,57.5,0,74.942,42,9,19,5
5.983,14,4,49.818,49,75,79.69,71,26,31,48.673,2,622.72,68.5,1,72.48,45,5,25,8
6.745,13,5,46.023,44,70,75.318,67,26,28,44.872,2,574.67,62.5,1,68.487,41,6,21,6
7.745,12,8,52.87,49,82,88.77,79,33,34,51.486,2,623.72,66.5,1,80.171,46,7,24,5
7.523,12,8,52.87,49,82,88.77,79,33,34,51.486,2,623.72,66.5,1,80.171,46,7,24,5
8.721,14,10,50.779,47,80,88.189,78,33,31,49.915,2,619.69,62.5,1,79.825,45,9,19,5
7.62,15,9,45.903,43,72,79.279,70,29,26,45.049,0,587.67,56.0,0,72.134,41,9,17,5
4.31,10,4,33.29,33,52,56.282,50,19,21,33.282,0,425.43,44.5,0,51.665,31,7,17,3
8.721,15,9,48.955,47,77,85.113,75,30,30,48.772,2,623.65,62.5,1,77.454,45,9,19,5
8.124,19,12,55.557,52,88,97.651,86,36,31,54.795,0,716.8,67.0,0,88.869,50,12,19,6
8.827,14,9,49.017,46,77,84.774,75,31,30,48.389,2,605.66,61.5,1,76.942,44,9,19,5
5.975,10,5,35.602,34,56,60.986,54,22,22,35.116,0,438.48,45.5,0,55.323,32,6,17,4
5.301,13,5,40.324,39,60,65.373,58,21,24,39.792,2,546.4,52.5,1,60.073,37,6,17,5
9.456,15,12,54.239,50,86,95.359,84,36,33,53.352,2,665.74,65.5,1,86.105,48,9,19,5
5.658,11,5,36.608,35,58,63.485,56,23,22,36.137,0,453.5,46.5,0,57.425,33,6,17,5
7.301,12,8,45.347,42,71,77.94,69,29,28,44.432,2,547.62,56.5,1,70.403,40,7,18,5
7.638,15,10,48.716,46,78,86.529,76,32,29,48.299,0,613.66,59.5,0,78.338,44,9,19,5
8.086,14,11,50.54,46,81,89.604,79,35,30,49.442,0,609.7,59.5,0,80.709,44,9,19,5
8.066,14,10,50.779,47,80,88.189,78,33,31,49.915,2,619.69,62.5,1,79.825,45,9,19,5
5.886,11,4,34.847,34,55,60.07,53,21,21,34.61,0,439.47,45.5,0,54.542,32,6,17,5
8.337,14,10,48.779,45,78,86.189,76,33,29,47.915,0,595.67,58.5,0,77.825,43,9,19,5
6.824,11,5,37.159,35,59,64.774,57,24,22,36.444,0,452.52,46.5,0,58.2,33,5,17,6
6.585,10,6,38.557,35,59,64.112,57,24,23,37.115,0,468.58,46.5,0,57.956,33,5,17,4
6.721,12,4,36.256,35,56,61.302,54,21,21,35.744,0,472.93,46.5,0,55.64,33,5,17,6
8.959,15,11,52.477,49,83,91.944,81,34,32,51.825,2,651.71,64.5,1,83.221,47,9,19,5
6.0,11,5,38.608,37,60,65.485,58,23,24,38.137,2,477.52,50.5,1,59.425,35,6,17,5
7.009,12,4,36.256,35,56,61.302,54,21,21,35.744,0,472.93,46.5,0,55.64,33,5,17,6
5.398,12,4,35.705,35,55,60.014,53,20,21,35.438,0,473.91,46.5,0,54.865,33,6,17,5
5.631,12,6,35.852,35,57,62.568,55,22,21,35.632,0,454.49,46.0,0,56.643,33,6,15,6
6.563,10,6,37.364,35,59,64.402,57,24,23,36.642,0,452.51,46.0,0,58.207,33,6,17,4
6.31,13,6,35.949,35,56,61.199,54,21,20,35.512,0,475.53,46.0,0,55.945,33,7,14,5
8.432,31,21,84.517,79,136,152.767,134,57,46,84.034,0,1104.19,100.0,0,139.072,77,21,25,9
5.759,13,8,39.472,37,62,68.029,60,25,22,38.566,0,503.59,48.0,0,61.713,35,7,14,5
5.921,12,7,38.466,36,60,65.531,58,24,22,37.544,0,488.57,47.0,0,59.611,34,7,15,4
5.474,12,8,40.227,37,63,68.946,61,26,23,39.071,0,502.6,48.0,0,62.494,35,7,15,4
4.606,11,5,34.489,33,53,57.491,51,20,20,33.776,0,444.51,44.0,0,52.516,31,6,15,4
6.237,11,7,38.011,35,59,64.322,57,24,22,36.829,0,472.57,46.0,0,58.283,33,6,15,4
5.775,11,6,39.011,36,60,65.322,58,24,23,37.829,0,484.58,48.0,0,59.283,34,6,17,4
6.119,12,7,37.256,35,58,63.405,56,23,21,36.324,0,473.56,46.0,0,57.502,33,6,14,5
6.004,9,7,42.284,38,64,69.468,62,26,27,40.787,2,508.01,51.5,1,62.869,36,5,18,3
8.699,14,11,50.909,49,81,87.225,77,32,31,49.782,2,612.71,65.0,1,78.381,45,6,18,8
6.377,13,7,37.71,36,59,64.614,57,23,21,37.039,0,489.56,47.0,0,58.829,34,7,14,5
8.046,11,7,41.063,39,64,70.157,62,25,26,40.552,2,508.55,52.5,1,63.603,37,6,17,4
5.866,12,6,36.705,35,57,62.116,55,22,21,36.017,0,474.54,46.0,0,56.727,33,7,15,4
6.119,11,6,39.369,37,62,67.9,60,25,24,38.664,0,479.54,49.0,0,61.309,35,6,18,5
6.77,8,5,43.216,40,66,70.398,63,26,29,41.74,2,494.59,55.5,1,63.436,37,4,22,4
5.74,6,3,37.784,35,57,60.149,54,22,26,36.256,2,422.52,49.5,1,54.014,32,2,21,4
5.412,13,7,32.091,32,51,55.551,49,19,17,31.856,0,442.35,40.0,0,51.404,30,10,10,2
6.796,12,7,38.307,37,61,67.24,59,24,23,38.047,0,485.52,48.0,0,60.822,35,6,16,5
6.194,7,2,29.506,28,45,48.402,43,17,19,28.697,2,347.41,39.5,1,43.465,26,2,15,5
6.357,11,6,38.25,36,58,62.906,56,22,23,37.303,2,482.56,49.0,1,57.4,34,6,15,4
5.959,12,6,37.239,37,59,65.081,57,22,23,37.409,0,488.49,48.5,0,59.232,35,6,17,4
5.971,12,6,38.256,36,59,64.405,57,23,22,37.324,0,485.57,48.0,0,58.502,34,6,16,5
9.222,14,8,46.063,44,71,77.236,68,27,27,44.869,2,578.69,59.0,1,69.549,41,4,17,8
5.77,12,6,39.239,39,61,67.081,59,22,25,39.409,2,512.51,52.5,1,61.232,37,6,17,4
6.658,10,5,45.125,43,69,73.817,66,26,30,44.169,2,538.6,59.0,1,67.091,40,6,23,4
7.237,11,5,37.54,37,58,63.326,56,21,24,37.499,2,480.49,50.0,1,57.836,35,6,17,4
6.022,12,6,37.239,37,59,65.081,57,22,23,37.409,0,488.49,48.5,0,59.232,35,6,17,4
7.695,11,5,38.608,37,60,65.485,58,23,24,38.137,2,477.52,50.5,1,59.425,35,6,17,5
6.26,11,4,35.398,34,56,61.358,54,22,21,34.917,0,438.49,45.5,0,55.316,32,5,17,6
6.26,12,7,37.949,36,59,64.661,57,23,22,37.213,0,490.56,47.0,0,58.796,34,6,15,4
6.208,10,6,45.228,42,70,75.395,67,28,29,43.782,2,524.63,58.5,1,67.64,39,4,21,6
5.951,10,5,38.364,36,60,65.402,58,24,24,37.642,0,464.52,48.5,0,59.207,34,6,19,4
6.032,12,7,37.949,36,59,64.661,57,23,22,37.213,0,490.56,47.0,0,58.796,34,6,15,4
7.77,14,10,48.779,45,78,86.189,76,33,29,47.915,0,595.67,58.5,0,77.825,43,9,19,5
6.638,12,7,37.256,35,58,63.405,56,23,21,36.324,0,473.56,46.0,0,57.502,33,6,14,5
5.148,12,5,33.733,33,52,56.574,50,19,19,33.271,0,445.5,44.0,0,51.734,31,6,14,5
6.638,12,6,37.494,36,57,61.99,55,21,22,36.797,2,483.55,49.0,1,56.618,34,6,14,5
4.509,11,5,40.67,39,61,66.057,59,22,26,40.163,2,523.96,53.5,1,60.756,37,7,19,3
5.102,8,6,39.665,36,61,66.109,59,25,26,38.433,2,459.54,49.5,1,59.662,34,5,18,3
4.018,7,5,32.688,30,51,55.069,49,21,21,31.665,2,379.45,40.5,1,49.567,28,4,14,3
7.398,10,6,39.364,37,61,66.402,59,24,25,38.642,2,476.53,50.0,1,60.207,35,6,17,4
6.824,11,7,38.369,36,61,66.9,59,25,23,37.664,0,467.53,47.0,0,60.309,34,6,16,5
9.108,14,12,53.54,50,85,92.604,82,35,33,52.442,2,645.73,65.5,1,83.709,47,9,19,5
6.027,13,7,36.5,35,57,62.488,55,22,20,35.819,0,474.55,46.0,0,56.72,33,6,13,6
5.987,12,7,38.466,36,60,65.531,58,24,22,37.544,0,488.57,47.0,0,59.611,34,7,15,4
6.42,10,4,41.943,41,63,67.149,60,22,28,41.202,3,506.56,59.5,2,60.989,38,4,21,6
9.0,18,12,59.767,56,93,103.137,91,37,36,59.136,2,770.23,73.5,1,93.967,54,11,22,5
8.854,11,9,44.585,41,70,76.987,68,29,28,43.606,2,536.61,54.5,1,69.371,39,6,17,4
6.678,10,7,39.125,36,62,67.817,60,26,24,38.169,0,466.54,47.0,0,61.091,34,6,17,4
7.886,13,6,43.296,42,66,71.322,63,24,26,42.321,2,549.64,57.0,1,64.563,39,4,18,7
5.511,12,6,37.494,36,57,61.99,55,21,22,36.797,1,483.55,49.0,1,56.618,34,6,15,5
5.215,11,5,39.369,37,62,67.9,60,25,24,38.664,0,479.54,49.5,0,61.309,35,6,19,5
6.658,13,7,37.193,36,58,63.744,56,22,21,36.707,0,491.55,47.0,0,58.014,34,6,14,5
7.252,10,5,40.398,39,63,67.821,60,24,26,39.617,0,489.55,53.5,0,61.167,36,4,21,5
6.377,12,6,35.494,34,55,59.99,53,21,20,34.797,0,459.53,45.0,0,54.618,32,6,14,5
5.971,13,7,37.886,37,59,65.001,57,22,22,37.596,0,508.55,48.0,0,59.309,35,6,15,4
7.319,11,5,39.705,38,60,65.476,58,22,25,39.138,2,512.96,51.5,1,59.716,36,5,18,4
9.108,14,9,48.79,47,76,81.232,72,29,29,47.42,2,603.72,64.0,1,73.472,43,6,18,7
8.62,15,10,58.739,55,91,97.813,87,36,36,56.936,2,712.85,74.5,1,88.56,51,8,24,6
8.585,14,12,53.222,50,85,91.929,81,35,32,51.615,2,625.76,66.0,1,82.04,46,5,18,9
8.959,12,10,48.108,45,76,82.355,73,31,30,46.959,2,573.66,59.5,1,74.287,42,7,18,5
8.658,14,10,49.699,48,79,85.099,75,31,30,48.561,2,597.7,64.0,1,76.272,44,5,18,9
8.77,14,9,47.387,47,75,80.395,71,28,29,46.728,2,584.65,63.0,1,72.614,43,6,18,8
4.316,14,5,29.574,31,47,51.219,45,16,15,29.824,0,429.31,40.0,0,47.738,29,10,10,3
9.699,16,11,53.37,52,85,91.933,81,33,32,52.518,2,655.74,69.0,1,82.811,48,7,19,9
4.0,6,2,26.142,25,38,40.223,36,13,17,25.262,2,324.79,35.5,1,36.476,23,1,13,4
6.114,6,3,30.262,28,46,49.318,44,18,20,29.203,2,346.42,39.5,1,44.247,26,2,15,4
4.959,6,2,27.756,26,39,41.084,37,13,18,26.595,2,358.24,36.5,1,37.582,24,1,14,3
5.886,6,2,28.29,27,42,44.777,40,15,19,27.456,3,329.39,39.5,2,40.254,25,1,14,5
8.357,12,5,44.307,44,68,73.24,65,24,29,44.047,2,557.58,61.5,1,66.822,41,6,22,5
6.208,8,2,28.199,28,43,46.196,41,15,18,27.885,2,349.38,40.5,1,41.909,26,3,14,5
4.64,6,5,33.784,30,52,56.149,50,22,22,32.256,2,374.48,41.5,1,50.014,28,2,15,4
5.836,7,4,38.432,35,57,60.069,54,22,25,36.443,2,442.58,49.0,1,54.091,32,2,19,4
6.959,9,4,40.699,39,62,66.066,59,23,27,39.707,2,481.55,55.5,1,59.771,36,4,21,5
6.347,7,4,38.79,36,59,62.647,56,23,26,37.278,2,437.54,50.5,1,56.116,33,2,20,5
5.62,5,3,29.256,27,44,46.82,42,17,20,28.181,2,331.4,38.5,1,42.145,25,2,15,3
8.155,9,9,42.676,38,67,73.568,65,29,27,41.176,2,492.6,50.5,1,65.716,36,4,16,4
4.939,6,2,26.983,26,41,44.034,39,15,18,26.345,2,322.37,36.5,1,39.549,24,1,14,4
6.066,8,4,37.676,35,56,59.152,53,21,24,35.938,2,443.57,49.0,1,53.309,32,2,18,5
5.377,6,4,32.023,29,49,52.734,47,20,21,30.73,2,360.45,40.5,1,47.131,27,2,15,4
6.284,8,4,33.932,32,52,56.152,50,20,22,33.159,2,404.46,44.5,1,50.785,30,4,16,4
5.86,7,4,37.239,35,57,60.358,54,22,25,35.971,2,426.51,49.0,1,54.342,32,3,19,4
6.943,8,5,40.489,38,62,66.402,59,24,27,39.188,2,469.56,52.5,1,59.512,35,2,20,5
7.62,11,4,42.608,42,65,69.485,62,23,28,42.137,2,525.56,59.5,1,63.425,39,6,22,5
6.796,9,4,41.909,40,64,68.192,61,24,28,40.928,2,496.56,55.5,1,61.88,37,5,22,4
7.237,8,8,40.978,36,64,69.813,62,28,26,39.266,2,460.58,48.5,1,62.32,34,4,16,4
7.398,10,6,39.364,37,61,66.402,59,24,25,38.642,2,476.53,50.5,1,60.207,35,6,17,4
8.222,9,8,40.915,37,64,70.153,62,27,26,39.65,2,478.57,49.5,1,62.832,35,4,16,4
6.495,9,4,40.699,39,62,66.066,59,23,27,39.707,2,481.55,55.5,1,59.771,36,4,21,5
7.377,8,7,39.216,35,61,66.398,59,26,25,37.74,2,446.55,47.5,1,59.436,33,4,16,4
6.143,6,4,39.546,36,60,63.564,57,24,27,37.783,2,436.55,50.5,1,56.898,33,2,21,4
6.569,8,4,41.455,39,63,66.983,60,24,28,40.213,2,480.56,54.5,1,60.552,36,4,22,4
5.075,11,7,38.011,35,59,64.322,57,24,22,36.829,0,472.57,46.0,0,58.283,33,6,15,4
4.606,11,5,34.489,33,53,57.491,51,20,20,33.776,0,444.51,43.5,0,52.516,31,6,15,4
5.971,10,7,39.125,36,62,67.817,60,26,24,38.169,0,466.54,47.5,0,61.091,34,6,17,4
5.0,12,4,36.852,36,58,63.568,56,22,22,36.632,0,466.5,48.5,0,57.643,34,6,18,6
4.877,12,7,38.466,36,60,65.531,58,24,22,37.544,0,488.57,47.0,0,59.611,34,7,15,4
5.082,10,5,35.602,34,56,60.986,54,22,22,35.116,0,438.48,45.5,0,55.323,32,6,17,4
5.347,10,5,35.602,34,56,60.986,54,22,22,35.116,0,438.48,45.0,0,55.323,32,6,17,4
5.172,11,5,35.54,35,56,61.326,54,21,22,35.499,0,456.47,46.5,0,55.836,33,6,17,4
5.485,10,5,37.602,37,59,62.986,56,22,24,37.116,0,462.5,50.5,0,57.323,34,6,19,4
4.85,11,6,39.011,36,60,65.322,58,24,23,37.829,0,484.58,48.0,0,59.283,34,6,17,4
5.418,11,6,36.25,34,56,60.906,54,22,21,35.303,0,458.54,45.0,0,55.4,32,6,15,4
5.156,11,5,34.489,33,53,57.491,51,20,20,33.776,0,444.51,44.0,0,52.516,31,6,15,4
4.987,10,4,34.483,33,52,55.993,50,19,21,33.755,0,441.5,44.5,0,51.414,31,6,17,3
5.332,10,5,36.244,34,55,59.408,53,21,22,35.281,0,455.53,45.5,0,54.298,32,6,17,3
6.222,12,6,39.239,39,61,67.081,59,22,25,39.409,2,512.51,52.5,1,61.232,37,6,17,4
5.943,11,6,37.301,36,59,64.741,57,23,23,37.026,0,470.5,47.0,0,58.72,34,6,17,4
6.824,10,7,40.364,39,63,67.402,60,24,26,39.642,2,488.54,52.5,1,61.207,36,6,17,4
5.582,10,6,37.364,35,59,64.402,57,24,23,36.642,0,452.51,46.5,0,58.207,33,6,17,4
5.367,10,6,37.364,35,59,64.402,57,24,23,36.642,0,452.51,46.5,0,58.207,33,6,17,4
5.004,12,7,37.949,36,59,64.661,57,23,22,37.213,0,490.56,47.0,0,58.796,34,6,15,4
6.699,11,5,36.608,35,58,63.485,56,23,22,36.137,0,453.5,46.5,0,57.425,33,6,17,5
7.097,12,6,39.239,39,61,67.081,59,22,25,39.409,2,512.51,52.5,1,61.232,37,6,17,4
4.959,12,4,36.301,36,57,62.279,55,21,22,36.325,0,467.48,48.5,0,56.869,34,7,18,5
6.0,12,6,37.239,37,59,65.081,57,22,23,37.409,0,488.49,48.5,0,59.232,35,6,17,4
6.155,11,6,38.369,36,61,66.9,59,25,23,37.664,0,467.53,47.5,0,60.309,34,6,17,5
7.611,12,5,20.835,22,34,38.226,33,12,9,21.229,0,326.2,26.0,0,35.611,21,8,4,2
9.222,8,5,17.028,18,29,32.459,28,11,9,17.634,0,246.22,21.0,0,29.771,17,5,4,2
5.051,9,7,43.074,38,65,70.444,63,27,27,41.147,2,505.64,51.5,1,63.622,36,5,18,3
7.194,10,5,39.619,37,58,62.582,56,21,25,38.561,2,514.39,50.5,1,57.425,35,5,18,3
6.602,9,6,40.523,37,61,66.053,59,24,26,39.26,2,493.98,50.5,1,59.985,35,5,18,3
6.208,10,6,40.46,38,61,66.393,59,23,26,39.644,2,511.97,51.5,1,60.498,36,5,18,3
5.721,10,7,40.887,37,65,71.232,63,28,25,39.696,0,480.57,48.5,0,63.974,35,6,18,4
6.456,9,6,40.671,37,63,68.607,61,26,26,39.454,2,474.56,50.5,1,61.763,35,5,18,4
5.222,9,7,41.881,38,65,70.734,63,27,27,40.675,2,489.57,51.5,1,63.872,36,6,18,3
7.018,10,6,40.955,38,61,66.29,59,23,26,39.841,2,556.42,51.5,1,60.403,36,5,18,3
7.638,11,5,39.557,38,58,62.922,56,20,25,38.944,2,532.38,51.5,1,57.938,36,5,18,3
5.638,9,6,38.523,35,59,64.053,57,24,24,37.26,0,469.96,46.5,0,57.985,33,5,18,3
5.947,9,6,38.523,35,59,64.053,57,24,24,37.26,0,469.96,46.5,0,57.985,33,5,18,3
6.824,10,6,40.977,38,62,67.263,60,24,26,39.975,2,509.98,51.5,1,61.313,36,6,18,3
4.42,9,5,36.761,34,56,60.638,54,22,23,35.734,0,455.93,45.5,0,55.102,32,5,18,3
5.63,14,8,36.102,35,58,64.01,56,23,19,35.599,0,487.42,43.0,0,58.458,33,9,11,3
5.824,9,6,40.909,38,62,67.192,60,24,27,39.928,3,484.55,53.5,2,60.88,36,5,18,4
6.921,9,6,40.523,37,61,66.053,59,24,26,39.26,2,493.98,50.5,1,59.985,35,5,18,3
7.188,10,6,40.46,38,61,66.393,59,23,26,39.644,2,511.97,51.5,1,60.498,36,5,18,3
6.131,9,7,40.284,36,62,67.468,60,26,25,38.787,0,483.99,47.5,0,60.869,34,5,18,3
5.721,11,5,41.222,39,62,67.346,60,23,26,40.47,2,522.98,53.5,1,61.531,37,6,19,4
6.824,12,6,40.335,40,61,67.072,59,21,26,40.41,2,547.95,53.5,1,61.523,38,5,18,3
