pXC50,RBN,nCsp2,nBM,nCsp3,nBT,H.,nSK,nHet,nDB,RBF,Se,Si,nO,nAT,nH,Mv,nBO
8.52,20,21,23,14,96,46.8,50,15,7,0.208,95.345,106.763,9,94,44,0.612,52
7.638,23,27,29,16,118,47.0,61,18,7,0.195,116.41,130.63,10,115,54,0.612,64
5.745,8,16,16,9,64,46.8,33,8,4,0.125,62.429,69.94,5,62,29,0.621,35
5.602,8,15,15,11,67,50.8,32,6,3,0.119,64.541,73.351,3,65,33,0.602,34
5.678,8,9,9,14,64,54.0,29,6,3,0.125,62.65,71.477,4,63,34,0.577,30
5.745,9,21,21,10,75,48.6,37,6,3,0.12,71.425,80.766,3,72,35,0.62,40
6.161,11,22,22,10,80,46.8,41,9,4,0.138,77.181,86.683,5,77,36,0.625,44
5.658,9,21,21,9,75,47.2,38,8,3,0.12,71.97,81.059,4,72,34,0.623,41
5.62,9,21,21,9,73,47.1,37,7,3,0.123,69.869,78.561,4,70,33,0.626,40
6.377,9,21,21,9,73,45.7,38,8,3,0.123,70.381,78.9,4,70,32,0.632,41
6.046,11,22,22,10,78,46.7,40,8,4,0.141,75.08,84.185,5,75,35,0.628,43
6.538,9,22,22,8,74,45.1,39,9,4,0.122,71.414,79.853,5,71,32,0.634,42
5.886,9,21,21,9,73,47.1,37,7,3,0.123,69.618,78.271,3,70,33,0.633,40
4.959,21,21,23,16,104,48.0,53,16,7,0.202,103.214,116.092,9,102,49,0.604,55
8.77,20,27,29,14,110,43.9,60,19,7,0.182,109.527,122.4,8,107,47,0.627,63
5.824,8,16,16,12,75,47.2,38,10,4,0.107,72.625,81.478,6,72,34,0.615,41
6.097,9,21,22,9,74,46.5,38,8,4,0.122,70.945,79.481,4,71,33,0.634,41
5.284,7,15,15,11,67,50.8,32,6,3,0.104,64.541,73.351,3,65,33,0.602,34
5.886,8,16,16,10,69,47.8,35,9,4,0.116,67.414,75.853,5,67,32,0.612,37
5.886,10,22,22,9,75,45.8,39,8,4,0.133,72.196,80.77,5,72,33,0.633,42
5.658,8,21,21,9,72,47.8,36,6,3,0.111,68.541,77.351,3,69,33,0.625,39
5.77,8,17,19,18,89,49.4,42,7,3,0.09,82.403,93.221,4,83,41,0.614,48
8.638,23,27,29,17,120,47.9,61,17,7,0.192,117.967,132.836,9,117,56,0.609,64
8.796,22,27,29,16,117,47.4,60,17,7,0.188,115.083,129.421,9,114,54,0.612,63
6.638,27,22,26,20,126,47.6,65,23,10,0.214,126.338,141.507,13,124,59,0.604,67
5.284,22,21,23,18,111,48.6,56,17,7,0.198,110.308,124.132,10,109,53,0.6,58
6.284,13,18,22,12,77,51.4,36,6,2,0.169,73.083,83.47,2,74,38,0.601,39
7.538,13,20,23,12,79,51.3,37,5,2,0.165,74.865,85.387,2,76,39,0.605,40
5.248,13,14,17,12,70,52.9,32,6,2,0.186,67.199,77.055,2,68,36,0.587,34
9.222,33,30,34,19,143,44.3,78,29,12,0.231,143.458,158.889,16,140,62,0.628,81
4.959,14,13,14,13,69,52.9,32,6,3,0.203,67.534,76.893,4,68,36,0.586,33
5.886,14,11,13,13,67,53.0,31,7,3,0.209,65.752,74.976,4,66,35,0.581,32
5.456,14,12,14,13,68,52.2,32,7,3,0.206,66.752,75.976,4,67,35,0.587,33
6.745,7,25,29,4,65,42.6,35,6,2,0.108,60.781,67.979,2,61,26,0.661,39
7.174,16,25,29,13,93,49.4,45,7,2,0.172,88.061,99.925,3,89,44,0.615,49
7.319,13,19,23,12,78,49.3,38,7,2,0.167,74.596,84.81,2,75,37,0.611,41
7.678,13,19,23,12,80,49.4,39,8,2,0.163,76.738,86.889,4,77,38,0.609,42
5.284,13,20,23,12,80,50.6,38,6,2,0.163,76.192,86.597,3,77,39,0.606,41
5.377,14,13,14,13,69,52.9,32,6,3,0.203,67.534,76.893,4,68,36,0.586,33
7.337,13,18,20,13,79,50.0,38,7,3,0.165,75.41,85.68,3,76,38,0.608,41
6.056,13,19,23,12,78,50.7,37,6,2,0.167,74.083,84.47,2,75,38,0.606,40
6.398,11,26,30,6,74,42.9,40,8,3,0.149,70.203,78.228,4,70,30,0.654,44
6.721,13,16,18,12,72,50.0,35,7,2,0.181,69.629,78.86,2,70,35,0.616,37
5.824,13,16,18,13,77,53.3,35,6,2,0.169,73.967,84.886,2,75,40,0.587,37
5.959,13,16,18,13,77,53.3,35,6,2,0.169,73.967,84.886,2,75,40,0.587,37
5.377,14,12,14,13,68,52.2,32,7,3,0.206,66.752,75.976,4,67,35,0.587,33
5.947,13,19,23,12,78,50.7,37,6,2,0.167,74.083,84.47,2,75,38,0.606,40
7.638,13,19,23,12,78,50.7,37,6,2,0.167,74.083,84.47,2,75,38,0.606,40
7.726,32,29,33,24,152,47.7,78,25,11,0.211,151.294,169.417,15,149,71,0.607,81
6.35,16,29,32,14,106,46.5,54,11,5,0.151,101.028,113.467,6,101,47,0.628,59
4.7,3,20,20,2,49,39.1,28,6,2,0.061,46.258,51.077,2,46,18,0.69,31
5.5,18,25,27,11,92,46.1,48,12,5,0.196,89.705,100.431,7,89,41,0.625,51
6.8,17,29,32,12,102,45.9,53,12,5,0.167,98.472,110.261,7,98,45,0.629,57
6.0,17,29,32,10,95,44.0,51,12,5,0.179,91.89,102.561,6,91,40,0.64,55
7.2,17,29,32,10,95,45.1,50,11,5,0.179,91.378,102.222,6,91,41,0.636,54
6.7,17,29,32,15,110,46.7,56,12,5,0.155,105.239,118.092,7,105,49,0.626,61
6.1,17,29,32,13,105,43.6,57,15,5,0.162,102.894,114.696,7,101,44,0.637,61
6.7,17,29,32,12,102,44.9,54,13,5,0.167,98.985,110.601,7,98,44,0.633,58
5.1,7,17,17,17,87,47.6,43,9,5,0.08,82.174,92.225,6,82,39,0.62,48
7.2,18,29,32,13,106,46.1,55,13,5,0.17,102.683,114.886,8,102,47,0.626,59
7.699,18,20,22,14,95,48.4,48,14,6,0.189,93.792,105.843,7,93,45,0.604,50
4.0,1,14,14,2,35,39.4,20,4,2,0.029,33.156,36.641,1,33,13,0.689,22
4.442,16,19,21,10,80,46.2,42,13,5,0.2,78.905,88.394,6,78,36,0.622,44
5.07,4,14,14,11,60,48.2,29,4,2,0.067,55.571,62.524,3,56,27,0.625,33
8.362,18,20,22,14,93,48.4,47,13,6,0.194,91.69,103.344,7,91,44,0.606,49
8.87,22,21,23,18,110,49.1,55,16,7,0.2,108.981,122.922,9,108,53,0.599,57
5.0,7,15,15,18,83,49.4,39,6,3,0.084,76.418,86.308,4,77,38,0.615,45
6.842,7,21,21,9,74,46.5,38,8,3,0.095,70.967,79.793,3,71,33,0.633,41
5.0,6,15,15,14,77,50.0,37,8,3,0.078,73.734,83.624,3,74,37,0.608,40
7.149,7,21,21,10,77,47.3,39,8,3,0.091,73.85,83.209,3,74,35,0.628,42
7.114,6,21,21,9,74,46.5,38,8,3,0.081,70.967,79.793,3,71,33,0.633,41
6.331,6,21,21,11,79,46.7,40,8,3,0.076,74.85,84.209,3,75,35,0.633,44
6.767,6,15,15,14,77,50.0,37,8,3,0.078,73.734,83.624,3,74,37,0.608,40
6.78,7,21,21,9,75,47.2,38,8,3,0.093,71.97,81.059,4,72,34,0.623,41
6.499,6,21,21,9,74,46.5,38,8,3,0.081,70.967,79.793,3,71,33,0.633,41
8.377,6,21,21,9,74,46.5,38,8,3,0.081,70.967,79.793,3,71,33,0.633,41
6.541,6,21,21,9,74,47.9,37,7,3,0.081,70.643,79.849,3,71,34,0.622,40
5.0,7,21,21,10,77,47.3,39,8,3,0.091,73.85,83.209,3,74,35,0.628,42
5.834,6,21,21,9,74,47.9,37,7,3,0.081,70.643,79.849,3,71,34,0.622,40
4.0,2,14,16,2,37,34.3,23,7,4,0.054,36.218,39.539,3,35,12,0.692,25
5.38,8,23,23,19,103,45.3,52,10,5,0.078,95.269,106.265,7,95,43,0.638,60
6.31,11,39,40,7,100,39.8,56,10,5,0.11,93.618,103.019,7,93,37,0.678,63
5.99,10,28,28,17,106,45.9,53,8,4,0.094,97.498,109.261,5,98,45,0.64,61
5.79,11,39,40,7,100,39.8,56,10,5,0.11,93.618,103.019,7,93,37,0.678,63
5.13,9,27,27,19,109,48.5,52,6,3,0.083,99.61,112.673,3,101,49,0.627,60
5.92,11,23,23,23,115,47.7,56,10,5,0.096,106.803,119.926,7,107,51,0.623,64
5.74,11,27,28,17,106,43.9,55,11,5,0.104,98.345,109.185,7,98,43,0.651,63
5.398,19,20,22,15,97,48.4,49,14,6,0.196,95.901,107.969,8,95,46,0.604,51
5.745,19,20,22,14,95,47.3,49,15,6,0.2,94.094,105.474,8,93,44,0.613,51
5.42,11,25,27,13,93,43.7,49,11,5,0.118,87.72,97.517,7,87,38,0.644,55
5.4,11,25,27,14,96,44.4,50,11,5,0.115,90.603,100.933,7,90,40,0.64,56
7.4,8,29,29,5,80,40.8,45,11,5,0.1,76.96,85.146,6,76,31,0.661,49
6.3,6,28,28,3,71,40.3,40,9,4,0.085,67.538,74.896,4,67,27,0.668,44
7.201,15,9,9,18,80,55.7,35,8,3,0.188,78.388,90.135,4,79,44,0.563,36
5.337,13,17,19,10,69,49.3,34,7,3,0.188,66.869,75.561,4,67,33,0.609,36
4.056,10,11,13,9,55,50.0,27,7,3,0.182,54.218,61.315,4,54,27,0.597,28
8.367,22,27,29,17,120,47.9,61,17,7,0.183,117.967,132.836,9,117,56,0.609,64
6.932,22,27,29,18,123,48.3,62,17,7,0.179,120.85,136.251,9,120,58,0.606,65
4.796,17,15,15,14,78,51.9,37,8,3,0.218,76.727,87.165,4,77,40,0.594,38
6.149,15,9,9,14,68,54.4,31,8,3,0.221,67.963,77.6,5,68,37,0.568,31
5.013,15,9,9,14,68,54.4,31,8,3,0.221,67.963,77.6,5,68,37,0.568,31
4.523,11,17,19,16,85,50.6,40,7,3,0.129,80.403,91.221,4,81,41,0.604,44
6.669,14,11,13,13,67,53.0,31,7,3,0.209,65.752,74.976,4,66,35,0.581,32
5.541,11,20,22,14,92,47.2,47,13,6,0.12,89.807,100.929,7,89,42,0.614,50
5.656,11,20,22,15,95,47.8,48,13,6,0.116,92.69,104.344,7,92,44,0.61,51
5.607,11,20,22,16,98,48.4,49,13,6,0.112,95.574,107.76,7,95,46,0.607,52
7.149,24,28,30,16,120,46.2,63,19,8,0.2,118.738,132.839,11,117,54,0.617,66
5.301,19,20,22,16,100,49.0,50,14,6,0.19,98.785,111.384,8,98,48,0.601,52
7.788,20,26,28,13,105,47.1,54,15,6,0.19,102.778,115.756,7,102,48,0.615,57
4.319,14,9,9,13,62,51.6,30,8,3,0.226,62.298,70.365,4,62,32,0.597,30
5.398,19,20,22,15,97,48.4,49,14,6,0.196,95.901,107.969,8,95,46,0.604,51
8.377,23,29,30,16,118,47.0,61,16,8,0.195,116.09,130.049,10,115,54,0.617,64
6.523,24,26,28,17,120,48.7,60,17,6,0.2,117.741,133.125,8,117,57,0.603,63
7.469,24,28,30,16,120,46.2,63,19,8,0.2,118.738,132.839,11,117,54,0.617,66
8.432,22,27,29,17,118,47.8,60,16,7,0.186,115.865,130.338,9,115,55,0.611,63
7.796,23,29,30,15,115,46.4,60,16,8,0.2,113.207,126.633,10,112,52,0.62,63
5.62,18,30,33,12,106,45.1,56,14,6,0.17,102.901,114.969,8,102,46,0.631,60
8.237,23,27,31,15,116,45.1,62,20,9,0.198,115.072,128.507,11,113,51,0.621,65
7.854,23,27,29,16,118,47.0,61,18,7,0.195,116.41,130.63,10,115,54,0.612,64
7.705,24,28,30,16,120,46.2,63,19,8,0.2,118.738,132.839,11,117,54,0.617,66
8.027,23,27,29,16,118,47.0,61,18,7,0.195,116.41,130.63,10,115,54,0.612,64
7.276,22,27,29,16,117,47.4,60,17,7,0.188,115.083,129.421,9,114,54,0.612,63
5.656,11,20,22,15,95,47.8,48,13,6,0.116,92.69,104.344,7,92,44,0.61,51
4.0,3,22,24,3,54,40.0,30,5,2,0.056,49.909,55.385,1,50,20,0.687,34
4.0,3,20,20,2,46,39.5,26,4,2,0.065,42.923,47.472,1,43,17,0.693,29
4.0,5,28,30,3,65,40.0,36,5,2,0.077,59.676,66.216,1,60,24,0.69,41
4.097,3,22,24,2,51,38.3,29,5,2,0.059,47.214,52.366,1,47,18,0.689,33
4.0,7,22,24,7,66,45.2,34,5,2,0.106,61.632,69.442,1,62,28,0.645,38
4.0,4,22,24,4,57,35.8,34,8,2,0.07,54.52,60.215,1,53,19,0.69,38
5.0,3,22,24,3,54,40.0,30,5,2,0.056,50.098,55.781,1,50,20,0.678,34
4.0,3,22,24,6,64,43.3,34,6,2,0.047,60.076,67.236,2,60,26,0.653,38
4.959,6,23,25,4,60,39.3,34,7,3,0.1,56.636,62.615,3,56,22,0.676,38
4.523,5,22,25,4,58,38.9,33,6,2,0.086,54.2,60.279,1,54,21,0.684,37
4.0,4,29,31,3,67,37.1,39,7,3,0.06,62.516,68.765,2,62,23,0.702,44
4.0,4,28,30,5,72,40.3,40,7,2,0.056,67.283,74.595,2,67,27,0.68,45
4.0,3,21,21,3,52,37.5,30,6,3,0.058,48.353,53.179,2,48,18,0.699,34
4.201,3,22,24,4,57,43.4,30,4,2,0.053,52.469,58.856,1,53,23,0.661,34
4.18,5,23,25,3,58,38.9,33,7,3,0.086,54.527,60.489,2,54,21,0.679,37
4.0,3,21,23,3,53,40.8,29,5,1,0.057,48.909,54.385,1,49,20,0.681,33
4.0,5,28,30,4,68,41.3,37,5,2,0.074,62.56,69.631,1,63,26,0.681,42
4.638,5,23,25,3,57,37.7,33,7,3,0.088,53.752,59.2,3,53,20,0.686,37
4.77,3,22,24,4,57,41.5,31,5,2,0.053,52.981,59.196,1,53,22,0.668,35
4.0,7,23,25,5,63,40.7,35,7,3,0.111,59.52,66.03,3,59,24,0.668,39
5.0,3,22,24,3,54,42.0,29,4,2,0.056,49.585,55.441,1,50,21,0.67,33
4.0,6,26,26,3,61,40.4,34,5,2,0.098,56.902,62.927,2,57,23,0.686,38
4.0,6,22,24,6,65,44.3,34,6,2,0.092,60.85,68.525,1,61,27,0.648,38
4.097,5,20,20,3,50,40.4,28,5,2,0.1,47.134,52.096,2,47,19,0.682,31
4.796,4,23,25,2,54,38.0,31,6,3,0.074,50.356,55.445,3,50,19,0.688,35
4.222,3,14,14,5,44,45.2,23,4,2,0.068,41.807,46.887,1,42,19,0.651,25
4.523,5,22,24,6,62,42.1,33,5,2,0.081,56.865,63.611,1,57,24,0.666,38
4.0,3,21,23,3,52,41.7,28,4,1,0.058,47.771,53.571,0,48,20,0.671,32
4.0,2,16,18,3,43,42.5,23,4,2,0.047,39.818,44.611,1,40,17,0.662,26
4.301,3,22,24,2,51,40.4,28,4,2,0.059,46.702,52.026,1,47,19,0.681,32
4.0,3,22,24,2,51,36.2,30,6,2,0.059,47.349,51.914,1,47,17,0.716,34
4.523,4,22,24,4,57,41.5,31,5,2,0.07,52.981,59.196,1,53,22,0.668,35
4.0,3,22,24,2,51,38.3,29,5,2,0.059,46.774,51.681,0,47,18,0.708,33
4.0,5,28,30,3,65,40.0,36,5,2,0.077,59.676,66.216,1,60,24,0.69,41
4.444,3,22,24,2,51,38.3,29,5,2,0.059,47.214,52.366,1,47,18,0.689,33
4.0,3,22,24,2,51,38.3,29,5,2,0.059,47.025,51.97,1,47,18,0.698,33
4.0,3,21,23,3,53,40.8,29,5,1,0.057,48.909,54.385,1,49,20,0.681,33
6.53,7,17,19,9,64,47.5,32,6,2,0.109,60.774,68.521,3,61,29,0.624,35
6.91,7,17,19,16,83,50.0,39,6,2,0.084,77.192,87.597,3,78,39,0.611,44
6.24,7,11,13,18,77,51.4,35,6,2,0.091,71.309,81.182,3,72,37,0.6,40
5.63,7,11,13,15,68,49.2,32,6,2,0.103,62.658,70.936,3,63,31,0.612,37
5.84,7,11,13,15,69,50.8,32,6,2,0.101,64.541,73.351,3,65,33,0.602,36
6.9,7,11,13,19,80,52.0,36,6,2,0.088,74.192,84.597,3,75,39,0.596,41
6.18,7,17,19,13,74,47.8,36,6,2,0.095,68.541,77.351,3,69,33,0.625,41
6.14,7,17,19,15,80,49.3,38,6,2,0.088,74.309,84.182,3,75,37,0.616,43
6.18,7,17,19,6,56,46.3,29,6,2,0.125,54.007,60.69,3,54,25,0.63,31
5.54,7,11,13,16,72,51.5,33,6,2,0.097,67.425,76.766,3,68,35,0.598,37
5.6,6,21,24,8,68,45.3,35,6,2,0.088,63.774,71.521,3,64,29,0.642,39
6.27,7,17,19,14,78,47.9,38,7,2,0.09,72.752,81.976,4,73,35,0.621,43
6.52,9,17,19,15,80,49.3,38,6,2,0.113,74.309,84.182,3,75,37,0.616,43
6.25,7,17,19,13,74,46.4,37,7,2,0.095,69.054,77.691,3,69,32,0.63,42
6.11,7,11,13,19,80,50.0,37,7,2,0.088,73.636,83.391,4,74,37,0.606,43
6.1,8,17,19,15,82,49.4,39,7,2,0.098,76.41,86.68,3,77,38,0.613,44
6.49,7,11,13,20,82,51.3,37,6,2,0.085,75.192,85.597,3,76,39,0.601,43
4.481,2,20,20,1,44,39.0,25,4,3,0.045,40.793,45.032,1,41,16,0.698,28
4.785,7,23,25,2,56,39.6,32,7,3,0.125,53.567,59.069,4,53,21,0.673,35
6.489,31,29,33,22,147,47.2,76,25,11,0.211,146.301,163.875,14,144,68,0.609,79
4.0,3,18,19,2,43,37.5,25,5,2,0.07,40.305,44.372,1,40,15,0.7,28
4.215,3,24,25,2,53,38.8,30,4,2,0.057,48.807,53.887,1,49,19,0.701,34
6.2,13,18,20,17,92,48.3,45,10,4,0.141,87.159,98.138,6,87,42,0.614,50
5.0,7,12,13,13,64,50.0,30,5,2,0.109,59.556,67.438,3,60,30,0.609,34
5.1,7,19,20,8,65,45.2,34,7,3,0.108,62.327,69.441,5,62,28,0.637,37
5.4,11,25,27,13,93,43.7,49,11,5,0.118,87.72,97.517,7,87,38,0.644,55
5.5,7,22,25,8,71,43.3,38,8,3,0.099,67.429,74.94,5,67,29,0.649,42
5.0,11,24,27,14,95,43.8,50,12,5,0.116,89.821,100.016,7,89,39,0.641,56
5.5,7,20,23,10,73,47.8,36,6,1,0.096,68.541,77.351,3,69,33,0.625,40
5.3,7,20,24,8,69,43.1,37,9,3,0.101,65.647,73.023,5,65,28,0.646,41
5.1,7,19,20,11,72,44.8,37,7,3,0.097,67.211,74.856,5,67,30,0.642,42
5.6,7,23,25,8,72,44.1,38,7,3,0.097,68.211,75.856,5,68,30,0.647,42
5.5,7,18,20,11,71,43.9,37,8,3,0.099,66.429,73.94,5,66,29,0.644,42
5.4,11,24,27,14,95,43.8,50,12,5,0.116,89.821,100.016,7,89,39,0.641,56
5.8,11,24,27,13,92,43.0,49,12,5,0.12,86.938,96.601,7,86,37,0.646,55
5.6,6,21,24,8,68,45.3,35,6,2,0.088,63.774,71.521,3,64,29,0.642,39
5.3,8,19,20,12,75,45.7,38,7,3,0.107,70.094,78.272,5,70,32,0.636,43
5.3,10,23,26,13,89,44.6,46,10,4,0.112,83.283,93.182,5,83,37,0.64,52
5.5,11,23,23,13,88,44.6,46,10,5,0.125,83.618,93.019,7,83,37,0.639,51
5.2,8,18,20,12,74,44.9,38,8,3,0.108,69.312,77.355,5,69,31,0.638,43
5.1,7,18,20,8,64,44.3,34,8,3,0.109,61.545,68.524,5,61,27,0.639,37
6.1,11,27,28,13,95,43.8,50,10,5,0.116,89.501,99.434,7,89,39,0.647,56
5.7,11,24,27,14,95,43.8,50,12,5,0.116,89.821,100.016,7,89,39,0.641,56
5.4,11,22,25,15,94,46.6,47,10,3,0.117,88.05,99.012,5,88,41,0.627,53
5.7,11,29,29,17,109,44.6,56,10,5,0.101,101.152,112.68,7,101,45,0.645,64
5.4,6,22,24,8,69,46.2,35,5,2,0.087,64.556,72.438,3,65,30,0.639,39
4.0,9,22,22,13,87,48.2,43,8,4,0.103,82.621,93.304,4,83,40,0.62,47
4.0,9,22,22,13,87,47.0,44,9,4,0.103,83.134,93.644,4,83,39,0.624,48
4.268,3,20,20,4,53,42.9,28,4,2,0.057,48.585,54.441,1,49,21,0.664,32
4.0,3,20,20,4,53,40.8,29,5,2,0.057,49.098,54.781,1,49,20,0.672,33
4.0,9,22,22,13,87,47.0,44,9,4,0.103,83.134,93.644,4,83,39,0.624,48
4.553,3,20,20,4,53,42.9,28,4,2,0.057,48.585,54.441,1,49,21,0.664,32
4.032,3,20,20,6,59,45.5,30,4,2,0.051,54.352,61.272,1,55,25,0.647,34
4.319,3,20,20,4,53,40.8,29,5,2,0.057,49.098,54.781,1,49,20,0.672,33
5.824,10,22,22,9,77,45.9,40,9,4,0.13,74.298,83.268,5,74,34,0.629,43
5.066,30,36,38,20,151,46.3,79,23,10,0.199,148.897,166.746,13,147,68,0.618,83
5.066,30,36,38,20,151,46.3,79,23,10,0.199,148.897,166.746,13,147,68,0.618,83
6.699,15,13,15,12,75,48.6,38,13,5,0.2,75.156,84.684,7,74,36,0.595,39
6.0,30,36,38,20,151,46.3,79,23,10,0.199,148.897,166.746,13,147,68,0.618,83
5.921,30,36,38,20,151,46.3,79,23,10,0.199,148.897,166.746,13,147,68,0.618,83
6.721,31,30,32,19,139,45.6,74,25,10,0.223,138.399,154.34,13,136,62,0.622,77
9.553,29,30,34,15,131,42.2,74,29,12,0.221,131.923,145.228,16,128,54,0.639,77
5.796,40,31,35,30,177,48.3,90,29,13,0.226,176.679,198.035,18,174,84,0.602,93
8.699,34,31,35,23,155,46.1,82,28,13,0.219,155.167,172.919,17,152,70,0.614,85
5.0,4,13,19,5,48,37.8,28,10,3,0.083,45.956,50.209,3,45,17,0.696,31
8.523,34,31,35,23,155,46.1,82,28,13,0.219,155.167,172.919,17,152,70,0.614,85
4.0,2,18,19,1,40,35.1,24,5,2,0.05,37.422,40.957,1,37,13,0.716,27
7.759,30,29,33,21,141,47.1,73,23,11,0.213,139.988,156.753,13,138,65,0.612,76
7.481,32,29,33,23,149,47.3,77,25,11,0.215,148.41,166.002,15,146,69,0.609,80
8.678,25,28,32,18,128,45.2,68,22,10,0.195,126.352,140.593,13,124,56,0.623,72
8.137,25,28,32,23,142,46.7,73,22,10,0.176,138.887,155.254,13,137,64,0.616,78
4.785,5,37,41,1,76,36.2,44,6,3,0.066,69.007,75.69,3,69,25,0.71,51
5.365,4,31,35,1,65,35.6,38,6,3,0.062,59.24,64.86,3,59,21,0.711,44
5.83,11,24,27,13,92,43.0,49,12,5,0.12,86.938,96.601,7,86,37,0.646,55
5.658,14,9,9,13,62,51.6,30,8,3,0.226,62.298,70.365,4,62,32,0.597,30
6.1,11,25,27,13,92,43.0,49,11,5,0.12,86.694,95.939,7,86,37,0.654,55
5.9,6,17,19,11,68,46.0,34,6,2,0.088,62.774,70.521,3,63,29,0.636,39
5.7,11,25,27,13,93,42.5,50,12,5,0.118,87.789,97.238,7,87,37,0.659,56
9.14,19,21,23,13,93,46.2,49,15,7,0.204,92.461,103.348,9,91,42,0.616,51
7.222,33,31,35,25,160,46.2,84,28,13,0.206,159.05,177.334,17,156,72,0.615,88
8.633,30,29,33,21,141,47.1,73,23,11,0.213,139.988,156.753,13,138,65,0.612,76
7.276,22,27,29,16,117,47.4,60,17,7,0.188,115.083,129.421,9,114,54,0.612,63
7.208,29,28,32,19,134,46.6,70,23,10,0.216,133.221,148.922,13,131,61,0.614,73
6.886,25,28,29,16,120,47.9,61,17,7,0.208,117.967,132.836,9,117,56,0.609,64
9.004,29,28,32,20,135,47.0,70,22,10,0.215,134.003,149.839,13,132,62,0.613,73
5.602,28,31,35,30,177,48.0,90,29,13,0.158,175.57,196.908,17,173,83,0.604,94
7.658,23,29,30,15,117,46.5,61,17,8,0.197,115.308,129.132,10,114,53,0.618,64
6.77,22,21,23,19,115,49.6,57,17,7,0.191,113.967,128.836,9,113,56,0.595,59
7.699,34,31,35,23,155,46.1,82,28,13,0.219,155.167,172.919,17,152,70,0.614,85
5.415,28,31,35,30,177,48.0,90,29,13,0.158,175.57,196.908,17,173,83,0.604,94
5.509,28,31,35,30,177,48.0,90,29,13,0.158,175.57,196.908,17,173,83,0.604,94
6.174,13,16,18,12,72,50.0,35,7,2,0.181,69.629,78.86,2,70,35,0.616,37
7.796,22,27,29,16,117,47.4,60,17,7,0.188,115.083,129.421,9,114,54,0.612,63
9.301,29,28,32,20,135,47.0,70,22,10,0.215,134.003,149.839,13,132,62,0.613,73
7.276,34,31,35,23,155,46.1,82,28,13,0.219,155.167,172.919,17,152,70,0.614,85
7.337,23,28,30,16,119,46.6,62,18,8,0.193,117.41,131.63,10,116,54,0.616,65
5.7,26,31,33,30,173,49.1,86,25,11,0.15,170.512,192.36,14,169,83,0.599,90
5.75,11,34,36,6,89,45.2,46,6,2,0.124,83.083,93.47,2,84,38,0.648,51
8.2,4,19,20,3,49,39.1,28,6,3,0.082,46.582,51.156,4,46,18,0.676,31
5.1,17,19,21,15,93,49.5,46,12,5,0.183,91.472,103.261,7,91,45,0.601,48
8.347,22,31,34,15,120,45.7,63,17,7,0.183,117.308,131.132,10,116,53,0.624,67
6.9,21,26,28,16,114,48.6,57,15,6,0.184,111.428,126.002,7,111,54,0.606,60
4.469,2,20,20,1,44,39.0,25,4,3,0.045,40.793,45.032,1,41,16,0.698,28
7.721,23,28,30,16,119,46.6,62,18,8,0.193,117.41,131.63,10,116,54,0.616,65
7.638,23,27,29,16,118,47.0,61,18,7,0.195,116.41,130.63,10,115,54,0.612,64
5.47,11,25,27,13,93,43.7,49,11,5,0.118,87.72,97.517,7,87,38,0.644,55
5.429,9,17,19,18,91,45.9,46,11,3,0.099,85.705,95.528,6,85,39,0.635,52
4.0,4,22,22,9,75,42.0,40,9,4,0.053,69.421,77.312,4,69,29,0.656,46
4.0,3,22,24,2,51,38.3,29,5,2,0.059,47.025,51.97,1,47,18,0.698,33
6.125,18,26,28,18,119,48.7,59,15,6,0.151,115.312,130.417,7,115,56,0.607,63
5.975,11,17,19,16,85,47.5,42,9,3,0.129,80.17,89.96,5,80,38,0.624,47
5.8,9,14,16,4,47,39.1,28,10,4,0.191,47.516,51.588,5,46,18,0.678,29
6.851,20,26,28,16,114,48.6,57,15,6,0.175,111.428,126.002,7,111,54,0.606,60
5.875,24,26,28,20,126,50.4,61,15,6,0.19,122.963,139.663,7,123,62,0.597,64
6.5,10,18,21,5,58,41.1,33,10,4,0.172,57.287,62.684,6,56,23,0.663,35
6.6,9,18,21,4,54,40.4,31,9,4,0.167,53.265,58.455,5,52,21,0.663,33
5.6,8,19,20,4,53,43.1,29,6,3,0.151,51.349,56.986,4,51,22,0.65,31
6.475,9,18,21,4,54,42.3,30,8,4,0.167,52.753,58.116,5,52,22,0.655,32
6.124,9,17,19,17,88,45.1,45,11,3,0.102,82.821,92.113,6,82,37,0.64,51
6.126,22,26,28,17,117,49.1,58,15,6,0.188,114.312,129.417,7,114,56,0.604,61
7.721,22,26,28,19,123,50.0,60,15,6,0.179,120.079,136.247,7,120,60,0.599,63
5.5,11,14,16,6,53,46.2,28,8,4,0.208,52.636,58.531,5,52,24,0.627,29
7.77,20,26,28,20,125,49.6,61,15,6,0.16,121.079,137.247,7,121,60,0.602,65
6.1,10,18,21,5,57,43.6,31,8,4,0.175,55.636,61.531,5,55,24,0.647,33
5.0,10,18,23,4,59,40.4,34,12,6,0.169,58.585,63.953,7,57,23,0.662,36
6.6,10,18,21,5,58,42.9,32,9,4,0.172,56.963,62.74,6,56,24,0.648,34
5.928,23,26,28,19,123,50.0,60,15,6,0.187,120.079,136.247,7,120,60,0.599,63
7.208,21,26,28,17,117,49.1,58,15,6,0.179,114.312,129.417,7,114,56,0.604,61
5.744,23,26,28,18,120,49.6,59,15,6,0.192,117.196,132.832,7,117,58,0.601,62
6.577,20,26,28,16,114,48.6,57,15,6,0.175,111.428,126.002,7,111,54,0.606,60
5.724,9,16,18,15,79,50.0,37,6,2,0.114,73.309,83.182,3,74,37,0.61,42
5.377,18,23,26,16,103,49.0,51,12,5,0.175,100.239,113.092,7,100,49,0.607,54
6.538,24,27,29,18,121,48.3,61,16,7,0.198,118.748,133.753,9,118,57,0.608,64
6.754,6,21,21,9,74,46.5,38,8,3,0.081,70.967,79.793,3,71,33,0.633,41
7.553,23,28,30,16,118,47.0,61,17,8,0.195,116.083,130.421,9,115,54,0.615,64
8.114,22,30,34,15,119,45.2,63,18,7,0.185,116.527,130.215,10,115,52,0.625,67
7.409,22,29,33,15,117,46.0,61,17,7,0.188,114.199,128.005,9,113,52,0.621,65
7.301,23,27,29,15,113,46.4,59,17,8,0.204,111.174,124.427,9,110,51,0.621,62
7.854,22,31,34,15,119,46.1,62,16,7,0.185,115.981,129.922,9,115,53,0.623,66
6.602,7,16,20,12,78,48.0,39,11,3,0.09,75.167,85.427,3,75,36,0.609,42
7.854,22,29,33,15,118,45.6,62,18,7,0.186,115.527,129.215,10,114,52,0.622,66
6.222,7,22,26,10,83,45.6,43,11,3,0.084,79.167,89.427,3,79,36,0.629,47
5.959,9,22,24,11,87,46.4,45,12,6,0.103,84.57,94.726,6,84,39,0.625,48
7.26,23,29,30,15,116,46.9,60,16,8,0.198,113.981,127.922,9,113,53,0.617,63
6.886,23,29,30,15,116,45.1,62,18,8,0.198,114.629,127.81,9,113,51,0.631,65
7.409,25,29,32,15,121,44.9,65,21,10,0.207,120.367,133.68,13,118,53,0.625,68
6.31,7,16,20,15,86,48.8,42,11,3,0.081,81.934,93.258,3,82,40,0.607,46
7.244,24,29,32,15,118,45.2,63,19,10,0.203,116.854,130.424,11,115,52,0.623,66
6.284,8,16,18,16,90,49.4,44,12,6,0.089,87.338,98.557,6,87,43,0.605,47
7.721,23,31,34,15,121,46.2,63,17,8,0.19,118.083,132.421,9,117,54,0.622,67
6.387,24,27,29,17,118,47.0,61,17,7,0.203,116.188,130.282,9,115,54,0.618,64
7.886,25,29,32,15,121,44.9,65,21,10,0.207,120.367,133.68,13,118,53,0.625,68
7.42,25,29,30,17,124,47.1,64,18,8,0.202,122.403,137.172,11,121,57,0.613,67
8.469,24,32,35,17,128,46.0,67,18,8,0.188,125.403,140.172,11,124,57,0.622,71
5.921,18,23,26,16,103,49.0,51,12,5,0.175,100.239,113.092,7,100,49,0.607,54
5.538,18,19,21,15,93,49.5,46,12,5,0.194,91.472,103.261,7,91,45,0.601,48
5.68,12,29,29,18,112,45.2,57,10,5,0.107,104.036,116.095,7,104,47,0.641,65
5.854,16,23,26,17,105,48.5,52,12,5,0.152,101.239,114.092,7,101,49,0.611,56
5.268,17,23,26,19,111,49.5,54,12,5,0.153,107.007,120.922,7,107,53,0.605,58
5.301,18,19,21,16,96,50.0,47,12,5,0.188,94.356,106.677,7,94,47,0.598,49
6.284,19,23,26,18,109,50.0,53,12,5,0.174,106.007,119.922,7,106,53,0.601,56
5.678,16,23,26,18,108,49.0,53,12,5,0.148,104.123,117.507,7,104,51,0.608,57
5.42,11,25,27,13,92,43.0,49,11,5,0.12,86.945,96.229,8,86,37,0.648,55
5.62,17,29,32,12,102,45.9,53,12,5,0.167,98.472,110.261,7,98,45,0.629,57
5.65,11,25,27,13,92,43.0,49,11,5,0.12,86.694,95.939,7,86,37,0.654,55
5.59,11,24,27,13,92,41.9,50,13,5,0.12,87.45,96.94,7,86,36,0.65,56
6.509,8,22,22,10,80,46.8,41,9,4,0.1,77.181,86.683,5,77,36,0.625,44
5.5,11,25,27,10,86,43.9,46,11,5,0.128,82.836,92.102,7,82,36,0.64,50
5.097,17,25,27,13,98,47.4,50,12,5,0.173,95.472,107.261,7,95,45,0.617,53
6.04,11,24,35,10,91,40.0,51,17,3,0.121,86.538,97.013,3,85,34,0.654,57
5.89,11,25,35,13,99,41.8,53,15,3,0.111,91.69,103.005,3,91,38,0.651,61
6.004,16,29,32,11,99,45.3,52,12,5,0.162,95.589,106.846,7,95,43,0.633,56
5.456,17,29,32,13,105,46.5,54,12,5,0.162,101.356,113.677,7,101,47,0.625,58
7.31,23,29,30,15,116,45.1,62,18,8,0.198,114.629,127.81,9,113,51,0.631,65
7.481,23,29,30,15,118,46.1,62,18,8,0.195,116.636,130.341,11,115,53,0.619,65
5.55,11,24,27,13,93,42.5,50,13,5,0.118,88.265,97.81,8,87,37,0.647,56
7.469,8,22,26,10,83,45.6,43,11,3,0.096,79.167,89.427,3,79,36,0.629,47
5.08,4,14,14,15,70,48.4,33,4,2,0.057,63.338,71.355,3,64,31,0.626,39
5.377,7,22,22,9,77,45.9,40,9,4,0.091,74.298,83.268,5,74,34,0.629,43
6.208,7,22,26,9,80,44.7,42,11,3,0.088,76.283,86.012,3,76,34,0.634,46
5.09,5,15,15,19,85,48.7,40,6,3,0.059,77.418,87.308,4,78,38,0.62,47
5.13,11,24,27,10,85,42.0,47,13,5,0.129,82.567,91.525,7,81,34,0.647,51
6.085,11,27,28,13,95,43.8,50,10,5,0.116,89.501,99.434,7,89,39,0.647,56
7.4,18,33,35,11,112,44.4,60,16,7,0.161,109.105,121.966,8,108,48,0.634,64
7.1,18,33,35,10,109,42.9,60,17,7,0.165,106.545,118.494,8,105,45,0.645,64
7.284,23,29,33,16,121,46.2,63,18,7,0.19,118.41,132.63,10,117,54,0.619,67
7.149,23,29,30,15,116,46.0,61,17,8,0.198,114.305,127.866,9,113,52,0.624,64
7.2,18,33,35,11,112,44.4,60,16,7,0.161,109.105,121.966,8,108,48,0.634,64
7.523,24,27,29,18,122,47.9,62,17,7,0.197,120.076,134.962,10,119,57,0.609,65
6.409,24,27,29,18,121,45.8,64,19,7,0.198,120.286,134.772,9,118,54,0.618,67
7.149,23,29,30,16,119,47.4,61,16,8,0.193,116.865,131.338,9,116,55,0.614,64
5.77,8,17,19,18,89,49.4,42,7,3,0.09,82.403,93.221,4,83,41,0.614,48
8.42,22,27,29,15,114,45.9,60,18,7,0.193,112.523,125.949,9,111,51,0.622,63
7.032,23,27,29,17,120,47.9,61,17,7,0.192,117.967,132.836,9,117,56,0.609,64
5.812,9,16,18,15,79,47.3,39,8,2,0.114,73.956,83.07,3,74,35,0.633,44
8.796,7,21,21,12,83,50.0,40,7,3,0.084,79.294,90.095,3,80,40,0.609,43
7.638,23,27,29,18,123,48.3,62,17,7,0.187,120.85,136.251,9,120,58,0.606,65
8.886,7,21,21,12,83,50.0,40,7,3,0.084,79.294,90.095,3,80,40,0.609,43
7.092,25,28,32,19,131,45.7,69,22,10,0.191,129.236,144.009,13,127,58,0.621,73
7.292,22,27,29,15,114,45.9,60,18,7,0.193,112.523,125.949,9,111,51,0.622,63
8.097,22,27,29,16,117,44.7,63,20,7,0.188,116.621,130.44,9,114,51,0.622,66
9.174,28,28,32,19,132,46.5,69,22,10,0.212,131.119,146.424,13,129,60,0.615,72
9.114,29,28,32,19,132,46.5,69,22,10,0.22,131.119,146.424,13,129,60,0.615,72
6.4,8,28,28,6,78,43.2,42,8,4,0.103,74.087,82.644,4,74,32,0.653,46
8.0,7,27,27,8,82,44.9,43,8,3,0.085,77.85,87.209,3,78,35,0.647,47
8.409,21,27,29,14,111,46.3,58,17,7,0.189,109.316,122.59,9,108,50,0.617,61
8.959,7,27,27,9,85,46.9,43,7,3,0.082,80.41,90.68,3,81,38,0.632,47
7.387,21,26,30,14,111,46.3,58,18,8,0.189,109.392,122.51,9,108,50,0.619,61
5.819,11,17,19,16,85,48.8,41,8,3,0.129,79.847,90.016,5,80,39,0.614,46
8.237,26,28,32,15,120,44.4,65,22,10,0.217,119.585,132.763,13,117,52,0.626,68
8.0,7,27,27,9,85,46.9,43,7,3,0.082,80.41,90.68,3,81,38,0.632,47
7.678,22,21,23,21,120,49.6,59,17,7,0.183,117.85,133.251,9,117,58,0.596,62
5.216,7,16,18,13,73,48.5,35,6,2,0.096,67.541,76.351,3,68,33,0.619,40
8.268,21,27,29,17,121,48.3,61,17,7,0.174,118.741,134.125,8,118,57,0.606,64
5.516,11,17,19,16,83,46.2,42,9,3,0.133,78.392,87.405,5,78,36,0.638,47
5.42,11,15,15,16,80,50.0,38,7,3,0.138,75.745,85.517,5,76,38,0.607,42
5.199,8,22,24,5,64,44.3,34,7,2,0.125,60.989,68.338,2,61,27,0.65,37
5.5,9,16,18,15,79,47.3,39,8,2,0.114,73.956,83.07,3,74,35,0.633,44
5.347,8,17,19,11,71,48.5,35,7,3,0.113,67.869,76.561,4,68,33,0.615,38
6.097,22,27,29,17,120,47.9,61,17,7,0.183,117.967,132.836,9,117,56,0.609,64
8.42,22,27,29,15,114,45.9,60,18,7,0.193,112.523,125.949,9,111,51,0.622,63
8.319,20,27,29,14,110,46.7,57,16,7,0.182,107.988,121.381,8,107,50,0.616,60
8.229,20,27,29,14,112,46.8,58,17,7,0.179,110.09,123.879,8,109,51,0.614,61
6.013,11,22,22,10,80,46.8,41,9,4,0.138,77.181,86.683,5,77,36,0.625,44
8.959,7,21,21,12,83,50.0,40,7,3,0.084,79.294,90.095,3,80,40,0.609,43
6.252,7,21,21,11,80,49.4,39,7,3,0.088,76.41,86.68,3,77,38,0.613,42
5.602,7,21,21,12,83,46.3,43,10,3,0.084,80.832,91.114,3,80,37,0.623,46
8.0,7,21,21,11,80,49.4,39,7,3,0.088,76.41,86.68,3,77,38,0.613,42
7.585,22,27,29,15,114,46.8,59,17,7,0.193,112.199,126.005,9,111,52,0.614,62
5.983,11,17,19,16,85,46.3,43,10,3,0.129,80.494,89.904,5,80,37,0.635,48
8.0,8,21,23,11,82,46.8,42,10,5,0.098,79.283,89.182,5,79,37,0.622,45
8.854,22,27,29,18,122,48.7,61,16,7,0.18,119.523,135.042,8,119,58,0.606,64
9.0,7,21,21,11,80,48.1,40,8,3,0.088,76.923,87.02,3,77,37,0.618,43
6.602,8,16,16,12,76,47.9,38,10,4,0.105,73.4,82.767,5,73,35,0.611,41
5.467,11,15,15,16,80,48.7,39,8,3,0.138,75.974,85.359,5,76,37,0.62,43
8.959,21,27,29,17,119,48.3,60,16,7,0.176,116.639,131.626,8,116,56,0.608,63
8.959,7,27,27,8,82,44.9,43,8,3,0.085,77.85,87.209,3,78,35,0.647,47
7.721,22,27,29,24,137,48.9,67,16,7,0.161,131.174,148.287,8,131,64,0.608,73
8.208,23,33,35,14,122,45.8,64,17,7,0.189,119.083,133.421,9,118,54,0.625,68
8.42,22,27,29,16,117,47.4,60,17,7,0.188,115.083,129.421,9,114,54,0.612,63
6.194,12,18,20,16,90,50.6,43,9,4,0.133,86.716,98.344,5,87,44,0.6,46
5.699,7,15,15,11,67,50.8,32,6,3,0.104,64.541,73.351,3,65,33,0.602,34
6.622,13,19,23,12,78,50.7,37,6,2,0.167,74.083,84.47,2,75,38,0.606,40
6.699,12,17,19,17,91,52.3,42,8,3,0.132,87.272,99.55,4,88,46,0.591,45
5.959,9,21,23,9,75,45.8,39,9,5,0.12,72.272,80.69,5,72,33,0.635,42
5.377,13,16,18,12,74,51.4,35,7,2,0.176,71.407,81.414,2,72,37,0.601,37
7.77,22,27,29,23,135,48.1,67,17,7,0.163,129.617,146.081,9,129,62,0.611,73
8.0,9,21,21,17,98,52.6,45,7,3,0.092,93.712,107.171,3,95,50,0.593,48
5.9,7,28,28,5,77,42.5,42,9,4,0.091,73.305,81.727,4,73,31,0.655,46
5.886,9,21,21,10,76,47.9,38,7,3,0.118,72.752,81.976,4,73,35,0.621,41
7.292,13,19,23,12,79,50.0,38,7,2,0.165,75.41,85.68,3,76,38,0.608,41
4.836,13,15,18,12,71,52.2,33,6,2,0.183,68.199,78.055,2,69,36,0.593,35
8.155,14,12,14,13,70,50.7,34,9,3,0.2,69.407,78.395,6,69,35,0.591,35
8.0,8,21,21,16,94,51.1,44,7,3,0.085,88.945,101.341,3,90,46,0.603,48
7.745,22,33,35,14,121,46.2,63,16,7,0.182,117.756,132.211,8,117,54,0.624,67
4.854,19,20,22,14,96,47.9,49,15,6,0.198,95.119,107.052,8,94,45,0.605,51
8.387,22,33,35,13,119,45.2,63,17,7,0.185,116.199,130.005,9,115,52,0.628,67
6.301,9,21,21,9,75,47.2,38,8,3,0.12,71.97,81.059,4,72,34,0.623,41
7.0,22,34,36,13,121,44.4,65,18,8,0.182,118.527,132.215,10,117,52,0.632,69
5.854,7,23,25,8,74,45.7,38,7,3,0.095,69.76,78.434,3,70,32,0.637,42
6.323,13,16,18,12,72,51.4,34,6,2,0.181,69.305,78.916,2,70,36,0.604,36
6.409,13,19,23,12,79,50.0,38,7,2,0.165,75.41,85.68,3,76,38,0.608,41
6.092,7,25,29,4,65,42.6,35,6,2,0.108,60.781,67.979,2,61,26,0.661,39
6.367,13,18,22,12,77,51.4,36,6,2,0.169,73.083,83.47,2,74,38,0.601,39
7.959,13,19,23,12,79,50.0,38,7,2,0.165,75.41,85.68,3,76,38,0.608,41
7.886,23,28,30,15,116,46.0,61,18,8,0.198,114.527,128.215,10,113,52,0.619,64
6.7,18,29,32,11,99,45.3,52,12,5,0.182,95.589,106.846,7,95,43,0.633,56
5.9,18,25,27,11,92,43.8,50,14,5,0.196,90.352,100.319,7,89,39,0.643,53
6.4,7,21,22,7,70,44.8,37,9,4,0.1,67.196,75.6,3,67,30,0.636,40
6.921,13,19,23,12,78,50.7,37,6,2,0.167,74.083,84.47,2,75,38,0.606,40
6.222,7,25,29,4,65,42.6,35,6,2,0.108,60.781,67.979,2,61,26,0.661,39
5.824,16,25,31,12,92,46.6,47,10,4,0.174,87.799,98.723,4,88,41,0.632,51
5.237,13,19,23,12,78,50.7,37,6,2,0.167,74.083,84.47,2,75,38,0.606,40
6.783,10,26,30,5,71,41.8,39,8,3,0.141,67.32,74.813,4,67,28,0.661,43
6.432,13,16,18,12,72,51.4,34,6,2,0.181,69.305,78.916,2,70,36,0.604,36
6.456,7,25,29,3,62,41.4,34,6,2,0.113,57.898,64.564,2,58,24,0.669,38
6.7,16,29,32,14,106,45.5,55,12,5,0.151,101.541,113.807,6,101,46,0.632,60
5.0,13,16,18,13,77,53.3,35,6,2,0.169,73.967,84.886,2,75,40,0.587,37
5.602,13,16,18,13,77,53.3,35,6,2,0.169,73.967,84.886,2,75,40,0.587,37
8.745,7,21,21,11,80,48.1,40,8,3,0.088,76.923,87.02,3,77,37,0.618,43
6.085,7,21,21,11,80,49.4,39,7,3,0.088,76.41,86.68,3,77,38,0.613,42
6.032,22,27,29,17,120,47.9,61,17,7,0.183,117.967,132.836,9,117,56,0.609,64
5.629,10,16,20,15,81,47.4,40,9,4,0.123,76.181,85.683,5,76,36,0.62,45
6.658,22,27,29,16,117,47.4,60,17,7,0.188,114.832,129.131,8,114,54,0.616,63
7.3,5,22,22,6,68,42.2,37,9,4,0.074,64.538,71.896,4,64,27,0.653,41
5.506,10,16,18,16,83,50.0,39,7,2,0.12,77.519,87.806,4,78,39,0.608,44
8.658,8,21,21,12,84,49.4,41,8,3,0.095,80.621,91.304,4,81,40,0.61,44
8.071,22,27,29,15,114,45.0,61,19,7,0.193,112.847,125.893,9,111,50,0.629,64
7.222,22,27,29,15,114,45.9,60,18,7,0.193,112.523,125.949,9,111,51,0.622,63
8.357,7,21,21,15,91,50.6,43,7,3,0.077,86.061,97.925,3,87,44,0.607,47
7.796,22,31,34,15,121,46.2,63,17,7,0.182,118.083,132.421,9,117,54,0.622,67
8.553,7,21,21,11,80,48.1,40,8,3,0.088,76.923,87.02,3,77,37,0.618,43
5.878,12,17,19,17,88,49.4,42,8,3,0.136,82.73,93.431,5,83,41,0.61,47
5.4,18,30,33,13,109,45.7,57,14,6,0.165,105.785,118.384,8,105,48,0.628,61
6.5,19,29,32,14,110,46.2,57,14,5,0.173,106.894,119.511,9,106,49,0.624,61
5.77,10,26,30,5,71,41.8,39,8,3,0.141,67.32,74.813,4,67,28,0.661,43
5.85,5,21,21,12,80,45.9,40,7,3,0.063,73.643,82.849,3,74,34,0.637,46
5.8,19,30,33,13,110,45.3,58,15,6,0.173,107.112,119.594,9,106,48,0.629,62
6.3,17,29,32,12,102,44.9,54,13,5,0.167,98.796,110.205,7,98,44,0.637,58
4.7,7,15,15,17,80,48.6,38,6,3,0.088,73.534,82.893,4,74,36,0.62,44
7.1,18,29,32,13,106,46.1,55,13,5,0.17,102.683,114.886,8,102,47,0.626,59
6.842,6,21,21,8,71,45.6,37,8,3,0.085,68.083,76.378,3,68,31,0.639,40
5.0,13,16,18,12,74,51.4,35,7,2,0.176,71.407,81.414,2,72,37,0.601,37
8.688,19,21,23,13,94,46.7,49,15,7,0.202,93.236,104.637,8,92,43,0.613,51
5.3,18,30,33,12,106,45.1,56,14,6,0.17,102.901,114.969,8,102,46,0.631,60
6.5,17,29,32,12,104,46.0,54,13,5,0.163,100.574,112.76,7,100,46,0.627,58
4.83,7,16,16,20,92,48.2,44,8,4,0.076,84.73,95.431,5,85,41,0.619,51
6.0,17,29,32,11,98,42.6,54,14,5,0.173,95.799,106.656,6,94,40,0.644,58
5.09,5,15,15,19,85,48.7,40,6,3,0.059,77.418,87.308,4,78,38,0.62,47
5.08,4,14,14,15,70,48.4,33,4,2,0.057,63.338,71.355,3,64,31,0.626,39
7.2,18,29,32,13,106,46.1,55,13,5,0.17,102.683,114.886,8,102,47,0.626,59
6.2,18,30,33,14,112,46.3,58,14,6,0.161,108.668,121.799,8,108,50,0.624,62
8.585,19,20,22,16,100,49.0,50,14,6,0.19,98.785,111.384,8,98,48,0.601,52
7.161,6,21,21,8,71,44.1,38,9,3,0.085,68.407,76.322,3,68,30,0.651,41
5.9,18,29,32,13,106,46.1,55,13,5,0.17,102.683,114.886,8,102,47,0.626,59
6.495,6,21,21,8,71,44.1,38,9,3,0.085,68.407,76.322,3,68,30,0.651,41
7.301,7,21,21,9,73,47.1,37,7,3,0.096,69.869,78.561,4,70,33,0.626,40
4.69,6,15,15,16,77,47.9,37,6,3,0.078,70.65,79.477,4,71,34,0.624,43
8.585,16,19,21,12,85,48.2,43,12,5,0.188,83.596,94.305,6,83,40,0.607,45
6.399,6,21,21,8,71,45.6,37,8,3,0.085,68.083,76.378,3,68,31,0.639,40
4.755,8,16,16,22,98,49.5,46,8,4,0.082,90.498,102.261,5,91,45,0.612,53
6.252,6,15,15,15,80,50.6,38,8,3,0.075,76.618,87.039,3,77,39,0.604,41
7.824,18,20,22,14,95,48.4,48,14,6,0.189,93.792,105.843,7,93,45,0.604,50
7.469,7,21,21,9,73,45.7,38,8,3,0.096,70.192,78.505,4,70,32,0.638,41
5.39,10,22,22,18,98,47.3,48,8,4,0.102,90.614,101.846,5,91,43,0.628,55
6.03,11,29,29,17,109,43.6,57,11,5,0.101,101.665,113.02,7,101,44,0.649,65
5.43,8,23,23,19,103,45.3,52,10,5,0.078,95.269,106.265,7,95,43,0.638,60
5.02,13,29,29,19,115,45.8,58,10,5,0.113,106.919,119.51,7,107,49,0.637,66
5.36,7,16,16,20,92,48.2,44,8,4,0.076,84.73,95.431,5,85,41,0.619,51
5.69,11,29,29,14,102,44.8,53,10,5,0.108,96.269,107.265,7,96,43,0.642,59
5.58,7,16,16,20,92,48.2,44,8,4,0.076,84.73,95.431,5,85,41,0.619,51
6.44,6,21,21,9,74,46.5,38,8,3,0.081,70.967,79.793,3,71,33,0.633,41
5.92,10,28,28,17,106,45.9,53,8,4,0.094,97.498,109.261,5,98,45,0.64,61
6.21,10,24,26,18,103,46.3,51,9,4,0.097,94.716,106.344,5,95,44,0.634,59
5.942,6,21,21,9,74,47.9,37,7,3,0.081,70.643,79.849,3,71,34,0.622,40
6.542,6,21,21,8,71,44.1,38,9,3,0.085,68.407,76.322,3,68,30,0.651,41
7.143,6,15,15,12,72,50.0,35,8,3,0.083,69.85,79.209,3,70,35,0.607,37
6.38,6,21,21,10,77,47.3,39,8,3,0.078,73.85,83.209,3,74,35,0.628,42
5.68,12,29,29,18,112,45.2,57,10,5,0.107,104.036,116.095,7,104,47,0.641,65
5.59,10,29,29,16,106,43.9,55,10,5,0.094,98.269,109.265,7,98,43,0.649,63
5.68,11,29,29,17,109,44.6,56,10,5,0.101,101.152,112.68,7,101,45,0.645,64
5.569,17,20,22,17,102,48.5,51,14,6,0.167,99.785,112.384,8,99,48,0.605,54
5.84,11,29,29,17,109,43.6,57,11,5,0.101,101.665,113.02,7,101,44,0.649,65
5.39,11,29,29,13,99,44.1,52,10,5,0.111,93.385,103.85,7,93,41,0.646,58
5.78,12,29,29,18,113,44.8,58,11,5,0.106,105.363,117.305,8,105,47,0.642,66
5.87,11,29,29,17,109,44.6,56,10,5,0.101,101.152,112.68,7,101,45,0.645,64
5.678,15,20,22,14,93,46.7,48,14,6,0.161,91.134,102.139,8,90,42,0.615,51
5.64,11,21,23,13,93,45.6,49,15,7,0.118,91.352,102.222,8,90,41,0.62,52
6.246,22,27,29,17,120,47.9,61,17,7,0.183,117.967,132.836,9,117,56,0.609,64
6.319,15,9,9,18,80,55.7,35,8,3,0.188,78.388,90.135,4,79,44,0.563,36
6.0,16,9,9,15,70,54.3,32,8,3,0.229,69.843,79.75,4,70,38,0.575,32
6.602,14,9,9,17,76,54.7,34,8,3,0.184,74.501,85.454,3,75,41,0.574,35
4.0,11,20,22,15,95,47.8,48,13,6,0.116,92.69,104.344,7,92,44,0.61,51
6.201,14,9,9,13,64,53.1,30,8,3,0.219,64.076,72.92,4,64,34,0.581,30
6.567,11,20,22,14,94,46.2,49,15,6,0.117,91.96,102.769,7,91,42,0.626,52
6.77,22,27,29,17,120,47.9,61,17,7,0.183,117.967,132.836,9,117,56,0.609,64
4.495,14,11,13,13,67,53.0,31,7,3,0.209,65.752,74.976,4,66,35,0.581,32
4.959,14,12,14,13,68,52.2,32,7,3,0.206,66.752,75.976,4,67,35,0.587,33
7.169,22,27,29,17,120,47.9,61,17,7,0.183,117.967,132.836,9,117,56,0.609,64
8.276,22,27,29,18,123,48.3,62,17,7,0.179,120.85,136.251,9,120,58,0.606,65
5.959,17,30,33,11,103,44.4,55,14,6,0.165,100.018,111.554,8,99,44,0.635,59
6.602,25,28,29,17,123,48.3,62,17,7,0.203,120.85,136.251,9,120,58,0.606,65
7.398,25,28,29,16,120,47.9,61,17,7,0.208,117.967,132.836,9,117,56,0.609,64
5.796,24,26,28,18,123,49.2,61,17,6,0.195,120.625,136.54,8,120,59,0.601,64
8.42,22,27,29,16,115,47.3,59,16,7,0.191,112.981,126.922,9,112,53,0.613,62
6.0,10,18,21,5,58,42.9,32,9,4,0.172,56.963,62.74,6,56,24,0.648,34
6.21,7,17,19,14,77,48.6,37,6,2,0.091,71.425,80.766,3,72,35,0.62,42
5.88,7,17,19,12,71,47.0,35,6,2,0.099,65.658,73.936,3,66,31,0.63,40
5.66,7,18,19,13,75,48.6,36,5,2,0.093,69.323,78.268,3,70,34,0.623,41
6.25,7,11,13,19,80,52.0,36,6,2,0.088,74.192,84.597,3,75,39,0.596,41
6.4,8,17,19,14,77,48.6,37,6,2,0.104,71.425,80.766,3,72,35,0.62,42
5.4,10,18,21,5,57,43.6,31,8,4,0.175,55.636,61.531,5,55,24,0.647,33
6.3,10,16,17,4,51,44.0,28,8,5,0.196,50.753,56.116,5,50,22,0.641,29
5.68,7,18,19,12,72,47.8,35,5,2,0.097,66.44,74.853,3,67,32,0.628,40
5.0,7,17,19,14,77,48.6,37,6,2,0.091,71.425,80.766,3,72,35,0.62,42
9.032,32,29,33,23,149,47.3,77,25,11,0.215,148.41,166.002,15,146,69,0.609,80
5.857,41,31,35,30,179,48.3,91,30,13,0.229,178.781,200.533,18,176,85,0.601,94
5.903,26,31,33,30,173,49.1,86,25,11,0.15,170.512,192.36,14,169,83,0.599,90
5.7,41,31,35,30,179,48.3,91,30,13,0.229,178.781,200.533,18,176,85,0.601,94
10.0,34,31,35,23,155,46.1,82,28,13,0.219,155.167,172.919,17,152,70,0.614,85
7.658,25,29,32,16,124,45.5,66,21,10,0.202,123.25,137.095,13,121,55,0.622,69
6.036,20,26,28,15,111,48.1,56,15,6,0.18,108.545,122.587,7,108,52,0.609,59
5.532,4,31,35,1,66,35.0,39,7,3,0.061,60.567,66.069,4,60,21,0.711,45
6.275,7,11,13,17,75,50.0,35,7,2,0.093,69.752,78.976,4,70,35,0.605,40
7.796,19,26,28,17,116,48.2,58,15,6,0.164,112.428,127.002,7,112,54,0.61,62
6.2,11,18,21,6,62,41.7,35,11,4,0.177,61.498,67.309,7,60,25,0.656,37
6.5,4,22,26,2,58,37.0,34,10,3,0.069,54.771,60.896,2,54,20,0.681,38
5.5,10,25,27,9,83,43.0,45,11,5,0.12,79.952,88.687,7,79,34,0.645,49
4.6,8,16,16,22,98,49.5,46,8,4,0.082,90.498,102.261,5,91,45,0.612,53
5.6,11,27,28,13,97,44.0,51,11,5,0.113,91.603,101.933,7,91,40,0.644,57
5.6,11,27,28,13,97,44.0,51,11,5,0.113,91.603,101.933,7,91,40,0.644,57
7.2,18,29,32,13,106,46.1,55,13,5,0.17,102.683,114.886,8,102,47,0.626,59
4.98,9,23,23,17,98,45.1,50,10,5,0.092,91.385,101.85,7,91,41,0.638,57
5.975,9,17,19,18,91,45.9,46,11,3,0.099,85.705,95.528,6,85,39,0.635,52
6.921,24,27,29,17,119,47.4,61,17,7,0.202,117.192,131.547,10,116,55,0.612,64
6.569,22,27,29,15,114,45.9,60,18,7,0.193,112.272,125.66,8,111,51,0.626,63
7.0,22,27,29,15,114,45.9,60,18,7,0.193,112.272,125.66,8,111,51,0.626,63
4.921,30,36,38,19,148,45.8,78,23,10,0.203,146.014,163.331,13,144,66,0.62,82
5.9,18,30,33,12,106,44.1,57,15,6,0.17,103.225,114.913,8,102,45,0.639,61
5.495,17,25,27,13,98,47.4,50,12,5,0.173,95.472,107.261,7,95,45,0.617,53
6.151,22,27,29,18,123,48.3,62,17,7,0.179,120.85,136.251,9,120,58,0.606,65
4.921,21,21,23,15,103,47.5,53,17,7,0.204,102.432,115.175,9,101,48,0.605,55
9.194,33,30,34,19,143,44.3,78,29,12,0.231,143.458,158.889,16,140,62,0.628,81
6.046,27,32,37,17,133,45.0,71,22,10,0.203,131.236,146.009,13,129,58,0.627,75
5.538,28,31,35,29,174,47.6,89,29,13,0.161,172.686,193.493,17,170,81,0.606,93
6.137,10,28,30,10,95,45.1,50,12,6,0.105,91.454,102.142,6,91,41,0.638,54
7.398,25,29,30,17,124,47.1,64,18,8,0.202,122.403,137.172,11,121,57,0.613,67
7.4,18,33,35,11,112,44.4,60,16,7,0.161,109.105,121.966,8,108,48,0.634,64
6.495,8,22,24,10,84,42.0,47,15,6,0.095,83.225,92.33,6,81,34,0.644,50
6.959,23,29,30,15,117,46.5,61,17,8,0.197,115.308,129.132,10,114,53,0.618,64
8.921,34,31,35,22,152,45.6,81,28,13,0.224,152.283,169.504,17,149,68,0.616,84
9.194,33,30,34,19,143,44.3,78,29,12,0.231,143.458,158.889,16,140,62,0.628,81
7.018,32,29,33,24,152,47.7,78,25,11,0.211,151.294,169.417,15,149,71,0.607,81
7.569,22,26,28,18,120,49.6,59,15,6,0.183,117.196,132.832,7,117,58,0.601,62
6.796,22,27,29,15,114,45.0,61,19,7,0.193,112.847,125.893,9,111,50,0.629,64
7.569,21,26,28,17,117,49.1,58,15,6,0.179,114.312,129.417,7,114,56,0.604,61
6.854,28,28,32,20,135,47.0,70,22,10,0.207,134.003,149.839,13,132,62,0.613,73
5.824,28,31,35,29,174,47.6,89,29,13,0.161,172.686,193.493,17,170,81,0.606,93
8.658,24,39,41,15,135,46.2,70,16,7,0.178,130.406,146.457,8,130,60,0.628,75
8.478,22,27,29,17,120,47.9,61,17,7,0.183,117.967,132.836,9,117,56,0.609,64
5.959,32,29,33,24,151,48.0,77,24,11,0.212,149.966,168.208,14,148,71,0.606,80
7.678,23,28,30,15,115,46.4,60,17,8,0.2,113.199,127.005,9,112,52,0.618,63
8.155,21,26,28,18,120,49.6,59,15,6,0.175,117.196,132.832,7,117,58,0.601,62
8.42,22,31,34,16,123,46.2,64,17,7,0.179,120.192,134.547,10,119,55,0.621,68
8.0,7,27,27,8,82,44.9,43,8,3,0.085,77.85,87.209,3,78,35,0.647,47
8.854,34,31,35,23,155,46.1,82,28,13,0.219,155.167,172.919,17,152,70,0.614,85
7.092,29,28,32,20,135,47.0,70,22,10,0.215,134.003,149.839,13,132,62,0.613,73
6.18,34,30,34,26,162,47.8,83,27,12,0.21,161.49,180.955,16,159,76,0.605,86
7.959,22,27,29,16,118,47.8,60,17,7,0.186,115.857,130.71,8,115,55,0.609,63
5.48,11,25,27,13,93,42.5,50,12,5,0.118,88.232,97.857,7,87,37,0.649,56
5.923,24,26,28,19,123,50.0,60,15,6,0.195,120.079,136.247,7,120,60,0.599,63
7.658,23,27,31,15,116,45.1,62,20,9,0.198,115.072,128.507,11,113,51,0.621,65
7.0,10,18,21,5,57,43.6,31,8,4,0.175,55.636,61.531,5,55,24,0.647,33
7.481,22,30,34,15,118,45.6,62,17,7,0.186,115.199,129.005,9,114,52,0.625,66
6.959,22,29,33,15,117,45.1,62,18,7,0.188,114.523,127.949,9,113,51,0.629,66
6.406,22,26,28,18,120,49.6,59,15,6,0.183,117.196,132.832,7,117,58,0.601,62
5.854,8,16,16,12,74,47.9,37,9,4,0.108,71.298,80.268,5,71,34,0.614,40
6.81,13,18,22,12,77,50.0,37,7,2,0.169,73.596,83.81,2,74,37,0.606,40
8.347,22,27,29,15,114,45.0,61,19,7,0.193,112.847,125.893,9,111,50,0.629,64
6.301,13,20,23,12,79,51.3,37,5,2,0.165,74.865,85.387,2,76,39,0.605,40
5.886,8,15,15,10,65,49.2,32,7,3,0.123,62.985,71.145,4,63,31,0.608,34
8.575,23,21,23,18,109,49.5,54,15,7,0.211,107.654,121.713,8,107,53,0.598,56
5.721,8,16,16,13,76,49.3,37,8,4,0.105,72.854,82.474,4,73,36,0.608,40
8.699,21,27,29,15,113,47.3,58,16,7,0.186,110.872,124.796,8,110,52,0.613,61
6.8,5,22,22,6,68,39.1,39,11,4,0.074,65.563,72.576,4,64,25,0.664,43
5.67,11,29,29,17,109,43.6,57,11,5,0.101,101.476,112.624,7,101,44,0.653,65
6.0,14,17,19,12,75,52.1,35,6,3,0.187,72.083,82.47,2,73,38,0.595,37
4.569,10,11,13,9,55,50.0,27,7,3,0.182,54.218,61.315,4,54,27,0.597,28
5.469,8,11,13,15,71,51.5,33,7,3,0.113,67.752,76.976,4,68,35,0.593,36
7.538,25,26,28,17,122,48.7,61,18,6,0.205,119.843,135.623,8,119,58,0.601,64
5.67,10,28,28,17,106,45.9,53,8,4,0.094,97.498,109.261,5,98,45,0.64,61
5.538,28,31,35,29,174,47.6,89,29,13,0.161,172.686,193.493,17,170,81,0.606,93
6.6,7,11,13,20,83,52.6,37,6,2,0.084,77.076,88.012,3,78,41,0.593,42
6.28,7,11,13,17,74,50.7,34,6,2,0.095,68.425,77.766,3,69,35,0.603,39
8.886,21,33,35,13,118,45.6,62,16,7,0.178,114.872,128.796,8,114,52,0.627,66
9.509,32,29,33,23,149,47.3,77,25,11,0.215,148.41,166.002,15,146,69,0.609,80
4.319,3,20,20,6,59,45.5,30,4,2,0.051,54.352,61.272,1,55,25,0.647,34
4.0,3,24,25,2,53,38.8,30,4,2,0.057,48.807,53.887,1,49,19,0.701,34
7.959,22,27,29,23,135,48.1,67,17,7,0.163,129.617,146.081,9,129,62,0.611,73
4.0,3,22,24,2,51,36.2,30,6,2,0.059,47.727,52.705,1,47,17,0.697,34
4.538,18,14,16,16,90,49.4,45,15,6,0.2,90.345,101.763,9,89,44,0.591,46
7.4,6,22,24,7,74,39.1,42,13,6,0.081,70.178,78.059,4,69,27,0.664,47
6.622,20,26,28,19,122,49.2,60,15,6,0.164,118.196,133.832,7,118,58,0.605,64
8.523,21,33,35,13,120,45.7,63,17,7,0.175,116.974,131.294,8,116,53,0.625,67
5.1,18,20,22,15,97,48.4,49,14,6,0.186,95.901,107.969,8,95,46,0.604,51
5.9,9,18,21,4,54,42.3,30,8,4,0.167,52.753,58.116,5,52,22,0.655,32
5.469,9,20,20,10,74,49.3,36,6,2,0.122,70.425,79.766,3,71,35,0.615,39
7.076,20,26,28,17,117,49.1,58,15,6,0.171,114.312,129.417,7,114,56,0.604,61
5.746,7,16,16,15,83,50.0,40,9,4,0.084,79.949,90.514,5,80,40,0.602,43
5.669,9,16,18,15,79,48.6,38,7,2,0.114,73.538,83.023,3,74,36,0.624,43
7.553,23,28,30,16,118,47.0,61,17,8,0.195,116.083,130.421,9,115,54,0.615,64
5.792,9,16,18,15,79,48.6,38,7,2,0.114,73.632,83.126,3,74,36,0.622,43
6.509,24,21,23,23,124,50.4,60,16,7,0.194,121.516,137.583,9,121,61,0.593,63
8.377,23,29,30,16,120,47.0,62,17,8,0.192,118.192,132.547,10,117,55,0.615,65
6.52,11,29,29,17,109,43.6,57,11,5,0.101,101.665,113.02,7,101,44,0.649,65
5.95,8,11,13,15,69,50.8,32,6,2,0.116,64.541,73.351,3,65,33,0.602,36
6.745,26,27,31,17,123,45.8,65,21,9,0.211,122.25,136.095,13,120,55,0.619,68
7.523,24,29,30,16,120,47.0,62,17,8,0.2,118.192,132.547,10,117,55,0.615,65
7.845,20,26,28,14,108,47.6,55,15,6,0.185,105.661,119.171,7,105,50,0.612,58
5.52,6,22,24,8,69,46.2,35,5,2,0.087,64.556,72.438,3,65,30,0.639,39
6.032,25,28,29,16,120,47.9,61,17,7,0.208,117.967,132.836,9,117,56,0.609,64
6.328,24,26,28,17,120,48.7,60,17,6,0.2,117.741,133.125,8,117,57,0.603,63
5.84,10,22,22,18,98,47.3,48,8,4,0.102,90.614,101.846,5,91,43,0.628,55
6.52,11,29,37,17,115,42.9,60,14,3,0.096,105.123,118.168,3,105,45,0.651,70
5.45,11,29,29,17,110,44.1,57,11,5,0.1,102.479,113.889,8,102,45,0.646,65
6.38,7,17,19,14,77,48.6,37,6,2,0.091,71.425,80.766,3,72,35,0.62,42
7.119,26,27,31,17,123,45.8,65,21,9,0.211,122.25,136.095,13,120,55,0.619,68
6.0,17,30,33,13,109,45.7,57,14,6,0.156,105.785,118.384,8,105,48,0.628,61
6.638,23,27,29,16,117,47.4,60,17,7,0.197,115.083,129.421,9,114,54,0.612,63
5.724,26,31,33,30,173,49.1,86,25,11,0.15,170.512,192.36,14,169,83,0.599,90
5.0,4,13,19,5,48,37.8,28,10,3,0.083,46.051,50.312,3,45,17,0.692,31
4.987,16,20,22,12,88,46.5,46,14,6,0.182,87.25,97.723,8,86,40,0.614,48
8.328,28,28,32,19,132,46.5,69,22,10,0.212,131.119,146.424,13,129,60,0.615,72
5.81,41,31,35,30,179,48.3,91,30,13,0.229,178.781,200.533,18,176,85,0.601,94
6.35,12,37,39,8,101,40.4,56,11,5,0.119,94.72,104.517,7,94,38,0.671,63
6.658,23,29,30,16,119,44.8,64,19,8,0.193,118.403,132.357,9,116,52,0.624,67
7.292,13,18,22,12,77,51.4,36,6,2,0.169,73.083,83.47,2,74,38,0.601,39
6.337,7,27,27,7,79,44.0,42,8,3,0.089,74.967,83.793,3,75,33,0.653,46
4.658,14,16,20,12,75,49.3,37,9,4,0.187,73.036,82.255,4,73,36,0.615,39
4.0,2,14,16,1,34,31.3,22,7,4,0.059,33.145,35.728,3,32,10,0.723,24
8.081,16,29,32,12,102,45.9,53,12,5,0.157,98.472,110.261,7,98,45,0.629,57
6.0,17,29,32,13,105,46.5,54,12,5,0.162,101.356,113.677,7,101,47,0.625,58
4.833,7,17,19,5,54,44.2,29,7,3,0.13,52.451,58.485,4,52,23,0.638,31
4.772,8,23,25,3,59,41.1,33,7,3,0.136,56.451,62.485,4,56,23,0.664,36
4.943,8,17,19,4,52,42.0,29,8,3,0.154,50.643,55.989,4,50,21,0.657,31
4.959,18,19,21,15,93,49.5,46,12,5,0.194,91.472,103.261,7,91,45,0.601,48
5.921,19,23,26,17,106,49.5,52,12,5,0.179,103.123,116.507,7,103,51,0.604,55
5.201,18,23,26,16,103,49.0,51,12,5,0.175,100.239,113.092,7,100,49,0.607,54
4.562,6,17,19,4,51,42.9,28,7,3,0.118,49.567,55.069,4,49,21,0.646,30
4.409,3,23,28,3,57,38.5,32,6,1,0.053,52.091,58.153,0,52,20,0.687,37
4.93,4,12,13,11,56,48.1,27,4,2,0.071,51.687,58.109,3,52,25,0.625,31
5.45,5,13,14,15,71,48.5,34,6,3,0.07,65.767,74.062,4,66,32,0.618,39
6.05,11,24,35,13,98,41.1,53,16,3,0.112,90.909,102.089,3,90,37,0.653,61
4.301,6,21,21,9,72,47.1,36,6,3,0.083,67.432,76.225,2,68,32,0.631,40
6.013,8,22,24,10,84,45.7,44,12,6,0.095,81.687,91.311,6,81,37,0.63,47
6.432,8,16,16,16,86,50.6,41,9,4,0.093,82.832,93.929,5,83,42,0.598,44
5.886,9,28,30,10,95,45.1,50,12,6,0.095,91.454,102.142,6,91,41,0.638,54
6.0,8,23,27,9,84,43.8,45,13,4,0.095,80.712,90.72,4,80,35,0.636,49
6.658,8,16,20,16,89,49.4,43,11,3,0.09,84.818,96.673,3,85,42,0.603,47
7.244,22,31,34,15,119,46.1,62,16,7,0.185,115.981,129.922,9,115,53,0.623,66
6.509,24,27,29,17,118,47.8,60,16,7,0.203,115.865,130.338,9,115,55,0.611,63
6.041,25,27,29,18,121,48.3,61,16,7,0.207,118.748,133.753,9,118,57,0.608,64
7.745,18,20,22,13,92,47.8,47,14,6,0.196,90.909,102.428,7,90,43,0.607,49
7.824,23,29,30,16,119,46.6,62,17,8,0.193,117.188,131.282,9,116,54,0.621,65
6.854,23,29,30,15,116,46.0,61,17,8,0.198,114.21,127.764,9,113,52,0.626,64
6.854,25,27,29,18,122,47.9,62,17,7,0.205,120.076,134.962,10,119,57,0.609,65
5.886,9,28,30,9,92,44.3,49,12,6,0.098,88.57,98.726,6,88,39,0.642,53
7.187,23,29,30,15,116,46.0,61,17,8,0.198,114.494,128.262,9,113,52,0.62,64
6.796,24,27,29,17,120,47.0,62,18,7,0.2,118.519,132.756,11,117,55,0.612,65
6.602,24,27,29,17,118,47.0,61,17,7,0.203,116.377,130.677,9,115,54,0.614,64
8.538,24,31,36,15,124,44.2,67,21,9,0.194,122.367,135.68,13,120,53,0.631,71
8.097,24,32,35,16,125,45.5,66,18,8,0.192,122.519,136.756,11,121,55,0.625,70
7.796,23,29,30,15,117,46.5,61,17,8,0.197,115.308,129.132,10,114,53,0.618,64
6.398,24,27,29,17,119,47.4,61,17,7,0.202,117.192,131.547,10,116,55,0.612,64
4.924,19,20,22,14,95,47.3,49,15,6,0.2,94.094,105.474,8,93,44,0.613,51
6.921,24,29,30,17,124,47.9,63,17,8,0.194,121.85,137.251,9,121,58,0.61,66
5.959,23,27,29,16,116,46.9,60,17,7,0.198,114.308,128.132,10,113,53,0.614,63
7.387,23,27,31,15,116,45.1,62,20,9,0.198,115.072,128.507,11,113,51,0.621,65
7.585,22,27,29,15,114,46.8,59,17,7,0.193,112.199,126.005,9,111,52,0.614,62
6.415,3,21,21,3,55,42.3,30,6,3,0.055,52.014,58.149,2,52,22,0.659,33
6.187,21,27,29,15,114,46.8,59,17,7,0.184,112.199,126.005,9,111,52,0.614,62
4.907,14,9,9,13,62,51.6,30,8,3,0.226,62.298,70.365,4,62,32,0.597,30
7.229,22,27,29,16,117,44.7,63,20,7,0.188,116.621,130.44,9,114,51,0.622,66
6.77,22,27,29,16,117,44.7,63,20,7,0.188,116.621,130.44,9,114,51,0.622,66
6.569,3,23,25,2,55,39.2,31,6,3,0.055,51.131,56.734,2,51,20,0.681,35
5.626,9,20,23,15,86,48.8,41,6,2,0.105,79.192,89.597,3,80,39,0.621,47
6.155,7,21,21,11,80,48.1,40,8,3,0.088,76.923,87.02,3,77,37,0.618,43
5.7,6,23,23,6,71,40.3,40,11,5,0.085,68.192,75.315,6,67,27,0.66,44
6.013,7,21,21,12,83,50.0,40,7,3,0.084,79.294,90.095,3,80,40,0.609,43
5.546,11,17,19,15,82,48.1,40,8,3,0.134,76.963,86.6,5,77,37,0.618,45
5.628,7,20,23,13,80,47.3,39,6,2,0.088,73.425,82.766,3,74,35,0.63,45
5.372,10,16,18,16,82,50.6,38,6,2,0.122,76.192,86.597,3,77,39,0.606,43
5.398,8,11,13,14,68,48.4,33,8,3,0.118,64.312,72.355,5,64,31,0.61,37
4.0,5,16,18,2,41,38.5,24,6,2,0.122,39.694,43.475,3,39,15,0.685,26
6.215,7,21,21,12,83,50.0,40,7,3,0.084,79.294,90.095,3,80,40,0.609,43
6.092,8,21,21,13,86,50.6,41,7,3,0.093,82.178,93.51,3,83,42,0.605,44
7.796,22,31,34,15,121,46.2,63,17,7,0.182,118.083,132.421,9,117,54,0.622,67
8.444,22,27,29,15,114,45.9,60,18,7,0.193,112.428,125.847,9,111,51,0.624,63
7.638,28,30,33,17,130,45.7,69,22,11,0.215,129.236,144.009,13,127,58,0.621,72
6.824,29,28,32,19,132,46.5,69,22,10,0.22,131.119,146.424,13,129,60,0.615,72
7.796,22,27,29,16,117,47.4,60,17,7,0.188,115.083,129.421,9,114,54,0.612,63
5.696,11,19,20,16,87,48.8,42,7,3,0.126,81.629,91.932,5,82,40,0.617,47
6.824,26,27,31,17,122,46.2,64,20,9,0.213,120.923,134.886,12,119,55,0.618,67
6.886,25,28,32,17,125,44.6,67,22,10,0.2,123.469,137.178,13,121,54,0.626,71
6.114,8,26,29,5,71,44.8,37,6,2,0.113,66.549,74.81,2,67,30,0.647,41
5.388,8,16,18,14,76,49.3,36,6,2,0.105,70.425,79.766,3,71,35,0.615,41
7.155,11,19,20,16,87,48.8,42,7,3,0.126,81.629,91.932,5,82,40,0.617,47
6.125,8,21,21,12,84,49.4,41,8,3,0.095,80.621,91.304,4,81,40,0.61,44
8.0,7,21,21,11,80,48.1,40,8,3,0.088,76.734,86.624,3,77,37,0.624,43
6.292,24,27,29,16,116,46.9,60,17,7,0.207,114.308,128.132,10,113,53,0.614,63
5.961,11,17,19,16,85,47.5,42,9,3,0.129,80.17,89.96,5,80,38,0.624,47
