pXC50,nCsp3,nF,nN,nHet,Si,nAT,nBT,Se,nH,nX,X.,nCsp2,Sp,SCBO,Mv,nBO,nSK,Mi,RBN
6.602,13,0,7,12,75.228,66,69,66.701,31,0,0.0,10,42.642,46.0,0.614,38,35,1.14,9
6.347,7,0,3,7,53.069,47,49,47.567,21,0,0.0,12,30.688,36.0,0.631,28,26,1.129,6
7.347,5,0,4,5,45.109,40,43,39.92,18,0,0.0,12,26.807,32.0,0.637,25,22,1.128,1
6.745,0,0,3,4,27.95,25,27,25.284,9,0,0.0,12,17.756,25.0,0.694,18,16,1.118,0
6.607,5,0,4,6,46.318,41,44,41.247,18,0,0.0,12,27.262,34.0,0.639,26,23,1.13,1
6.68,0,0,3,4,27.95,25,27,25.284,9,0,0.0,12,17.756,26.0,0.694,18,16,1.118,0
6.523,11,0,7,11,67.478,59,62,59.858,27,0,0.0,10,37.472,43.0,0.615,35,32,1.144,6
7.237,4,0,4,5,41.694,37,40,37.036,16,0,0.0,12,25.046,32.0,0.648,24,21,1.127,1
7.35,10,0,7,12,64.983,57,60,58.051,25,0,0.0,10,37.358,43.0,0.63,35,32,1.14,6
5.699,6,0,3,8,61.405,55,58,55.527,23,0,0.0,18,38.097,46.0,0.661,35,32,1.116,7
7.292,6,0,4,5,46.109,41,45,40.92,18,0,0.0,12,27.807,35.0,0.646,27,23,1.125,1
6.47,6,0,4,6,49.734,44,47,44.131,20,0,0.0,12,29.023,35.0,0.63,27,24,1.13,4
4.854,0,0,2,3,25.452,23,25,23.182,8,0,0.0,12,16.75,25.0,0.71,17,15,1.107,0
6.699,6,0,4,9,60.488,54,57,54.745,22,0,0.0,17,37.341,46.0,0.664,35,32,1.12,7
6.301,6,0,3,9,62.614,56,59,56.854,23,0,0.0,18,38.551,47.0,0.662,36,33,1.118,8
6.762,6,0,4,5,50.939,45,47,44.687,22,0,0.0,12,29.33,33.0,0.612,25,23,1.132,6
6.398,6,0,5,10,59.571,53,56,53.963,21,0,0.0,16,36.585,46.0,0.667,35,32,1.124,7
6.398,10,0,7,12,64.983,57,60,58.051,25,0,0.0,10,37.358,43.0,0.63,35,32,1.14,6
6.222,10,0,8,13,64.066,56,59,57.269,24,0,0.0,9,36.602,43.0,0.633,35,32,1.144,6
7.602,11,0,5,11,71.441,63,66,63.825,29,0,0.0,12,41.085,45.0,0.622,37,34,1.134,7
6.301,6,0,3,8,61.405,55,58,55.527,23,0,0.0,18,38.097,46.0,0.661,35,32,1.116,7
7.149,8,0,4,5,52.939,47,51,46.687,22,0,0.0,12,31.33,37.0,0.629,29,25,1.126,3
7.35,11,3,6,14,70.334,61,64,63.254,25,3,4.9,11,39.688,47.0,0.641,39,36,1.153,6
5.793,4,3,2,7,36.636,32,34,33.447,11,3,9.4,10,22.495,29.0,0.695,23,21,1.145,1
7.427,6,0,4,9,63.903,57,60,57.629,24,0,0.0,18,39.102,47.0,0.656,36,33,1.121,7
7.379,6,0,5,10,59.571,53,56,53.963,21,0,0.0,16,36.585,46.0,0.667,35,32,1.124,7
5.585,0,0,2,3,25.452,23,25,23.182,8,0,0.0,12,16.75,25.0,0.71,17,15,1.107,0
8.699,4,2,4,7,46.788,41,44,41.945,16,2,4.9,14,27.682,37.0,0.665,28,25,1.141,3
8.523,5,1,4,6,49.864,44,47,44.316,19,1,2.3,14,29.506,37.0,0.645,28,25,1.133,3
5.0,12,0,3,6,74.062,66,70,65.29,33,0,0.0,15,43.995,45.0,0.615,37,33,1.122,6
8.222,5,1,4,6,49.864,44,47,44.316,19,1,2.3,14,29.506,37.0,0.645,28,25,1.133,3
8.285,5,1,4,6,49.864,44,47,44.316,19,1,2.3,14,29.506,37.0,0.645,28,25,1.133,3
8.222,5,1,4,6,49.864,44,47,44.316,19,1,2.3,14,29.506,37.0,0.645,28,25,1.133,3
8.699,5,2,4,7,50.204,44,47,44.829,18,2,4.5,14,29.444,38.0,0.654,29,26,1.141,3
7.461,10,0,4,9,64.318,57,60,57.512,26,0,0.0,12,37.864,42.0,0.63,34,31,1.128,7
6.762,15,0,3,6,71.062,63,67,62.29,33,0,0.0,9,40.995,39.0,0.597,34,30,1.128,5
8.049,8,0,4,5,59.77,53,56,52.454,26,0,0.0,14,34.853,39.0,0.615,30,27,1.128,4
6.301,6,0,3,10,64.823,58,61,59.182,23,0,0.0,19,40.006,50.0,0.669,38,35,1.118,9
7.886,9,0,2,5,50.487,45,48,44.771,22,0,0.0,9,30.182,31.0,0.621,26,23,1.122,3
6.158,8,0,2,5,57.903,52,56,51.654,24,0,0.0,15,35.944,40.0,0.643,32,28,1.114,3
7.276,9,0,2,5,61.318,55,59,54.538,26,0,0.0,15,37.705,41.0,0.636,33,29,1.115,4
7.42,10,0,2,5,64.733,58,62,57.421,28,0,0.0,15,39.466,42.0,0.629,34,30,1.116,5
7.824,5,0,4,5,49.524,44,47,43.803,20,0,0.0,14,29.569,36.0,0.637,27,24,1.126,3
8.222,4,1,4,6,46.449,41,44,41.432,17,1,2.4,14,27.745,36.0,0.655,27,24,1.133,3
9.0,4,1,4,6,46.449,41,44,41.432,17,1,2.4,14,27.745,36.0,0.655,27,24,1.133,3
8.461,6,0,4,5,52.939,47,50,46.687,22,0,0.0,14,31.33,37.0,0.629,28,25,1.126,3
8.35,6,0,4,5,52.939,47,50,46.687,22,0,0.0,14,31.33,37.0,0.629,28,25,1.126,3
8.35,5,0,4,5,49.524,44,47,43.803,20,0,0.0,14,29.569,36.0,0.637,27,24,1.126,3
5.538,0,0,2,3,25.452,23,25,23.182,8,0,0.0,12,16.75,25.0,0.71,17,15,1.107,0
7.347,13,0,2,5,64.148,57,60,56.305,30,0,0.0,9,37.228,35.0,0.597,30,27,1.125,6
7.004,3,0,1,4,29.913,27,29,27.251,11,0,0.0,9,19.369,23.0,0.677,18,16,1.108,0
7.149,13,0,2,5,64.148,57,60,56.305,30,0,0.0,9,37.228,35.0,0.597,30,27,1.125,5
7.538,10,0,2,6,55.112,49,52,48.982,24,0,0.0,9,32.398,33.0,0.616,28,25,1.125,4
7.398,11,0,2,6,58.527,52,55,51.865,26,0,0.0,9,34.159,34.0,0.61,29,26,1.126,5
7.753,8,0,4,5,59.77,53,56,52.454,26,0,0.0,14,34.853,39.0,0.615,30,27,1.128,4
7.921,8,0,4,5,59.77,53,56,52.454,26,0,0.0,14,34.853,39.0,0.615,30,27,1.128,4
8.699,4,1,4,6,46.449,41,44,41.432,17,1,2.4,14,27.745,36.0,0.655,27,24,1.133,3
7.585,4,0,4,6,46.053,41,44,41.243,17,1,2.4,14,28.665,36.0,0.666,27,24,1.123,3
7.678,5,0,4,5,49.524,44,47,43.803,20,0,0.0,14,29.569,36.0,0.637,27,24,1.126,3
8.35,5,0,4,5,49.524,44,47,43.803,20,0,0.0,14,29.569,36.0,0.637,27,24,1.126,3
7.409,9,0,2,5,50.487,45,48,44.771,22,0,0.0,9,30.182,31.0,0.621,26,23,1.122,2
7.602,10,0,2,5,53.903,48,51,47.654,24,0,0.0,9,31.944,32.0,0.614,27,24,1.123,3
7.252,11,0,2,5,57.318,51,54,50.538,26,0,0.0,9,33.705,33.0,0.607,28,25,1.124,4
8.16,6,0,4,5,52.939,47,50,46.687,22,0,0.0,14,31.33,37.0,0.629,28,25,1.126,3
7.553,8,0,2,5,47.072,42,45,41.887,20,0,0.0,9,28.421,30.0,0.629,25,22,1.121,2
8.461,4,1,4,6,46.449,41,44,41.432,17,1,2.4,14,27.745,36.0,0.655,27,24,1.133,3
7.097,8,0,2,5,47.072,42,45,41.887,20,0,0.0,9,28.421,30.0,0.629,25,22,1.121,2
8.523,4,0,4,5,46.109,41,44,40.92,18,0,0.0,14,27.807,35.0,0.646,26,23,1.125,3
7.444,4,0,4,5,46.109,41,44,40.92,18,0,0.0,14,27.807,35.0,0.646,26,23,1.125,3
7.959,7,0,4,5,56.355,50,53,49.571,24,0,0.0,14,33.091,38.0,0.621,29,26,1.127,4
7.886,7,0,4,5,56.355,50,53,49.571,24,0,0.0,14,33.091,38.0,0.621,29,26,1.127,4
8.398,5,0,4,5,49.524,44,47,43.803,20,0,0.0,14,29.569,36.0,0.637,27,24,1.126,3
7.377,11,0,2,5,57.318,51,54,50.538,26,0,0.0,9,33.705,33.0,0.607,28,25,1.124,4
6.569,0,0,4,5,31.448,28,30,28.385,10,0,0.0,13,19.762,29.0,0.692,20,18,1.123,2
7.77,5,0,4,6,50.734,45,48,45.131,20,0,0.0,14,30.023,37.0,0.638,28,25,1.127,4
7.509,6,0,5,6,55.438,49,52,48.789,23,0,0.0,14,32.336,38.0,0.624,29,26,1.131,4
8.495,5,0,4,5,49.524,44,47,43.803,20,0,0.0,14,29.569,36.0,0.637,27,24,1.126,3
6.886,1,0,3,4,35.78,32,34,32.051,13,0,0.0,14,22.279,30.0,0.669,21,19,1.118,3
7.0,0,0,3,5,32.309,29,31,29.491,10,1,3.4,14,21.375,30.0,0.714,21,19,1.114,2
7.854,0,0,3,5,32.309,29,31,29.491,10,1,3.4,14,21.375,30.0,0.714,21,19,1.114,2
7.854,3,2,4,7,45.788,40,42,40.945,16,2,5.0,14,26.682,35.0,0.656,26,24,1.145,5
8.174,4,0,4,5,48.524,43,45,42.803,20,0,0.0,14,28.569,34.0,0.628,25,23,1.128,5
8.432,3,0,4,5,45.109,40,42,39.92,18,0,0.0,14,26.807,33.0,0.637,24,22,1.128,4
7.796,4,0,4,5,48.524,43,45,42.803,20,0,0.0,14,28.569,34.0,0.628,25,23,1.128,4
8.229,6,0,5,6,57.853,51,53,50.672,25,0,0.0,14,33.097,37.0,0.61,28,26,1.134,7
8.367,3,0,4,5,45.109,40,42,39.92,18,0,0.0,14,26.807,33.0,0.637,24,22,1.128,5
8.276,2,0,4,5,41.694,37,39,37.036,16,0,0.0,14,25.046,32.0,0.648,23,21,1.127,4
8.658,3,0,4,5,42.694,38,41,38.036,16,0,0.0,14,26.046,34.0,0.657,25,22,1.124,2
7.149,0,0,4,5,31.448,28,30,28.385,10,0,0.0,13,19.762,29.0,0.692,20,18,1.123,2
8.432,3,0,4,5,45.109,40,42,39.92,18,0,0.0,14,26.807,33.0,0.637,24,22,1.128,4
8.319,5,0,4,5,49.524,44,47,43.803,20,0,0.0,14,29.569,36.0,0.637,27,24,1.126,4
8.678,3,1,4,6,45.449,40,42,40.432,17,1,2.5,14,26.745,34.0,0.647,25,23,1.136,5
8.62,5,0,4,5,49.524,44,47,43.803,20,0,0.0,14,29.569,36.0,0.637,27,24,1.126,3
6.699,3,0,4,5,45.109,40,42,39.92,18,0,0.0,14,26.807,33.0,0.637,24,22,1.128,5
8.721,6,0,4,5,52.939,47,50,46.687,22,0,0.0,14,31.33,37.0,0.629,28,25,1.126,4
8.854,3,0,4,5,42.694,38,41,38.036,16,0,0.0,14,26.046,34.0,0.657,25,22,1.124,2
8.509,4,0,4,5,46.109,41,44,40.92,18,0,0.0,14,27.807,35.0,0.646,26,23,1.125,3
8.495,5,0,4,5,49.524,44,47,43.803,20,0,0.0,14,29.569,36.0,0.637,27,24,1.126,3
8.046,5,0,4,5,49.524,44,47,43.803,20,0,0.0,14,29.569,36.0,0.637,27,24,1.126,3
7.62,0,0,3,5,32.309,29,31,29.491,10,1,3.4,14,21.375,30.0,0.714,21,19,1.114,2
6.699,7,2,3,11,55.878,49,51,50.996,19,2,4.1,12,32.665,40.0,0.66,32,30,1.14,7
6.0,10,0,6,11,65.899,58,61,58.832,26,0,0.0,11,38.114,43.0,0.628,35,32,1.136,6
6.097,10,0,7,12,65.272,57,60,58.302,25,0,0.0,10,36.165,43.0,0.622,35,32,1.145,6
5.301,8,0,3,7,62.9,56,59,56.334,25,0,0.0,16,37.21,44.5,0.638,34,31,1.123,6
6.507,0,0,2,3,25.452,23,25,23.182,8,0,0.0,12,16.75,25.0,0.71,17,15,1.107,0
6.398,8,0,3,7,62.9,56,59,56.334,25,0,0.0,16,37.21,44.5,0.638,34,31,1.123,6
5.523,12,0,6,8,63.976,56,59,55.985,28,0,0.0,8,35.319,37.0,0.596,31,28,1.142,6
6.046,10,0,7,11,68.478,60,63,60.858,27,0,0.0,12,38.472,45.0,0.621,36,33,1.141,6
6.301,6,0,3,9,50.518,45,47,46.084,18,1,2.2,12,31.432,37.0,0.67,29,27,1.123,6
4.658,0,0,1,8,48.122,44,47,45.353,13,4,9.1,23,35.386,46.5,0.77,34,31,1.094,4
7.377,5,0,4,5,42.694,38,42,38.036,16,0,0.0,12,26.046,34.0,0.657,26,22,1.124,1
7.26,0,0,3,4,32.365,29,31,29.167,11,0,0.0,14,20.517,29.0,0.686,20,18,1.116,2
7.538,8,0,2,4,48.567,43,45,42.694,22,0,0.0,9,27.534,28.0,0.599,23,21,1.129,4
7.602,8,0,4,5,50.939,45,48,44.687,22,0,0.0,10,29.33,32.5,0.612,26,23,1.132,2
8.036,13,0,2,5,75.268,67,71,66.323,34,0,0.0,15,43.557,45.0,0.606,37,33,1.123,7
8.003,6,0,7,8,59.019,52,56,52.109,23,0,0.0,15,34.586,43.0,0.636,33,29,1.135,5
6.0,2,0,1,3,23.578,21,22,21.291,9,0,0.0,7,13.96,17.0,0.646,13,12,1.123,2
7.167,3,0,2,4,44.737,40,42,39.927,18,0,0.0,15,27.012,32.0,0.642,24,22,1.118,3
8.553,7,0,3,4,54.856,49,53,48.469,23,0,0.0,15,33.086,39.0,0.634,30,26,1.12,3
6.569,0,0,1,3,19.795,18,19,18.309,6,1,5.6,9,14.097,18.0,0.741,13,12,1.1,0
6.051,0,0,1,2,30.784,28,30,27.847,11,0,0.0,15,20.267,27.0,0.692,19,17,1.099,1
6.0,1,0,3,4,24.95,22,23,22.284,9,0,0.0,8,14.756,20.0,0.653,14,13,1.134,1
4.26,0,0,1,3,17.795,16,16,16.309,6,1,6.3,7,12.097,14.0,0.709,10,10,1.112,1
4.721,1,0,1,2,21.369,19,19,18.964,9,0,0.0,7,12.506,14.0,0.623,10,10,1.125,1
7.284,1,0,2,4,23.661,21,22,21.509,8,0,0.0,8,14.205,19.0,0.669,14,13,1.127,0
4.77,1,0,1,3,22.578,20,20,20.291,9,0,0.0,7,12.96,15.0,0.628,11,11,1.129,2
4.921,0,0,2,3,19.036,17,18,17.298,6,0,0.0,8,11.989,17.5,0.695,12,11,1.12,0
5.071,3,0,1,4,26.937,24,25,24.498,10,1,4.2,7,16.58,19.0,0.663,15,14,1.122,1
6.796,3,0,1,2,25.784,23,24,22.847,11,0,0.0,7,15.267,17.0,0.625,13,12,1.121,0
4.699,0,1,1,3,18.293,16,16,16.593,6,1,6.3,7,10.682,14.0,0.669,10,10,1.143,1
4.966,11,0,2,4,54.398,48,50,47.461,26,0,0.0,7,30.057,28.0,0.579,24,22,1.133,6
8.222,0,0,3,5,33.575,30,32,30.494,11,0,0.0,14,20.972,30.0,0.687,21,19,1.119,2
7.495,2,0,3,5,40.405,36,38,36.262,15,0,0.0,14,24.495,32.0,0.657,23,21,1.122,3
7.222,1,0,3,5,36.99,33,35,33.378,13,0,0.0,14,22.733,31.0,0.671,22,20,1.121,3
8.523,0,0,3,5,32.309,29,31,29.491,10,1,3.4,14,21.375,30.0,0.714,21,19,1.114,2
6.866,3,0,3,7,46.239,41,43,41.8,17,0,0.0,14,27.165,35.0,0.649,26,24,1.128,5
8.076,0,0,3,5,32.309,29,31,29.491,10,1,3.4,14,21.375,30.0,0.714,21,19,1.114,2
6.456,1,3,3,7,25.969,22,23,23.822,6,3,13.6,8,14.568,23.0,0.705,17,16,1.18,1
8.796,1,0,3,5,36.99,33,35,33.378,13,0,0.0,14,22.733,31.0,0.671,22,20,1.121,3
7.975,1,0,3,5,36.99,33,35,33.378,13,0,0.0,14,22.733,31.0,0.671,22,20,1.121,3
8.268,2,0,3,6,41.614,37,39,37.589,15,0,0.0,14,24.949,33.0,0.659,24,22,1.125,4
8.046,0,1,3,5,32.705,29,31,29.68,10,1,3.4,14,20.455,30.0,0.699,21,19,1.128,2
6.62,0,0,3,4,21.535,19,20,19.4,7,0,0.0,8,12.994,19.0,0.675,13,12,1.133,1
8.092,2,0,3,6,42.614,38,40,38.589,15,0,0.0,15,25.949,35.0,0.668,25,23,1.121,5
7.886,1,0,3,6,38.199,34,36,34.705,13,0,0.0,14,23.188,32.0,0.672,23,21,1.124,3
8.222,1,0,3,5,36.99,33,35,33.378,13,0,0.0,14,22.733,31.0,0.671,22,20,1.121,3
8.027,2,0,3,6,46.03,41,43,41.473,17,0,0.0,16,27.71,36.0,0.656,26,24,1.123,6
7.959,0,0,4,5,34.863,31,33,31.269,12,0,0.0,14,21.523,30.0,0.674,21,19,1.125,2
4.602,0,0,3,6,21.538,19,20,20.171,5,0,0.0,8,13.142,22.5,0.723,15,14,1.134,1
7.538,6,0,2,3,51.358,46,49,45.367,22,0,0.0,15,31.08,36.0,0.631,27,24,1.116,2
8.155,3,0,2,3,41.112,37,40,36.716,16,0,0.0,15,25.796,33.0,0.661,24,21,1.111,1
8.222,3,0,2,4,42.322,38,41,38.043,16,0,0.0,15,26.25,34.0,0.662,25,22,1.114,2
7.495,3,0,2,4,42.032,38,41,37.793,16,0,0.0,15,27.443,34.0,0.675,25,22,1.106,2
8.301,2,0,2,4,34.202,31,34,31.025,12,0,0.0,13,22.921,30.5,0.696,22,19,1.103,1
8.301,1,0,2,3,34.282,31,34,30.949,12,0,0.0,15,22.273,31.0,0.69,22,19,1.106,1
7.244,2,0,2,3,37.408,34,37,33.582,14,0,0.0,15,25.228,32.0,0.688,23,20,1.1,1
8.097,5,0,3,4,50.441,45,48,44.585,21,0,0.0,15,30.324,36.0,0.634,27,24,1.121,3
7.959,2,0,3,4,27.95,25,27,25.284,9,0,0.0,9,17.756,26.0,0.694,18,16,1.118,0
7.495,5,0,3,5,41.82,37,39,37.145,17,0,0.0,10,24.256,29.0,0.627,22,20,1.13,2
5.615,0,0,0,3,30.704,28,30,28.4,10,0,0.0,15,20.171,28.0,0.706,20,18,1.097,1
8.222,2,0,2,3,37.697,34,37,33.833,14,0,0.0,15,24.034,32.0,0.674,23,20,1.109,1
7.854,3,0,3,5,34.99,31,33,31.378,13,0,0.0,10,20.733,27.0,0.649,20,18,1.129,1
8.0,3,0,2,4,31.491,28,30,28.276,12,0,0.0,9,18.727,24.0,0.647,18,16,1.125,1
6.58,2,0,2,5,41.116,37,40,37.487,14,0,0.0,16,25.943,36.0,0.685,26,23,1.111,2
8.301,5,0,3,4,50.441,45,48,44.585,21,0,0.0,15,30.324,36.0,0.634,27,24,1.121,3
8.222,3,0,3,4,50.026,45,49,44.702,19,0,0.0,19,31.563,41.5,0.667,30,26,1.112,3
8.301,2,0,2,3,44.112,40,44,39.716,16,0,0.0,19,28.796,39.5,0.686,28,24,1.103,1
8.301,4,0,3,4,47.026,42,45,41.702,19,0,0.0,15,28.563,35.0,0.643,26,23,1.12,3
5.374,0,0,0,6,34.332,31,33,32.382,10,0,0.0,15,21.534,31.0,0.707,23,21,1.107,1
6.31,2,0,2,3,25.867,23,24,23.065,10,0,0.0,8,15.511,19.5,0.646,14,13,1.125,0
4.721,3,0,6,9,59.235,53,57,53.527,20,0,0.0,21,37.921,51.0,0.687,37,33,1.118,7
5.387,0,0,1,4,34.203,31,33,31.502,11,0,0.0,16,22.176,31.5,0.703,22,20,1.103,3
7.921,1,0,6,7,40.445,36,40,36.589,12,0,0.0,16,25.773,39.5,0.706,28,24,1.123,2
6.155,0,0,1,5,26.292,24,26,24.811,7,0,0.0,12,18.301,26.5,0.747,19,17,1.096,1
7.222,0,0,2,5,27.581,25,27,25.585,8,0,0.0,12,18.852,26.5,0.73,19,17,1.103,1
6.398,1,0,1,4,27.498,25,27,25.367,9,0,0.0,11,18.608,24.5,0.71,18,16,1.1,1
4.0,1,0,0,4,35.329,32,34,32.611,12,0,0.0,15,22.386,30.0,0.688,22,20,1.104,2
4.596,1,0,0,2,32.91,30,32,29.956,12,0,0.0,15,21.477,28.0,0.686,20,18,1.097,1
4.301,10,0,2,4,51.567,46,50,45.694,22,0,0.0,10,30.534,34.0,0.625,28,24,1.121,2
4.971,1,3,2,7,39.926,35,37,36.698,11,3,8.6,16,24.301,35.0,0.708,26,24,1.141,2
4.873,1,0,2,4,38.907,35,37,35.16,14,0,0.0,16,24.489,32.0,0.675,23,21,1.112,2
4.745,0,1,2,5,35.831,32,34,32.789,11,1,3.1,16,22.665,32.0,0.703,23,21,1.12,2
4.951,0,0,2,5,35.435,32,34,32.6,11,1,3.1,16,23.585,32.0,0.717,23,21,1.107,2
5.119,0,0,2,5,35.212,32,34,32.345,11,1,3.1,16,25.387,32.0,0.732,23,21,1.1,2
4.857,0,0,2,4,35.491,32,34,32.276,12,0,0.0,16,22.727,31.0,0.691,22,20,1.109,2
4.5,1,0,2,4,38.907,35,37,35.16,14,0,0.0,16,24.489,32.0,0.675,23,21,1.112,2
5.523,0,0,3,7,37.993,34,36,35.149,11,0,0.0,16,23.881,36.0,0.707,25,23,1.117,3
5.347,0,0,2,5,35.212,32,34,32.345,11,1,3.1,16,25.387,32.0,0.732,23,21,1.1,2
4.65,0,0,2,5,31.996,29,31,29.469,10,0,0.0,14,21.614,29.5,0.716,21,19,1.103,2
4.097,6,0,2,4,42.737,38,40,37.927,18,0,0.0,10,25.012,28.0,0.623,22,20,1.125,2
4.0,4,0,2,4,38.322,34,35,34.043,16,0,0.0,10,22.25,25.0,0.622,19,18,1.127,2
4.78,1,0,2,4,38.907,35,37,35.16,14,0,0.0,16,24.489,32.0,0.675,23,21,1.112,2
4.744,0,0,1,4,23.372,21,22,21.735,7,0,0.0,10,14.653,21.0,0.702,15,14,1.113,1
4.959,0,0,1,4,27.787,25,26,25.618,9,0,0.0,12,17.415,24.0,0.691,17,16,1.111,2
5.066,2,0,1,4,30.203,27,28,27.502,11,0,0.0,10,18.176,23.0,0.659,17,16,1.119,3
5.796,1,0,2,5,29.286,26,27,26.72,10,0,0.0,10,17.421,23.0,0.665,17,16,1.126,3
6.26,2,0,2,5,32.701,29,30,29.604,12,0,0.0,10,19.182,24.0,0.649,18,17,1.128,3
7.523,0,0,3,5,33.309,30,32,30.491,10,1,3.3,15,22.375,31.5,0.724,22,20,1.11,2
7.886,7,1,3,6,58.555,52,55,52.189,23,2,3.8,16,35.642,41.0,0.65,32,29,1.126,6
4.108,4,0,1,8,55.265,50,52,50.909,19,4,8.0,19,38.165,43.0,0.713,33,31,1.105,5
4.18,0,0,1,6,50.602,46,49,46.804,16,1,2.2,24,33.773,46.5,0.716,33,30,1.1,5
4.523,8,0,3,5,52.066,46,48,45.796,23,0,0.0,10,29.54,31.0,0.604,25,23,1.132,6
7.432,6,1,3,5,55.196,49,52,48.981,22,1,2.0,16,33.023,39.5,0.641,30,27,1.126,5
7.638,6,1,3,5,55.196,49,52,48.981,22,1,2.0,16,33.023,39.5,0.641,30,27,1.126,5
7.569,4,0,2,3,44.528,40,43,39.6,18,0,0.0,15,27.557,34.0,0.649,25,22,1.113,3
8.222,6,0,4,5,55.939,50,53,49.687,22,0,0.0,16,34.33,42.5,0.651,31,28,1.119,5
7.569,6,0,3,5,54.8,49,52,48.792,22,1,2.0,16,33.944,39.5,0.651,30,27,1.118,5
7.409,6,0,3,6,54.744,49,52,49.116,21,2,4.1,16,34.801,40.5,0.667,31,28,1.117,5
7.921,8,0,3,4,59.272,53,57,52.352,25,0,0.0,16,35.847,41.5,0.633,32,28,1.118,4
6.602,6,0,3,5,54.8,49,52,48.792,22,1,2.0,16,33.944,39.5,0.651,30,27,1.118,5
6.166,6,0,3,5,54.8,49,52,48.792,22,1,2.0,16,33.944,39.0,0.651,30,27,1.118,5
8.125,2,0,3,6,42.349,38,41,38.585,14,1,2.6,16,27.352,37.0,0.697,27,24,1.114,2
6.0,7,0,3,5,59.481,53,56,52.68,25,0,0.0,16,35.302,40.5,0.628,31,28,1.122,6
7.06,4,1,4,7,47.658,42,45,42.76,17,1,2.4,14,28.199,36.0,0.657,28,25,1.135,2
4.721,5,0,5,10,58.571,52,55,52.963,21,0,0.0,16,35.585,45.0,0.661,34,31,1.126,8
7.77,7,0,3,4,58.272,52,55,51.352,25,0,0.0,16,34.847,39.5,0.626,30,27,1.121,5
7.18,8,0,3,4,61.687,55,58,54.236,27,0,0.0,16,36.608,40.5,0.62,31,28,1.122,6
6.699,2,1,3,6,42.745,38,41,38.774,14,1,2.6,16,26.432,37.0,0.685,27,24,1.125,2
7.102,3,0,2,4,31.491,28,30,28.276,12,0,0.0,9,18.727,24.0,0.647,18,16,1.125,1
7.658,3,1,2,4,41.452,37,40,37.229,15,1,2.7,15,25.733,34.0,0.671,25,22,1.12,1
6.472,2,0,2,4,39.907,36,39,36.16,14,0,0.0,16,25.489,35.0,0.684,25,22,1.109,2
6.218,3,0,2,4,32.491,29,31,29.276,12,0,0.0,10,19.727,26.0,0.659,19,17,1.12,1
6.77,7,0,3,5,59.481,53,56,52.68,25,0,0.0,16,35.302,40.5,0.628,31,28,1.122,6
6.754,2,0,2,4,29.076,26,28,26.393,10,0,0.0,10,17.966,25.0,0.676,18,16,1.118,1
6.523,1,0,2,5,34.286,31,34,31.72,10,0,0.0,15,22.421,34.5,0.719,24,21,1.106,1
6.914,3,0,2,3,30.282,27,29,26.949,12,0,0.0,9,18.273,23.0,0.644,17,15,1.122,0
6.42,3,0,2,4,42.322,38,41,38.043,16,0,0.0,15,26.25,34.0,0.662,25,22,1.114,2
7.42,2,0,3,5,42.405,38,41,38.262,15,0,0.0,16,26.495,36.0,0.675,26,23,1.116,2
7.102,4,3,2,6,45.547,40,43,41.138,15,3,7.5,15,27.37,37.0,0.678,28,25,1.139,1
8.041,5,0,3,4,50.441,45,48,44.585,21,0,0.0,15,30.324,36.0,0.634,27,24,1.121,3
7.367,2,0,2,5,39.851,36,39,36.484,13,1,2.8,16,26.347,36.0,0.707,26,23,1.107,2
7.387,3,0,2,3,41.112,37,40,36.716,16,0,0.0,15,25.796,33.0,0.661,24,21,1.111,1
5.959,8,0,3,4,46.441,41,43,40.585,21,0,0.0,8,26.324,27.5,0.598,22,20,1.133,4
7.921,6,0,4,5,65.977,59,63,58.396,27,0,0.0,21,40.233,48.5,0.642,36,32,1.118,6
8.167,3,0,3,4,50.026,45,49,44.702,19,0,0.0,19,31.563,41.5,0.667,30,26,1.112,3
6.517,2,0,2,4,26.587,24,26,24.134,9,1,4.2,9,19.171,23.0,0.716,17,15,1.108,0
6.046,3,0,2,5,33.701,30,32,30.604,12,0,0.0,10,20.182,27.0,0.661,20,18,1.123,2
6.0,7,0,2,3,55.773,50,53,49.251,24,0,0.0,16,33.841,38.5,0.631,29,26,1.115,5
7.268,2,1,3,5,39.12,35,38,35.563,12,1,2.9,15,25.216,37.0,0.708,26,23,1.118,1
7.854,7,0,3,4,58.272,52,55,51.352,25,0,0.0,16,34.847,39.5,0.626,30,27,1.121,5
7.409,3,0,3,5,34.99,31,33,31.378,13,0,0.0,10,20.733,27.0,0.649,20,18,1.129,1
7.149,7,0,4,5,56.355,50,53,49.571,24,0,0.0,14,33.091,37.5,0.621,29,26,1.127,5
7.845,2,0,2,3,37.697,34,37,33.833,14,0,0.0,15,24.034,32.0,0.674,23,20,1.109,1
6.435,8,1,4,10,65.658,58,62,59.025,25,1,1.7,15,38.801,47.5,0.643,37,33,1.132,7
8.027,2,0,3,5,31.575,28,30,28.494,11,0,0.0,10,18.972,26.0,0.664,19,17,1.128,1
4.721,4,0,5,9,53.946,48,51,48.753,19,0,0.0,16,33.37,43.0,0.669,32,29,1.124,7
7.398,8,0,3,8,62.82,56,60,56.411,25,0,0.0,15,37.858,45.0,0.641,35,31,1.122,6
6.466,1,1,1,3,32.123,29,32,29.36,10,1,3.4,15,21.205,30.5,0.716,22,19,1.108,0
6.979,8,0,3,6,61.69,55,59,55.007,25,0,0.0,16,36.756,43.5,0.636,34,30,1.122,5
6.142,4,0,3,5,49.235,44,47,44.029,19,0,0.0,16,30.017,37.5,0.652,28,25,1.119,3
6.398,6,0,3,6,54.86,49,53,49.24,21,0,0.0,16,33.233,41.5,0.652,32,28,1.12,3
7.699,12,0,3,4,62.102,55,58,54.12,29,0,0.0,10,35.37,35.0,0.593,29,26,1.129,5
6.432,4,0,3,5,48.235,43,45,43.029,19,0,0.0,15,29.017,35.5,0.644,26,24,1.122,4
7.678,8,0,3,6,58.275,52,56,52.123,23,0,0.0,15,34.995,43.5,0.644,33,29,1.121,5
7.796,9,0,4,7,61.773,55,60,55.225,24,0,0.0,15,37.0,46.5,0.645,36,31,1.123,3
7.886,8,0,3,7,57.069,51,56,51.567,21,0,0.0,15,34.688,45.5,0.66,35,30,1.119,3
7.699,9,0,3,6,59.275,53,58,53.123,23,0,0.0,15,35.995,45.5,0.651,35,30,1.118,3
7.824,4,0,5,8,49.196,44,49,44.909,15,0,0.0,17,31.199,47.0,0.702,34,29,1.118,3
7.721,10,0,3,8,68.524,61,65,61.545,27,0,0.0,16,40.426,49.5,0.639,38,34,1.123,7
8.097,6,0,3,8,54.864,49,53,50.011,19,0,0.0,16,33.381,45.5,0.67,34,30,1.12,5
7.921,9,0,3,8,62.694,56,61,56.778,23,0,0.0,16,37.904,49.5,0.659,38,33,1.12,5
7.921,12,0,3,8,72.94,65,70,65.429,29,0,0.0,16,43.188,52.5,0.638,41,36,1.122,6
8.155,8,0,3,8,59.279,53,58,53.894,21,0,0.0,16,36.142,48.5,0.668,37,32,1.118,4
8.523,5,0,2,7,48.95,44,48,45.025,16,0,0.0,16,30.614,43.5,0.689,32,28,1.113,4
7.921,9,0,3,7,63.9,57,61,57.334,25,0,0.0,16,38.21,47.5,0.644,36,32,1.121,6
7.796,9,0,3,7,61.485,55,60,55.451,23,0,0.0,16,37.449,48.5,0.658,37,32,1.118,4
8.0,10,0,3,7,64.9,58,63,58.334,25,0,0.0,16,39.21,49.5,0.65,38,33,1.119,4
7.585,5,0,3,7,61.069,55,60,55.567,21,0,0.0,22,38.688,53.5,0.685,39,34,1.11,4
7.886,9,0,3,8,62.694,56,61,56.778,23,0,0.0,16,37.904,49.5,0.659,38,33,1.12,4
8.0,13,0,4,10,81.062,72,77,72.741,32,0,0.0,17,47.409,57.5,0.635,45,40,1.126,6
7.824,9,0,4,8,63.983,57,62,57.552,24,0,0.0,16,38.455,49.5,0.653,38,33,1.123,4
7.796,11,0,4,10,76.647,68,72,68.858,30,0,0.0,17,44.648,54.5,0.636,42,38,1.127,9
7.658,7,0,4,8,59.568,53,57,53.669,22,0,0.0,16,35.693,46.5,0.654,35,31,1.124,6
8.046,7,0,3,8,58.279,52,56,52.894,21,0,0.0,16,35.142,46.5,0.661,35,31,1.121,6
8.155,13,0,3,9,78.564,70,75,70.64,31,0,0.0,17,46.404,56.5,0.639,44,39,1.122,7
8.699,9,0,3,9,64.903,58,63,59.105,23,0,0.0,17,39.358,52.5,0.666,40,35,1.119,5
7.886,9,0,4,9,66.192,59,64,59.88,24,0,0.0,17,39.909,52.5,0.66,40,35,1.122,5
7.77,5,0,4,7,49.113,44,49,44.691,16,0,0.0,16,30.955,44.5,0.691,33,28,1.116,1
7.921,6,0,4,7,52.528,47,52,47.574,18,0,0.0,16,32.716,45.5,0.679,34,29,1.118,1
6.936,3,0,3,6,46.03,41,43,41.473,17,0,0.0,15,27.71,35.5,0.656,26,24,1.123,5
6.305,13,0,3,4,65.517,58,61,57.003,31,0,0.0,10,37.131,36.0,0.589,30,27,1.13,5
7.328,1,0,6,8,55.9,50,54,50.567,18,0,0.0,23,35.512,51.0,0.694,36,32,1.118,5
6.538,3,0,3,7,45.95,41,43,41.549,17,0,0.0,14,28.358,36.5,0.661,26,24,1.121,5
6.724,2,0,4,6,42.488,38,41,38.48,14,0,0.0,16,26.739,38.0,0.688,27,24,1.118,3
7.016,1,0,2,3,34.282,31,34,30.949,12,0,0.0,15,22.273,30.5,0.69,22,19,1.106,0
5.0,14,0,3,4,68.932,61,64,59.887,33,0,0.0,10,38.893,37.0,0.585,31,28,1.13,5
6.331,6,0,2,4,27.202,24,25,24.025,12,0,0.0,2,15.921,15.0,0.607,13,12,1.133,0
6.924,6,0,2,3,62.188,56,60,55.134,26,0,0.0,21,38.603,45.0,0.644,34,30,1.111,5
7.638,5,0,2,4,44.737,40,43,39.927,18,0,0.0,13,27.012,33.0,0.642,25,22,1.118,2
6.924,9,0,3,5,51.066,45,47,44.796,23,0,0.0,8,28.54,29.5,0.595,24,22,1.135,6
5.152,0,1,2,4,19.376,17,18,17.811,5,1,5.9,8,11.926,18.0,0.717,13,12,1.14,0
5.496,0,0,2,4,18.98,17,18,17.622,5,1,5.9,8,12.847,18.0,0.743,13,12,1.116,0
4.602,1,0,2,3,22.452,20,21,20.182,8,0,0.0,8,13.75,18.0,0.667,13,12,1.123,0
5.045,0,1,2,4,19.376,17,18,17.811,5,1,5.9,8,11.926,18.0,0.717,13,12,1.14,0
4.959,0,0,2,4,18.98,17,18,17.622,5,1,5.9,8,12.847,18.0,0.743,13,12,1.116,0
4.602,0,0,2,4,18.757,17,18,17.367,5,1,5.9,8,14.648,18.0,0.772,13,12,1.103,0
4.602,0,0,2,4,20.246,18,19,18.625,6,0,0.0,8,12.443,18.0,0.696,13,12,1.125,0
4.602,1,0,2,3,22.452,20,21,20.182,8,0,0.0,8,13.75,18.0,0.667,13,12,1.123,0
4.602,0,0,3,4,21.535,19,20,19.4,7,0,0.0,8,12.994,18.0,0.675,13,12,1.133,0
5.125,1,3,2,6,23.471,20,21,21.72,5,3,15.0,8,13.563,21.0,0.724,16,15,1.174,0
4.602,1,0,2,3,22.452,20,21,20.182,8,0,0.0,8,13.75,18.0,0.667,13,12,1.123,0
4.727,0,1,2,4,19.376,17,18,17.811,5,1,5.9,8,11.926,18.0,0.717,13,12,1.14,0
5.248,0,0,2,4,18.98,17,18,17.622,5,1,5.9,8,12.847,18.0,0.743,13,12,1.116,0
4.602,1,3,2,6,23.471,20,21,21.72,5,3,15.0,8,13.563,21.0,0.724,16,15,1.174,0
5.879,1,0,2,3,22.452,20,21,20.182,8,0,0.0,8,13.75,18.0,0.667,13,12,1.123,0
6.119,0,0,3,4,21.535,19,20,19.4,7,0,0.0,8,12.994,18.0,0.675,13,12,1.133,0
5.857,2,0,2,3,25.867,23,24,23.065,10,0,0.0,8,15.511,19.0,0.646,14,13,1.125,0
5.706,1,1,2,4,22.791,20,21,20.694,7,1,5.0,8,13.688,19.0,0.686,14,13,1.14,0
5.275,2,0,2,3,25.867,23,24,23.065,10,0,0.0,8,15.511,19.0,0.646,14,13,1.125,0
4.879,3,0,2,3,29.282,26,27,25.949,12,0,0.0,8,17.273,20.0,0.63,15,14,1.126,0
5.577,1,0,2,4,22.396,20,21,20.505,7,1,5.0,8,14.608,19.0,0.708,14,13,1.12,0
6.398,1,0,3,4,24.95,22,23,22.284,9,0,0.0,8,14.756,19.0,0.653,14,13,1.134,0
7.921,3,0,3,6,44.614,40,43,40.589,15,0,0.0,16,27.949,38.0,0.684,28,25,1.115,3
7.886,2,3,3,8,42.424,37,39,38.8,12,3,8.1,15,25.307,36.5,0.697,27,25,1.147,3
8.051,11,0,3,5,59.607,53,56,52.312,27,0,0.0,10,35.256,35.0,0.609,29,26,1.125,5
7.721,3,0,3,7,44.558,40,43,40.913,14,1,2.5,16,28.807,39.0,0.705,29,26,1.114,3
8.022,4,1,4,8,50.868,45,48,46.087,17,1,2.2,16,30.654,41.5,0.673,31,28,1.13,3
8.301,3,1,3,7,44.954,40,43,41.102,14,1,2.5,16,27.887,39.0,0.694,29,26,1.124,3
8.167,3,1,3,7,55.784,50,54,50.869,18,1,2.0,22,35.409,49.0,0.696,36,32,1.116,4
6.924,7,0,2,3,65.604,59,63,58.018,28,0,0.0,21,40.364,47.0,0.637,35,31,1.112,6
7.26,4,0,3,5,45.82,41,44,41.145,17,0,0.0,15,28.256,36.0,0.663,27,24,1.118,4
6.921,4,0,3,5,45.82,41,44,41.145,17,0,0.0,15,28.256,36.0,0.663,27,24,1.118,3
6.268,4,0,4,6,50.734,45,47,45.131,20,0,0.0,15,30.023,36.5,0.638,27,25,1.127,5
8.009,5,1,3,7,51.784,46,49,46.869,18,1,2.2,16,31.409,41.5,0.67,31,28,1.126,3
6.699,11,0,3,5,59.896,53,56,52.563,27,0,0.0,10,34.063,35.0,0.6,29,26,1.13,5
6.562,13,0,3,4,65.517,58,61,57.003,31,0,0.0,10,37.131,36.0,0.589,30,27,1.13,5
7.796,4,0,2,3,55.358,50,54,49.367,22,0,0.0,21,35.08,44.0,0.661,32,28,1.107,3
5.215,12,0,4,5,64.6,57,60,56.221,30,0,0.0,10,36.376,36.0,0.59,30,27,1.133,5
7.796,5,0,4,6,51.734,46,49,46.131,20,0,0.0,15,31.023,38.0,0.646,29,26,1.125,3
5.301,1,0,2,4,32.076,29,32,29.393,10,0,0.0,14,20.966,31.5,0.71,22,19,1.106,0
5.0,3,0,1,4,34.913,32,36,32.251,11,0,0.0,14,24.369,34.5,0.727,25,21,1.091,0
8.097,4,0,3,5,56.651,51,55,50.912,21,0,0.0,21,35.779,46.5,0.671,34,30,1.111,3
6.699,5,0,2,3,41.112,37,41,36.716,16,0,0.0,13,25.796,33.5,0.661,25,21,1.111,0
7.398,3,0,2,4,30.076,27,30,27.393,10,0,0.0,10,18.966,27.0,0.688,20,17,1.114,0
8.046,6,0,4,6,55.149,49,52,49.014,22,0,0.0,15,32.784,39.5,0.638,30,27,1.125,3
7.149,4,0,2,3,37.697,34,38,33.833,14,0,0.0,13,24.034,32.5,0.674,24,20,1.109,0
8.046,12,0,4,7,77.849,69,72,68.643,34,0,0.0,16,44.807,48.5,0.611,38,35,1.128,7
7.824,11,0,4,7,72.019,64,68,63.876,30,0,0.0,16,42.284,48.5,0.626,38,34,1.125,4
7.796,10,0,4,7,71.019,63,66,62.876,30,0,0.0,16,41.284,46.5,0.62,36,33,1.127,6
7.824,8,0,3,7,62.9,56,59,56.334,25,0,0.0,16,37.21,44.5,0.638,34,31,1.123,6
7.337,6,0,4,6,57.564,51,53,50.898,24,0,0.0,15,33.546,38.5,0.623,29,27,1.129,6
5.0,4,0,2,3,37.697,34,38,33.833,14,0,0.0,13,24.034,32.5,0.674,24,20,1.109,0
5.0,2,0,2,5,34.286,31,35,31.72,10,0,0.0,14,22.421,34.5,0.719,25,21,1.106,0
8.046,7,1,4,7,58.904,52,55,52.411,23,1,1.9,15,34.483,41.5,0.638,32,29,1.133,3
8.097,8,0,4,8,71.524,64,68,64.069,28,0,0.0,20,44.171,53.0,0.652,40,36,1.118,7
6.625,6,0,4,6,59.149,53,58,53.014,22,0,0.0,19,36.784,48.5,0.665,36,31,1.116,3
8.222,12,0,4,6,73.225,65,69,64.432,32,0,0.0,15,42.591,46.5,0.614,37,33,1.127,4
7.187,6,0,4,6,59.149,53,58,53.014,22,0,0.0,19,36.784,48.5,0.665,36,31,1.116,3
8.046,8,0,4,7,75.019,67,71,66.876,30,0,0.0,22,45.284,54.5,0.643,41,37,1.12,6
6.793,7,0,5,7,60.647,54,59,54.116,23,0,0.0,17,36.79,48.0,0.653,36,31,1.123,4
8.301,10,1,4,7,66.734,59,63,59.178,27,1,1.7,15,39.006,45.5,0.631,36,32,1.131,5
7.081,8,0,3,6,54.86,49,54,49.24,21,0,0.0,14,33.233,42.5,0.652,33,28,1.12,1
8.097,12,0,4,7,75.434,67,71,66.76,32,0,0.0,16,44.046,49.5,0.621,39,35,1.126,4
7.638,7,0,4,6,58.564,52,55,51.898,24,0,0.0,15,34.546,40.5,0.63,31,28,1.126,3
7.444,3,0,2,4,36.491,33,37,33.276,12,0,0.0,14,23.727,34.5,0.7,25,21,1.106,0
8.301,12,1,4,7,73.565,65,69,64.945,31,1,1.5,15,42.529,47.5,0.62,38,34,1.132,4
6.783,8,0,4,6,58.564,52,56,51.898,24,0,0.0,14,34.546,41.5,0.63,32,28,1.126,4
7.854,10,0,4,6,66.394,59,63,58.665,28,0,0.0,15,39.069,44.5,0.624,35,31,1.125,5
7.569,5,0,3,4,43.611,39,43,38.818,17,0,0.0,13,26.801,34.5,0.653,26,22,1.118,1
6.097,5,0,2,3,41.112,37,41,36.716,16,0,0.0,13,25.796,33.5,0.661,25,21,1.111,0
8.301,9,1,4,7,65.734,58,61,58.178,27,1,1.7,15,38.006,43.5,0.624,34,31,1.133,5
7.398,5,0,3,6,50.445,45,48,45.356,19,0,0.0,15,30.472,38.5,0.654,29,26,1.121,3
7.097,4,0,2,5,41.116,37,41,37.487,14,0,0.0,14,25.943,36.5,0.685,27,23,1.111,1
8.097,7,0,5,9,75.312,67,71,67.421,29,0,0.0,22,44.983,55.5,0.646,42,38,1.124,5
8.046,7,0,5,10,71.84,64,68,64.862,26,1,1.6,21,44.08,55.5,0.665,42,38,1.123,5
6.79,10,0,4,7,64.189,57,62,57.109,26,0,0.0,14,37.762,45.5,0.632,36,31,1.126,4
6.174,18,0,5,11,102.052,90,94,90.145,45,0,0.0,16,56.983,60.5,0.599,49,45,1.134,13
6.928,4,1,3,5,37.535,33,35,33.447,14,1,3.0,10,21.978,27.0,0.646,21,19,1.137,2
6.951,4,1,4,6,40.034,35,37,35.549,15,1,2.9,10,22.983,28.0,0.638,22,20,1.144,2
7.959,7,1,4,7,50.073,44,47,44.643,19,1,2.3,11,28.961,35.0,0.639,28,25,1.138,3
7.658,6,1,4,7,46.658,41,44,41.76,17,1,2.4,11,27.199,34.0,0.648,27,24,1.138,3
7.252,6,1,4,8,48.868,43,46,44.087,17,1,2.3,12,28.654,37.0,0.658,29,26,1.136,3
8.222,7,1,4,8,52.283,46,49,46.971,19,1,2.2,12,30.415,38.0,0.648,30,27,1.137,3
6.567,6,1,5,9,51.366,45,48,46.189,18,1,2.2,12,29.659,38.0,0.652,30,27,1.141,3
7.77,6,1,5,9,51.366,45,48,46.189,18,1,2.2,12,29.659,38.0,0.652,30,27,1.141,3
6.873,7,1,4,8,53.698,47,49,47.854,21,1,2.1,11,30.176,35.0,0.625,28,26,1.143,6
7.569,8,1,4,8,58.113,51,53,51.738,23,1,2.0,12,32.938,38.0,0.625,30,28,1.139,7
7.796,7,1,5,9,68.027,60,63,60.723,26,1,1.7,18,39.705,48.0,0.64,37,34,1.134,8
7.796,6,1,4,8,62.113,55,58,55.738,23,1,1.8,18,36.938,46.0,0.652,35,32,1.129,7
6.914,4,1,4,7,42.243,37,39,37.876,15,1,2.7,11,24.438,31.0,0.65,24,22,1.142,3
7.347,6,1,4,7,49.073,43,45,43.643,19,1,2.3,11,27.961,33.0,0.631,26,24,1.141,4
7.47,7,1,4,7,50.073,44,47,44.643,19,1,2.3,11,28.961,35.0,0.639,28,25,1.138,4
6.955,10,1,5,8,62.817,55,58,55.396,26,1,1.8,11,35.25,39.0,0.613,32,29,1.142,6
6.538,11,1,6,9,68.731,60,63,60.381,29,1,1.7,11,38.017,41.0,0.604,34,31,1.146,6
5.357,8,1,5,8,55.987,49,52,49.629,22,1,2.0,11,31.728,37.0,0.626,30,27,1.143,3
5.62,9,1,5,8,59.402,52,55,52.512,24,1,1.9,11,33.489,38.0,0.619,31,28,1.142,3
7.658,8,1,5,8,66.817,59,63,59.396,26,1,1.7,17,39.25,47.0,0.639,37,33,1.132,4
7.495,9,1,5,8,59.402,52,55,52.512,24,1,1.9,11,33.489,38.0,0.619,31,28,1.142,3
8.379,13,1,5,8,70.648,62,66,62.163,30,1,1.6,11,39.773,43.0,0.609,36,32,1.139,4
6.721,7,1,5,9,54.781,48,51,49.072,20,1,2.1,12,31.421,39.0,0.643,31,28,1.141,3
7.658,11,1,5,9,66.027,58,62,58.723,26,1,1.7,12,37.705,44.0,0.628,36,32,1.138,4
6.745,9,1,5,9,61.611,54,57,54.84,24,1,1.9,12,34.944,41.0,0.628,33,30,1.141,3
8.222,9,4,5,12,62.631,54,57,56.378,21,4,7.4,12,34.756,44.0,0.649,36,33,1.16,3
7.959,8,1,5,9,69.027,61,65,61.723,26,1,1.6,18,40.705,50.0,0.646,39,35,1.132,4
7.301,10,1,6,10,67.525,59,62,59.825,27,1,1.7,12,37.711,43.0,0.618,35,32,1.144,3
6.824,9,1,5,11,62.741,55,58,56.243,24,1,1.8,11,36.046,43.0,0.633,34,31,1.141,4
8.846,8,1,5,8,66.817,59,63,59.396,26,1,1.7,17,39.25,47.0,0.639,37,33,1.132,4
7.409,8,1,6,9,65.9,58,62,58.614,25,1,1.7,16,38.495,47.0,0.642,37,33,1.136,4
8.046,8,1,6,9,65.9,58,62,58.614,25,1,1.7,16,38.495,47.0,0.642,37,33,1.136,4
8.854,8,1,6,9,65.9,58,62,58.614,25,1,1.7,16,38.495,47.0,0.642,37,33,1.136,4
8.481,8,1,7,10,64.983,57,61,57.832,24,1,1.8,15,37.739,47.0,0.644,37,33,1.14,4
9.199,8,1,7,10,64.983,57,61,57.832,24,1,1.8,15,37.739,47.0,0.644,37,33,1.14,4
5.0,4,0,2,3,44.528,40,43,39.6,18,0,0.0,15,27.557,34.0,0.649,25,22,1.113,1
8.041,3,1,3,6,46.16,41,44,41.658,16,1,2.4,16,28.193,38.0,0.672,28,25,1.126,2
5.893,0,0,0,4,31.914,29,31,29.727,10,0,0.0,15,20.625,29.0,0.707,21,19,1.1,1
6.745,0,0,2,3,28.867,26,28,26.065,10,0,0.0,13,18.512,25.0,0.687,18,16,1.11,0
5.051,13,0,5,9,81.557,72,76,72.072,35,0,0.0,15,46.267,50.0,0.609,41,37,1.133,8
7.444,7,1,4,8,63.113,56,60,56.738,23,1,1.8,18,37.938,48.0,0.659,37,33,1.127,3
4.95,4,1,3,7,59.2,53,57,53.752,20,1,1.9,22,37.171,50.0,0.686,37,33,1.117,4
4.064,3,1,4,8,58.283,52,56,52.971,19,1,1.9,22,36.415,50.0,0.689,37,33,1.121,4
5.0,10,1,4,8,83.189,74,79,74.156,33,1,1.4,23,49.745,59.0,0.642,46,41,1.124,7
6.31,10,1,4,8,83.189,74,79,74.156,33,1,1.4,23,49.745,59.0,0.642,46,41,1.124,7
9.509,5,1,4,8,62.698,56,61,56.854,21,1,1.8,22,39.176,53.0,0.685,40,35,1.12,3
8.745,9,1,4,8,67.528,60,65,60.621,25,1,1.7,18,40.699,51.0,0.657,40,35,1.125,3
6.678,6,1,4,8,59.698,53,57,53.854,21,1,1.9,18,36.176,47.0,0.667,36,32,1.126,3
7.481,6,1,5,10,70.821,63,68,64.167,24,1,1.6,23,43.398,58.0,0.676,44,39,1.124,5
7.347,9,1,5,10,78.651,70,76,70.934,28,1,1.4,23,47.921,62.0,0.667,48,42,1.124,4
8.721,10,1,5,10,82.066,73,79,73.818,30,1,1.4,23,49.682,63.0,0.66,49,43,1.124,4
5.857,6,1,4,7,63.904,57,62,57.411,23,1,1.8,21,39.483,51.0,0.67,39,34,1.121,3
5.461,5,1,3,7,60.2,54,59,54.752,20,1,1.9,22,38.171,52.0,0.691,39,34,1.115,3
4.064,6,1,3,7,62.615,56,61,56.636,22,1,1.8,21,38.932,51.0,0.676,39,34,1.118,3
6.252,6,2,3,7,61.745,55,60,55.821,21,2,3.6,21,38.415,51.0,0.682,39,34,1.123,3
4.116,6,1,4,7,63.904,57,62,57.411,23,1,1.8,21,39.483,51.0,0.67,39,34,1.121,3
4.076,3,1,3,7,55.784,50,54,50.869,18,1,2.0,22,35.409,49.0,0.696,36,32,1.116,4
5.318,4,1,3,7,58.2,52,56,52.752,20,1,1.9,21,36.171,48.0,0.679,36,32,1.119,4
6.244,4,1,3,7,58.2,52,56,52.752,20,1,1.9,21,36.171,48.0,0.679,36,32,1.119,4
5.056,11,0,4,6,55.564,49,53,48.898,24,0,0.0,8,31.546,34.0,0.608,29,25,1.134,2
5.028,11,0,4,6,55.564,49,53,48.898,24,0,0.0,8,31.546,34.0,0.608,29,25,1.134,2
5.029,12,0,4,6,58.979,52,56,51.781,26,0,0.0,8,33.307,35.0,0.602,30,26,1.134,2
5.0,9,3,6,11,56.749,49,53,50.872,19,3,6.1,10,31.847,41.5,0.651,34,30,1.158,2
6.523,11,0,5,9,74.727,66,70,66.305,31,0,0.0,15,42.745,48.0,0.618,39,35,1.132,6
5.059,12,0,5,9,78.142,69,73,69.189,33,0,0.0,15,44.506,49.0,0.614,40,36,1.132,7
5.048,11,1,5,9,73.857,65,69,65.49,30,1,1.5,15,42.228,48.0,0.623,39,35,1.136,6
5.07,11,0,6,9,72.6,64,68,64.196,30,0,0.0,14,41.534,47.0,0.619,38,34,1.134,6
5.959,10,1,4,8,72.359,64,68,64.389,29,1,1.6,17,42.222,49.0,0.632,39,35,1.131,6
6.678,10,1,4,8,72.359,64,68,64.389,29,1,1.6,17,42.222,49.0,0.632,39,35,1.131,5
7.721,10,1,4,8,72.359,64,68,64.389,29,1,1.6,17,42.222,49.0,0.632,39,35,1.131,5
6.084,5,0,5,6,37.777,33,35,33.254,15,0,0.0,7,21.29,26.0,0.62,20,18,1.145,2
6.197,5,0,5,6,37.777,33,35,33.254,15,0,0.0,7,21.29,26.0,0.62,20,18,1.145,2
6.277,8,0,5,6,48.023,42,44,41.905,21,0,0.0,7,26.574,29.0,0.596,23,21,1.143,4
5.838,6,0,5,6,41.192,36,38,36.138,17,0,0.0,7,23.051,27.0,0.611,21,19,1.144,2
6.186,8,0,5,6,48.023,42,44,41.905,21,0,0.0,7,26.574,29.0,0.596,23,21,1.143,3
6.028,8,0,5,6,48.023,42,44,41.905,21,0,0.0,7,26.574,29.0,0.596,23,21,1.143,4
7.222,8,0,3,8,63.405,57,62,57.527,23,0,0.0,18,40.097,52.0,0.673,39,34,1.112,5
7.699,6,0,5,9,60.361,54,59,54.636,21,0,0.0,18,38.131,51.0,0.679,38,33,1.118,4
7.301,4,0,4,7,48.823,44,49,44.44,16,0,0.0,17,32.148,45.0,0.701,33,28,1.11,1
7.268,4,0,4,7,48.823,44,49,44.44,16,0,0.0,17,32.148,45.0,0.701,33,28,1.11,2
7.18,3,0,4,8,49.617,45,51,45.884,14,0,0.0,20,33.841,51.5,0.734,37,31,1.103,2
7.77,10,0,4,12,72.946,65,71,66.494,26,0,0.0,17,44.227,57.0,0.663,45,39,1.122,5
7.268,4,0,4,8,51.033,46,51,46.767,16,0,0.0,18,33.602,48.0,0.708,35,30,1.109,2
7.886,4,0,2,6,41.958,38,42,38.716,13,1,2.6,15,28.296,39.5,0.72,29,25,1.104,1
7.495,7,0,4,8,61.278,55,60,55.418,22,0,0.0,18,38.887,51.0,0.676,38,33,1.114,4
6.309,10,0,3,4,61.687,55,59,54.236,27,0,0.0,14,36.608,40.0,0.62,32,28,1.122,3
7.398,4,0,3,6,46.325,42,47,42.338,15,0,0.0,17,31.142,44.0,0.711,32,27,1.103,1
7.076,4,0,3,7,46.167,42,47,42.567,14,1,2.4,17,32.495,45.0,0.735,33,28,1.099,1
7.337,15,0,4,11,93.228,83,88,83.469,38,0,0.0,19,55.341,64.0,0.633,50,45,1.123,11
7.699,5,0,4,8,54.448,49,54,49.651,18,0,0.0,18,35.364,49.0,0.696,36,31,1.111,3
7.252,8,0,4,8,64.693,58,63,58.302,24,0,0.0,18,40.648,52.0,0.667,39,34,1.115,5
7.31,7,0,4,8,58.863,53,59,53.534,20,0,0.0,18,38.125,52.0,0.691,39,33,1.111,4
7.658,7,0,4,9,62.488,56,61,56.745,22,0,0.0,18,39.341,52.0,0.676,39,34,1.116,6
7.252,6,0,4,8,57.863,52,57,52.534,20,0,0.0,18,37.125,50.0,0.685,37,32,1.113,4
7.284,9,0,4,8,65.693,59,65,59.302,24,0,0.0,18,41.648,54.0,0.673,41,35,1.113,4
7.745,4,0,3,5,42.405,38,42,38.262,15,0,0.0,14,26.495,36.5,0.675,27,23,1.116,1
7.42,5,0,3,9,53.079,48,53,48.953,17,0,0.0,17,35.46,50.0,0.708,36,31,1.106,3
7.678,8,0,3,9,63.325,57,62,57.603,23,0,0.0,17,40.744,53.0,0.677,39,34,1.111,4
8.06,8,0,3,5,59.216,53,57,52.676,24,1,1.9,16,36.705,42.0,0.649,33,29,1.117,3
7.456,8,1,3,6,59.555,53,57,53.189,23,2,3.8,16,36.642,43.0,0.656,34,30,1.124,3
7.745,6,1,3,5,57.196,51,55,50.981,22,1,2.0,18,35.023,43.0,0.655,33,29,1.121,3
7.824,6,0,3,5,56.8,51,55,50.792,22,1,2.0,18,35.944,43.0,0.664,33,29,1.114,3
6.544,6,0,3,5,56.8,51,55,50.792,22,1,2.0,18,35.944,43.0,0.664,33,29,1.114,3
7.444,6,1,3,6,57.14,51,55,51.305,21,2,3.9,18,35.881,44.0,0.672,34,30,1.12,3
6.883,8,0,4,5,61.77,55,59,54.454,26,0,0.0,16,36.853,42.0,0.629,33,29,1.123,3
7.337,8,0,3,4,57.272,51,54,50.352,25,0,0.0,14,33.847,37.0,0.619,29,26,1.123,5
7.796,6,0,3,4,56.856,51,55,50.469,23,0,0.0,18,35.086,42.0,0.648,32,28,1.115,3
5.076,9,0,3,4,62.687,56,60,55.236,27,0,0.0,16,37.608,42.0,0.627,33,29,1.119,3
6.796,7,0,3,4,60.272,54,58,53.352,25,0,0.0,18,36.847,43.0,0.64,33,29,1.116,3
5.796,9,0,3,4,62.687,56,60,55.236,27,0,0.0,16,37.608,42.0,0.627,33,29,1.119,3
7.796,7,0,3,5,58.216,52,55,51.676,24,1,1.9,16,35.705,40.0,0.642,31,28,1.12,5
6.987,8,0,3,5,57.216,51,54,50.676,24,1,2.0,14,34.705,38.0,0.635,30,27,1.122,5
7.328,8,1,3,6,57.555,51,54,51.189,23,2,3.9,14,34.642,39.0,0.643,31,28,1.129,5
6.59,8,1,3,6,59.555,53,57,53.189,23,2,3.8,16,36.642,43.0,0.656,34,30,1.124,3
7.523,9,1,3,5,63.026,56,60,55.749,26,1,1.8,16,37.546,43.0,0.634,34,30,1.125,3
7.337,9,0,3,5,62.631,56,60,55.56,26,1,1.8,16,38.466,43.0,0.642,34,30,1.118,3
7.921,8,0,4,6,61.714,55,59,54.778,25,1,1.8,16,37.711,43.0,0.644,34,30,1.122,3
7.796,6,1,3,5,55.196,49,52,48.981,22,1,2.0,16,33.023,39.0,0.641,30,27,1.126,5
7.638,6,0,3,5,54.8,49,52,48.792,22,1,2.0,16,33.944,39.0,0.651,30,27,1.118,5
7.585,6,0,3,5,54.8,49,52,48.792,22,1,2.0,16,33.944,39.0,0.651,30,27,1.118,5
7.886,6,1,3,6,55.14,49,52,49.305,21,2,4.1,16,33.881,40.0,0.658,31,28,1.125,5
5.021,0,0,0,4,31.914,29,31,29.727,10,0,0.0,15,20.625,29.0,0.707,21,19,1.1,1
5.131,0,0,2,3,19.036,17,18,17.298,6,0,0.0,8,11.989,17.0,0.695,12,11,1.12,0
4.679,0,0,1,2,17.953,16,16,16.08,7,0,0.0,7,10.744,13.0,0.645,9,9,1.122,1
5.857,0,0,0,2,29.495,27,29,27.073,10,0,0.0,15,19.716,27.0,0.706,19,17,1.092,1
4.0,0,0,0,5,33.123,30,32,31.055,10,0,0.0,15,21.08,30.0,0.707,22,20,1.104,1
7.523,4,0,3,5,48.443,43,45,42.971,20,0,0.0,14,28.398,34.0,0.627,25,23,1.127,3
6.824,2,1,2,5,49.077,44,47,44.44,17,1,2.3,20,30.949,42.0,0.683,30,27,1.115,4
6.851,3,0,3,4,29.365,26,28,26.167,11,0,0.0,8,17.517,23.0,0.649,17,15,1.129,0
6.735,1,0,1,4,33.203,30,32,30.502,11,0,0.0,14,21.176,30.0,0.693,21,19,1.107,2
7.456,6,0,3,6,52.86,47,50,47.24,21,0,0.0,14,31.233,38.0,0.637,29,26,1.125,4
7.036,1,1,1,3,30.123,27,29,27.36,10,1,3.7,13,19.205,27.0,0.695,19,17,1.116,0
6.71,5,0,3,5,51.858,46,48,45.854,22,0,0.0,14,30.159,35.0,0.62,26,24,1.127,3
4.854,2,0,2,6,60.697,55,59,55.098,22,0,0.0,25,39.637,53.0,0.684,37,33,1.104,6
7.678,0,1,1,5,30.127,27,29,28.131,8,1,3.7,14,19.352,30.0,0.728,21,19,1.116,1
6.506,0,0,2,3,28.867,26,28,26.065,10,0,0.0,13,18.512,26.0,0.687,18,16,1.11,0
6.62,0,0,1,4,26.257,24,26,24.611,7,2,8.3,13,19.222,27.0,0.771,19,17,1.094,0
5.123,0,0,0,5,33.123,30,32,31.055,10,0,0.0,15,21.08,30.0,0.707,22,20,1.104,1
8.31,2,0,3,4,43.196,39,43,38.934,15,0,0.0,18,28.04,39.5,0.691,28,24,1.108,1
7.951,3,3,3,7,41.215,36,39,37.472,12,3,8.3,14,24.853,36.0,0.697,27,24,1.145,1
8.114,2,0,3,5,36.724,33,36,33.374,12,1,3.0,14,24.137,33.0,0.704,24,21,1.113,1
6.62,10,0,3,5,56.481,50,53,49.68,25,0,0.0,10,32.302,34.5,0.606,28,25,1.13,3
7.051,6,0,3,7,48.654,43,45,43.683,19,0,0.0,11,27.926,33.5,0.631,26,24,1.131,4
7.509,7,0,3,5,46.235,41,44,41.029,19,0,0.0,10,27.017,31.5,0.627,25,22,1.128,1
6.772,0,0,2,3,25.452,23,25,23.182,8,0,0.0,12,16.75,25.0,0.71,17,15,1.107,0
8.229,5,0,4,5,49.524,44,47,43.803,20,0,0.0,14,29.569,36.0,0.637,27,24,1.126,4
6.34,11,0,3,5,59.896,53,56,52.563,27,0,0.0,10,34.063,35.5,0.6,29,26,1.13,4
6.936,13,0,4,6,66.81,59,63,58.549,30,0,0.0,10,37.83,39.5,0.599,33,29,1.132,3
8.009,6,0,5,6,55.438,49,52,48.789,23,0,0.0,14,32.336,38.0,0.624,29,26,1.131,4
6.425,10,0,3,7,57.61,51,54,51.083,25,0,0.0,9,33.404,36.5,0.612,29,26,1.13,4
6.936,0,0,2,3,25.452,23,25,23.182,8,0,0.0,12,16.75,24.0,0.71,17,15,1.107,0
7.222,10,0,7,12,64.983,57,60,58.051,25,0,0.0,10,37.358,43.0,0.63,35,32,1.14,6
6.699,7,0,3,9,66.029,59,62,59.738,25,0,0.0,18,40.313,48.0,0.655,37,34,1.119,8
7.412,6,0,4,9,60.488,54,57,54.745,22,0,0.0,17,37.341,46.0,0.664,35,32,1.12,7
7.49,6,0,3,9,50.416,45,47,45.989,18,1,2.2,12,31.926,37.0,0.674,29,27,1.12,6
6.699,11,0,5,9,69.312,61,64,61.421,29,0,0.0,12,38.983,43.0,0.611,35,32,1.136,6
5.456,6,0,3,9,50.416,45,47,45.989,18,1,2.2,12,31.926,37.0,0.674,29,27,1.12,6
6.111,9,0,4,7,59.773,53,57,53.225,24,0,0.0,13,35.0,42.0,0.632,33,29,1.128,3
7.097,6,0,3,8,56.989,51,54,51.643,21,0,0.0,16,35.335,43.5,0.664,33,30,1.117,6
6.046,12,0,7,11,70.893,62,65,62.741,29,0,0.0,10,39.233,44.0,0.61,36,33,1.143,6
5.301,10,0,7,11,72.893,64,67,64.741,29,0,0.0,14,41.233,48.0,0.622,38,35,1.139,6
7.262,10,0,5,10,66.816,59,62,59.614,27,0,0.0,12,38.87,43.0,0.626,35,32,1.132,6
8.237,2,0,4,5,41.694,37,39,37.036,16,0,0.0,14,25.046,32.0,0.648,23,21,1.127,3
6.721,1,3,3,7,36.799,32,34,33.589,10,3,9.4,14,22.091,33.0,0.705,24,22,1.15,2
8.921,1,3,3,7,36.799,32,34,33.589,10,3,9.4,14,22.091,33.0,0.705,24,22,1.15,2
6.538,0,0,3,6,35.784,32,34,32.822,11,0,0.0,15,22.426,33.0,0.697,23,21,1.118,3
8.027,0,0,3,5,32.309,29,31,29.491,10,1,3.4,14,21.375,30.0,0.714,21,19,1.114,2
8.097,1,3,3,7,36.799,32,34,33.589,10,3,9.4,14,22.091,33.0,0.705,24,22,1.15,2
8.398,0,0,4,5,33.448,30,32,30.385,10,0,0.0,14,21.762,33.0,0.713,22,20,1.115,2
8.201,0,0,3,5,33.575,30,32,30.494,11,0,0.0,14,20.972,30.0,0.687,21,19,1.119,2
4.0,0,0,2,5,32.286,29,31,29.72,10,0,0.0,14,20.421,30.0,0.7,21,19,1.113,2
8.167,1,0,3,5,36.99,33,35,33.378,13,0,0.0,14,22.733,31.0,0.671,22,20,1.121,3
8.229,1,0,3,6,35.784,32,35,32.822,11,0,0.0,14,22.426,33.0,0.697,24,21,1.118,2
6.409,0,0,1,3,21.163,19,20,19.407,7,0,0.0,9,13.199,18.5,0.686,13,12,1.114,0
6.745,0,0,2,4,26.661,24,26,24.509,8,0,0.0,12,17.205,25.5,0.711,18,16,1.111,0
8.699,1,0,3,6,38.199,34,36,34.705,13,0,0.0,14,23.188,32.0,0.672,23,21,1.124,3
6.276,2,0,3,7,54.654,49,52,49.683,19,0,0.0,21,33.926,46.0,0.676,33,30,1.115,6
8.097,0,0,4,7,34.867,31,33,32.04,10,0,0.0,14,21.671,34.0,0.704,23,21,1.125,3
5.854,0,0,1,3,24.163,22,24,22.407,7,0,0.0,12,16.199,24.5,0.729,17,15,1.098,0
5.155,0,0,1,2,19.953,18,19,18.08,7,0,0.0,9,12.744,17.5,0.684,12,11,1.109,0
7.071,10,0,3,6,70.866,63,65,61.992,33,0,0.0,14,42.404,41.0,0.608,32,30,1.125,8
7.638,2,0,2,4,38.907,35,38,35.16,14,0,0.0,15,24.489,33.0,0.675,24,21,1.112,1
6.432,2,0,2,4,28.076,25,27,25.393,10,0,0.0,9,16.966,23.0,0.663,17,15,1.123,0
8.155,2,0,3,4,40.196,36,39,35.934,15,0,0.0,15,25.04,33.0,0.665,24,21,1.117,1
7.42,2,0,2,3,26.867,24,26,24.065,10,0,0.0,9,16.512,22.0,0.661,16,14,1.119,0
8.155,2,0,3,4,36.78,33,36,33.051,13,0,0.0,14,23.279,32.0,0.679,23,20,1.115,1
8.0,2,0,3,5,42.405,38,41,38.262,15,0,0.0,16,26.495,36.0,0.675,26,23,1.116,2
7.638,3,0,2,3,51.943,47,51,46.483,20,0,0.0,21,33.319,43.0,0.67,31,27,1.105,3
8.097,2,0,3,4,35.78,32,35,32.051,13,0,0.0,13,22.279,30.5,0.669,22,19,1.118,1
8.301,4,0,3,4,47.026,42,45,41.702,19,0,0.0,15,28.563,35.0,0.643,26,23,1.12,3
8.301,3,3,2,6,42.132,37,40,38.254,13,3,8.1,15,25.608,36.0,0.692,27,24,1.139,1
7.328,1,0,2,3,23.452,21,23,21.182,8,0,0.0,9,14.75,21.0,0.683,15,13,1.117,0
8.046,2,0,3,4,42.196,38,42,37.934,15,0,0.0,17,27.04,38.0,0.683,27,23,1.11,1
5.0,3,1,2,3,39.243,35,38,34.902,15,1,2.9,14,24.279,31.0,0.66,23,20,1.121,1
6.638,4,6,2,9,46.566,40,43,42.676,12,6,15.0,15,27.182,40.0,0.707,31,28,1.164,1
7.585,7,0,3,5,59.481,53,56,52.68,25,0,0.0,16,35.302,40.5,0.628,31,28,1.122,6
7.602,7,3,3,7,59.291,52,55,52.89,22,3,5.8,16,34.66,42.5,0.649,33,30,1.14,5
6.604,2,1,4,6,46.034,41,45,41.549,15,1,2.4,18,28.983,41.5,0.691,30,26,1.123,2
7.222,7,1,3,6,59.821,53,56,53.192,24,1,1.9,16,35.239,41.0,0.635,32,29,1.129,6
7.244,2,1,5,7,46.532,41,44,41.651,16,1,2.4,16,27.989,38.0,0.667,28,25,1.135,3
8.42,4,0,3,4,47.026,42,45,41.702,19,0,0.0,15,28.563,35.0,0.643,26,23,1.12,3
8.194,5,0,3,4,50.441,45,48,44.585,21,0,0.0,15,30.324,36.0,0.634,27,24,1.121,3
5.523,1,0,1,2,31.784,29,32,28.847,11,0,0.0,15,21.267,29.5,0.702,21,18,1.096,0
7.959,2,1,2,4,38.037,34,37,34.345,13,1,2.9,15,23.972,33.0,0.685,24,21,1.119,1
8.161,4,0,3,4,47.026,42,45,41.702,19,0,0.0,15,28.563,35.0,0.643,26,23,1.12,3
6.66,2,1,3,6,42.455,38,41,38.523,14,1,2.6,16,27.625,37.0,0.698,27,24,1.117,2
8.041,3,1,3,6,46.16,41,44,41.658,16,1,2.4,16,28.193,38.0,0.672,28,25,1.126,2
6.514,3,1,2,5,43.662,39,42,39.556,15,1,2.6,16,27.188,37.0,0.681,27,24,1.12,2
6.16,4,0,2,4,34.907,31,33,31.16,14,0,0.0,9,20.489,25.0,0.633,19,17,1.126,1
7.469,6,0,3,4,65.687,59,63,58.236,27,0,0.0,22,40.608,48.5,0.646,36,32,1.113,6
6.092,3,0,3,5,34.99,31,33,31.378,13,0,0.0,10,20.733,27.0,0.649,20,18,1.129,2
5.925,1,0,2,4,22.396,20,21,20.505,7,1,5.0,8,14.608,19.5,0.708,14,13,1.12,0
6.523,1,0,2,3,34.282,31,34,30.949,12,0,0.0,15,22.273,30.5,0.69,22,19,1.106,0
5.523,7,0,4,6,59.564,53,57,52.898,24,0,0.0,16,35.546,42.5,0.637,33,29,1.124,3
7.886,1,0,3,6,42.199,38,41,38.705,13,0,0.0,18,27.188,39.5,0.706,28,25,1.111,3
8.222,2,1,3,6,42.745,38,41,38.774,14,1,2.6,16,26.432,37.0,0.685,27,24,1.125,2
6.917,3,0,3,5,34.99,31,33,31.378,13,0,0.0,10,20.733,27.0,0.649,20,18,1.129,2
7.921,6,0,3,5,56.066,50,53,49.796,23,0,0.0,16,33.54,39.5,0.635,30,27,1.121,5
6.464,4,0,4,8,55.863,50,54,50.534,20,0,0.0,18,35.125,47.0,0.673,34,30,1.117,6
6.971,4,0,3,5,49.235,44,47,44.029,19,0,0.0,16,30.017,37.5,0.652,28,25,1.119,3
7.131,6,0,4,5,54.939,49,53,48.687,22,0,0.0,16,33.33,41.5,0.644,31,27,1.121,4
8.081,7,0,3,5,59.481,53,56,52.68,25,0,0.0,16,35.302,40.5,0.628,31,28,1.122,6
8.023,8,1,3,9,63.159,56,60,56.923,24,1,1.8,15,37.796,46.5,0.648,36,32,1.128,6
7.796,6,1,3,5,55.196,49,52,48.981,22,1,2.0,16,33.023,39.5,0.641,30,27,1.126,5
5.523,4,0,2,6,58.697,53,57,53.098,22,0,0.0,21,37.637,48.5,0.672,35,31,1.107,6
7.959,2,0,2,4,37.641,34,37,34.156,13,1,2.9,15,24.892,33.0,0.698,24,21,1.107,1
6.979,2,0,2,3,26.867,24,26,24.065,10,0,0.0,9,16.512,22.0,0.661,16,14,1.119,0
6.475,1,1,1,3,32.123,29,32,29.36,10,1,3.4,15,21.205,30.5,0.716,22,19,1.108,0
5.066,11,0,4,5,61.185,54,57,53.338,28,0,0.0,10,34.614,35.0,0.595,29,26,1.133,5
6.604,11,0,3,4,58.687,52,55,51.236,27,0,0.0,10,33.608,34.0,0.598,28,25,1.129,5
8.387,4,1,3,7,48.369,43,46,43.985,16,1,2.3,16,29.648,40.0,0.681,30,27,1.125,3
6.301,1,0,2,5,34.286,31,34,31.72,10,0,0.0,15,22.421,34.5,0.719,24,21,1.106,1
6.745,1,0,3,6,48.614,44,48,44.589,15,0,0.0,22,31.949,46.5,0.713,33,29,1.105,3
8.42,4,1,3,7,48.369,43,46,43.985,16,1,2.3,16,29.648,40.0,0.681,30,27,1.125,3
5.0,0,0,2,4,28.661,26,29,26.509,8,0,0.0,14,19.205,30.5,0.733,21,18,1.102,0
7.481,4,0,3,7,49.239,44,47,44.8,17,0,0.0,16,30.165,40.0,0.673,30,27,1.119,4
7.444,2,0,2,5,40.116,36,38,36.487,14,0,0.0,15,24.943,33.0,0.676,24,22,1.114,4
7.126,6,1,4,7,67.319,60,65,60.294,25,1,1.7,22,41.245,52.5,0.662,40,35,1.122,4
7.699,3,0,3,5,44.82,40,42,40.145,17,0,0.0,15,27.256,34.0,0.655,25,23,1.121,4
6.959,2,0,2,5,41.116,37,40,37.487,14,0,0.0,16,25.943,35.5,0.685,26,23,1.111,2
7.049,4,0,3,5,49.235,44,47,44.029,19,0,0.0,16,30.017,37.5,0.652,28,25,1.119,3
6.959,3,0,3,5,43.82,39,41,39.145,17,0,0.0,14,26.256,32.0,0.646,24,22,1.124,3
7.252,1,0,3,7,52.66,48,52,48.298,17,0,0.0,23,36.551,49.0,0.72,35,31,1.097,5
6.18,1,0,1,6,36.332,33,36,33.905,11,0,0.0,15,24.278,35.5,0.718,25,22,1.101,1
8.222,6,0,4,9,80.148,72,77,72.28,30,0,0.0,27,50.387,64.5,0.666,47,42,1.113,6
7.796,11,0,4,9,85.268,76,81,76.298,34,0,0.0,22,50.716,60.5,0.639,47,42,1.122,6
6.125,0,0,2,4,22.246,20,22,20.625,6,0,0.0,10,14.443,23.0,0.726,16,14,1.112,0
6.022,8,0,3,5,47.651,42,44,41.912,21,0,0.0,8,26.779,28.5,0.601,23,21,1.135,5
7.097,10,0,5,7,67.893,60,64,59.767,29,0,0.0,14,39.074,44.5,0.614,35,31,1.132,7
8.0,9,0,4,6,65.394,58,61,57.665,28,0,0.0,15,38.069,42.5,0.618,33,30,1.127,5
6.921,4,0,2,4,37.641,34,38,34.156,13,1,2.9,13,24.892,33.5,0.698,25,21,1.107,0
8.312,6,1,4,7,55.489,49,52,49.527,21,1,2.0,15,32.722,40.0,0.646,31,28,1.132,3
6.155,2,0,2,4,35.491,32,35,32.276,12,0,0.0,14,22.727,32.5,0.691,23,20,1.109,0
5.699,1,0,2,4,32.076,29,32,29.393,10,0,0.0,14,20.966,31.5,0.71,22,19,1.106,0
5.523,4,0,2,4,39.907,36,40,36.16,14,0,0.0,14,25.489,35.5,0.684,26,22,1.109,0
7.301,3,0,3,5,44.82,40,42,40.145,17,0,0.0,15,27.256,34.0,0.655,25,23,1.121,4
5.654,3,0,1,3,25.578,23,25,23.291,9,0,0.0,8,15.96,21.0,0.676,16,14,1.112,0
5.0,4,0,2,4,39.907,36,40,36.16,14,0,0.0,14,25.489,35.5,0.684,26,22,1.109,0
7.824,11,0,4,7,72.019,64,68,63.876,30,0,0.0,16,42.284,48.5,0.626,38,34,1.125,5
5.0,3,0,1,4,35.203,32,36,32.502,11,0,0.0,14,23.176,34.5,0.712,25,21,1.1,0
6.979,6,0,6,8,56.315,50,55,50.451,20,0,0.0,16,34.273,47.0,0.665,35,30,1.126,4
7.921,8,0,5,11,72.026,64,68,64.942,27,0,0.0,18,43.324,55.0,0.651,41,37,1.125,5
7.046,2,0,3,5,41.405,37,39,37.262,15,0,0.0,15,25.495,33.0,0.666,24,22,1.119,3
7.824,8,0,4,6,61.979,55,58,54.781,26,0,0.0,15,36.307,41.5,0.624,32,29,1.127,4
7.229,5,0,2,5,44.531,40,44,40.371,16,0,0.0,14,27.705,37.5,0.672,28,24,1.113,2
5.0,6,0,2,3,44.528,40,44,39.6,18,0,0.0,13,27.557,34.5,0.649,26,22,1.113,0
8.097,7,3,4,12,73.752,65,69,66.934,25,3,4.6,21,44.438,58.5,0.671,44,40,1.135,5
8.0,3,0,5,8,64.857,58,62,58.443,23,0,0.0,24,40.245,54.0,0.672,39,35,1.118,6
8.097,9,0,4,8,79.644,71,75,71.087,32,0,0.0,22,47.5,56.5,0.638,43,39,1.122,7
7.745,4,0,3,4,38.78,35,39,35.051,13,0,0.0,13,25.279,36.5,0.698,26,22,1.108,0
7.569,2,0,4,7,58.654,53,57,53.207,20,0,0.0,24,38.671,52.0,0.697,37,33,1.107,5
7.523,4,0,2,4,37.539,34,38,34.062,13,1,2.9,13,25.387,33.5,0.704,25,21,1.104,0
5.0,5,0,2,4,45.737,41,44,40.927,18,0,0.0,14,28.012,35.5,0.651,26,23,1.116,3
7.699,5,0,4,9,66.488,60,66,60.745,22,0,0.0,24,43.341,60.0,0.698,44,38,1.108,6
7.745,5,0,4,10,55.577,50,55,51.054,18,0,0.0,17,36.466,51.0,0.7,37,32,1.112,4
5.585,1,0,2,3,22.452,20,21,20.182,8,0,0.0,8,13.75,18.0,0.667,13,12,1.123,0
7.252,8,0,4,8,64.693,58,63,58.302,24,0,0.0,18,40.648,52.0,0.667,39,34,1.115,6
7.77,4,0,2,5,42.116,38,42,38.487,14,0,0.0,15,26.943,38.5,0.693,28,24,1.108,1
7.538,8,0,3,8,63.405,57,62,57.527,23,0,0.0,18,40.097,52.0,0.673,39,34,1.112,5
7.377,7,0,4,8,61.278,55,60,55.418,22,0,0.0,18,38.887,51.0,0.676,38,33,1.114,5
7.602,3,0,4,7,45.408,41,46,41.556,14,0,0.0,17,30.387,44.0,0.716,32,27,1.108,1
7.721,3,0,6,9,51.405,46,51,46.76,16,0,0.0,18,33.398,48.0,0.704,35,30,1.117,3
6.523,7,0,4,5,58.355,52,56,51.571,24,0,0.0,16,35.091,41.0,0.636,32,28,1.122,3
7.602,7,1,3,5,60.611,54,58,53.865,24,1,1.9,18,36.785,44.0,0.647,34,30,1.122,3
7.737,6,0,3,4,54.856,49,52,48.469,23,0,0.0,16,33.086,38.0,0.634,29,26,1.12,5
5.745,9,0,3,4,62.687,56,60,55.236,27,0,0.0,16,37.608,42.0,0.627,33,29,1.119,3
7.602,7,0,4,6,58.299,52,56,51.894,23,1,1.9,16,35.949,42.0,0.652,33,29,1.121,3
7.602,7,1,4,7,58.638,52,56,52.407,22,2,3.8,16,35.887,43.0,0.659,34,30,1.128,3
6.298,6,0,4,5,54.939,49,53,48.687,22,0,0.0,16,33.33,40.0,0.644,31,27,1.121,3
7.796,7,1,3,5,58.611,52,55,51.865,24,1,1.9,16,34.785,40.0,0.634,31,28,1.127,5
6.155,10,0,7,12,68.398,60,63,60.934,27,0,0.0,11,39.12,44.0,0.624,36,33,1.14,6
7.444,7,0,3,7,56.195,50,53,50.2,23,0,0.0,13,33.642,40.0,0.633,30,27,1.124,5
8.201,5,0,4,5,49.524,44,47,43.803,20,0,0.0,14,29.569,36.0,0.637,27,24,1.126,3
6.951,7,0,4,5,51.939,46,49,45.687,22,0,0.0,12,30.33,35.0,0.62,27,24,1.129,2
5.523,10,0,7,11,64.063,56,59,56.974,25,0,0.0,10,35.711,42.0,0.621,34,31,1.144,6
7.199,11,3,6,14,70.334,61,64,63.254,25,3,4.9,11,39.688,47.0,0.641,39,36,1.153,6
4.658,0,0,1,3,17.897,16,16,16.404,6,1,6.3,7,11.602,14.0,0.697,10,10,1.119,1
5.041,0,0,1,3,19.163,17,17,17.407,7,0,0.0,7,11.199,14.0,0.649,10,10,1.127,1
8.143,6,0,4,5,52.939,47,50,46.687,22,0,0.0,14,31.33,37.0,0.629,28,25,1.126,4
6.614,14,0,4,6,70.225,62,66,61.432,32,0,0.0,10,39.591,40.5,0.595,34,30,1.133,4
5.0,0,0,2,4,35.076,32,36,32.393,10,0,0.0,18,23.966,38.0,0.737,26,22,1.096,0
6.046,7,0,3,8,52.911,47,49,47.796,20,1,2.1,12,32.04,37.0,0.653,29,27,1.126,6
5.092,0,0,2,4,20.246,18,19,18.625,6,0,0.0,8,12.443,18.0,0.696,13,12,1.125,0
6.9,1,0,3,5,36.99,33,35,33.378,13,0,0.0,14,22.733,31.0,0.671,22,20,1.121,3
8.097,2,0,2,4,37.641,34,37,34.156,13,1,2.9,15,24.892,33.0,0.698,24,21,1.107,1
7.167,2,0,3,4,36.78,33,36,33.051,13,0,0.0,14,23.279,32.0,0.679,23,20,1.115,1
7.194,7,0,3,4,58.272,52,55,51.352,25,0,0.0,16,34.847,39.0,0.626,30,27,1.121,6
7.046,4,0,3,5,48.235,43,45,43.029,19,0,0.0,15,29.017,35.0,0.644,26,24,1.122,5
7.903,3,0,3,4,50.026,45,49,44.702,19,0,0.0,19,31.563,41.5,0.667,30,26,1.112,3
8.155,8,1,4,7,62.319,55,58,55.294,25,1,1.8,15,36.245,42.5,0.631,33,30,1.133,4
6.097,8,0,3,8,62.82,56,60,56.411,25,0,0.0,15,37.858,45.5,0.641,35,31,1.122,6
8.086,3,0,2,4,42.322,38,41,38.043,16,0,0.0,15,26.25,34.0,0.662,25,22,1.114,2
7.228,10,0,6,11,65.899,58,61,58.832,26,0,0.0,11,38.114,43.0,0.628,35,32,1.136,6
8.056,3,0,3,5,41.405,37,40,37.262,15,0,0.0,14,25.495,34.0,0.666,25,22,1.119,2
7.921,5,0,4,6,50.734,45,48,45.131,20,0,0.0,14,30.023,37.0,0.638,28,25,1.127,4
6.097,7,0,3,7,59.485,53,56,53.451,23,0,0.0,16,35.449,43.5,0.645,33,30,1.122,6
6.824,9,0,7,12,61.567,54,57,55.167,23,0,0.0,10,35.597,42.0,0.637,34,31,1.14,5
7.35,7,0,3,9,55.199,49,51,49.971,21,0,0.0,12,32.79,38.0,0.644,30,28,1.127,7
8.301,2,1,2,4,38.037,34,37,34.345,13,1,2.9,15,23.972,33.0,0.685,24,21,1.119,1
6.35,1,1,3,8,43.459,39,43,40.294,12,1,2.6,18,28.773,44.0,0.729,31,27,1.114,2
7.347,10,0,9,15,75.478,66,71,67.832,27,0,0.0,14,42.631,55.0,0.64,44,39,1.144,5
8.301,4,1,3,7,45.954,41,45,42.102,14,1,2.4,16,28.887,41.5,0.701,31,27,1.121,3
8.222,3,3,2,6,42.132,37,40,38.254,13,3,8.1,15,25.608,36.0,0.692,27,24,1.139,1
7.06,0,0,4,5,35.863,32,34,32.269,12,0,0.0,15,22.523,31.5,0.685,22,20,1.121,2
7.509,5,0,4,6,50.734,45,48,45.131,20,0,0.0,14,30.023,37.0,0.638,28,25,1.127,4
6.678,7,0,3,5,44.235,39,41,39.029,19,0,0.0,8,25.017,28.0,0.608,22,20,1.134,3
7.699,3,1,2,4,30.622,27,29,27.462,11,1,3.7,9,18.21,23.5,0.658,18,16,1.134,0
7.215,6,0,4,5,44.524,39,40,38.803,20,0,0.0,8,24.569,26.0,0.59,20,19,1.142,5
6.06,5,0,5,7,45.817,40,41,40.349,19,0,0.0,9,25.267,29.0,0.606,22,21,1.145,4
7.721,9,0,4,5,52.355,46,48,45.571,24,0,0.0,8,29.091,30.0,0.588,24,22,1.138,4
7.276,8,0,4,5,48.939,43,45,42.687,22,0,0.0,8,27.33,29.0,0.594,23,21,1.138,4
7.531,6,0,4,5,42.109,37,39,36.92,18,0,0.0,8,23.807,27.0,0.608,21,19,1.138,2
6.014,0,0,2,3,22.452,20,21,20.182,8,0,0.0,9,13.75,18.0,0.667,13,12,1.123,0
7.033,4,0,3,5,29.285,26,28,26.244,11,0,0.0,6,18.165,21.5,0.657,17,15,1.126,0
4.222,0,0,1,4,29.787,27,29,27.618,9,0,0.0,14,19.415,29.0,0.714,20,18,1.103,1
5.0,4,0,3,5,29.285,26,28,26.244,11,0,0.0,6,18.165,22.0,0.657,17,15,1.126,0
4.907,8,0,2,6,41.866,37,38,37.331,18,0,0.0,5,24.114,24.5,0.611,20,19,1.132,6
7.602,3,0,4,5,31.863,28,30,28.269,12,0,0.0,8,18.523,24.0,0.64,18,16,1.138,2
6.523,8,0,3,8,57.694,51,53,51.778,23,0,0.0,12,32.904,38.0,0.626,30,28,1.131,7
4.824,0,0,2,3,34.282,31,33,30.949,12,0,0.0,16,22.273,30.5,0.69,21,19,1.106,2
8.222,7,0,4,5,45.524,40,42,39.803,20,0,0.0,8,25.569,28.0,0.6,22,20,1.138,3
5.697,0,0,1,4,29.787,27,29,27.618,9,0,0.0,14,19.415,29.0,0.714,20,18,1.103,1
7.352,5,0,4,5,38.694,34,36,34.036,16,0,0.0,8,22.046,26.0,0.617,20,18,1.138,2
7.762,7,0,4,5,45.524,40,42,39.803,20,0,0.0,8,25.569,28.0,0.6,22,20,1.138,3
8.262,10,0,4,5,53.355,47,50,46.571,24,0,0.0,8,30.091,32.0,0.597,26,23,1.135,3
6.65,0,0,2,4,39.617,36,38,35.909,14,0,0.0,18,26.682,34.5,0.697,24,22,1.1,4
6.62,4,0,2,6,41.451,37,38,37.447,16,0,0.0,11,25.352,29.5,0.65,22,21,1.12,7
6.456,0,0,1,2,26.369,24,26,23.964,9,0,0.0,13,17.506,24.0,0.702,17,15,1.099,0
7.79,8,0,4,5,48.939,43,45,42.687,22,0,0.0,8,27.33,29.0,0.594,23,21,1.138,3
6.745,8,0,4,5,46.524,41,44,40.803,20,0,0.0,8,26.569,30.0,0.61,24,21,1.135,3
7.783,6,0,4,5,42.109,37,39,36.92,18,0,0.0,8,23.807,27.0,0.608,21,19,1.138,4
8.31,8,0,4,5,48.939,43,45,42.687,22,0,0.0,8,27.33,29.0,0.594,23,21,1.138,4
8.277,8,0,4,5,48.939,43,45,42.687,22,0,0.0,8,27.33,29.0,0.594,23,21,1.138,3
8.5,9,0,4,5,49.939,44,47,43.687,22,0,0.0,8,28.33,31.0,0.603,25,22,1.135,3
8.134,6,0,4,5,52.939,47,50,46.687,22,0,0.0,14,31.33,37.0,0.629,28,25,1.126,5
5.432,2,0,2,3,30.282,27,28,26.949,12,0,0.0,10,18.273,22.5,0.644,16,15,1.122,2
7.674,6,0,4,5,42.109,37,39,36.92,18,0,0.0,8,23.807,27.0,0.608,21,19,1.138,2
7.721,6,0,4,5,42.109,37,39,36.92,18,0,0.0,8,23.807,27.0,0.608,21,19,1.138,2
7.215,5,1,3,7,52.2,46,48,46.752,20,1,2.2,14,30.171,36.0,0.638,28,26,1.135,5
8.658,6,0,3,4,35.196,31,33,30.934,15,0,0.0,6,20.04,22.5,0.611,18,16,1.135,0
7.357,2,3,2,6,36.716,32,34,33.371,11,3,9.4,13,21.847,31.0,0.69,23,21,1.147,0
6.745,0,0,3,4,31.365,28,30,28.167,11,0,0.0,13,19.517,27.0,0.675,19,17,1.12,0
5.215,0,0,2,5,28.87,26,28,26.836,8,0,0.0,13,18.659,30.0,0.722,20,18,1.11,1
7.678,5,0,5,6,50.607,45,48,45.022,19,0,0.0,14,30.813,40.0,0.656,29,26,1.125,3
7.268,11,0,5,6,61.683,54,56,53.44,29,0,0.0,8,33.62,33.0,0.577,27,25,1.142,7
6.0,4,0,5,6,37.777,33,35,33.254,15,0,0.0,8,21.29,26.0,0.62,20,18,1.145,2
6.77,7,0,5,9,51.361,45,47,45.636,21,0,0.0,8,29.131,34.0,0.615,26,24,1.141,4
7.745,8,0,4,6,48.883,43,45,43.011,21,1,2.3,8,28.188,30.0,0.613,24,22,1.137,3
6.745,3,0,4,6,34.073,30,32,30.596,12,0,0.0,9,19.977,27.0,0.654,20,18,1.136,2
7.229,6,0,4,6,44.318,39,41,39.247,18,0,0.0,9,25.262,30.0,0.621,23,21,1.136,2
8.398,11,0,4,5,56.77,50,53,49.454,26,0,0.0,8,31.853,33.0,0.592,27,24,1.135,3
8.0,0,1,1,7,31.256,28,30,29.535,8,1,3.6,13,20.455,32.0,0.734,22,20,1.116,1
7.432,1,1,1,5,33.542,30,32,31.014,10,1,3.3,14,21.114,31.0,0.706,22,20,1.118,2
4.0,0,0,1,10,35.465,32,34,34.08,9,0,0.0,13,23.528,37.0,0.735,25,23,1.108,2
7.538,5,2,3,8,52.539,46,48,47.265,19,2,4.3,14,30.108,37.0,0.646,29,27,1.142,5
6.62,5,3,3,9,52.879,46,48,47.778,18,3,6.5,14,30.046,38.0,0.654,30,28,1.15,5
7.721,8,1,3,9,76.694,68,71,68.825,30,1,1.5,21,44.887,53.0,0.638,41,38,1.128,9
6.301,1,0,2,3,26.867,24,25,24.065,10,0,0.0,10,16.512,21.5,0.661,15,14,1.119,1
7.481,3,3,2,8,42.285,37,39,38.905,12,4,10.8,14,25.921,36.0,0.706,27,25,1.143,1
7.0,9,0,8,15,73.189,64,68,66.058,26,0,0.0,14,41.08,53.0,0.639,42,38,1.144,9
6.866,2,3,2,8,36.72,32,34,34.142,9,3,9.4,13,21.994,35.0,0.718,25,23,1.147,1
7.854,6,1,3,7,53.2,47,50,47.752,20,1,2.1,14,31.171,39.0,0.645,30,27,1.132,4
5.487,0,0,3,4,31.365,28,30,28.167,11,0,0.0,13,19.517,27.0,0.675,19,17,1.12,0
4.456,0,0,3,8,31.372,28,30,29.709,7,0,0.0,13,19.812,35.0,0.739,23,21,1.12,2
5.0,5,3,3,9,52.879,46,48,47.778,18,3,6.5,14,30.046,38.0,0.654,30,28,1.15,5
7.854,7,2,3,10,73.619,65,68,66.454,27,2,3.1,21,43.063,53.0,0.65,41,38,1.133,8
7.456,4,0,4,5,48.524,43,45,42.803,20,0,0.0,14,28.569,34.0,0.628,25,23,1.128,6
7.585,4,0,3,4,43.611,39,42,38.818,17,0,0.0,14,26.801,34.0,0.653,25,22,1.118,3
5.824,5,3,3,9,52.879,46,48,47.778,18,3,6.5,14,30.046,38.0,0.654,30,28,1.15,5
4.284,1,3,2,6,38.716,34,36,35.371,11,3,8.8,16,23.847,34.5,0.708,25,23,1.139,2
7.237,3,0,4,5,42.694,38,41,38.036,16,0,0.0,14,26.046,34.0,0.657,25,22,1.124,2
8.262,6,0,4,5,44.524,39,40,38.803,20,0,0.0,8,24.569,26.0,0.59,20,19,1.142,5
8.427,6,0,4,5,44.524,39,40,38.803,20,0,0.0,8,24.569,26.0,0.59,20,19,1.142,4
8.222,8,0,4,5,48.939,43,45,42.687,22,0,0.0,8,27.33,29.0,0.594,23,21,1.138,4
7.569,2,0,4,7,58.654,53,57,53.207,20,0,0.0,24,38.671,51.5,0.697,37,33,1.107,5
7.824,8,0,4,5,48.939,43,45,42.687,22,0,0.0,8,27.33,29.0,0.594,23,21,1.138,3
7.602,6,0,5,10,59.571,53,56,53.963,21,0,0.0,16,36.585,46.0,0.667,35,32,1.124,7
6.524,2,0,3,4,25.95,23,25,23.284,9,0,0.0,8,15.756,22.0,0.668,16,14,1.128,0
7.387,5,0,4,5,41.109,36,37,35.92,18,0,0.0,8,22.807,25.0,0.597,19,18,1.142,5
6.963,8,0,3,4,47.441,42,45,41.585,21,0,0.0,9,27.324,30.0,0.608,24,21,1.13,2
4.208,1,0,2,4,38.907,35,37,35.16,14,0,0.0,16,24.489,32.5,0.675,23,21,1.112,3
7.337,5,0,2,3,58.773,53,57,52.251,24,0,0.0,21,36.841,44.0,0.652,33,29,1.109,4
7.301,2,0,4,5,30.863,27,28,27.269,12,0,0.0,8,17.523,22.0,0.626,16,15,1.143,2
4.367,1,0,2,3,37.697,34,36,33.833,14,0,0.0,16,24.034,31.5,0.674,22,20,1.109,2
4.569,0,0,3,4,35.365,32,34,32.167,11,0,0.0,16,23.517,34.5,0.715,23,21,1.105,2
6.046,0,0,2,3,34.282,31,33,30.949,12,0,0.0,16,22.273,30.5,0.69,21,19,1.106,2
6.62,4,0,3,6,54.571,49,52,48.989,21,0,0.0,18,34.426,42.5,0.662,31,28,1.114,7
7.62,10,1,3,8,69.07,61,64,61.614,28,1,1.6,15,39.671,45.0,0.625,36,33,1.132,6
7.201,7,0,4,6,57.564,51,54,50.898,24,0,0.0,14,33.546,39.0,0.623,30,27,1.129,6
6.604,9,0,3,4,56.272,50,53,49.352,25,0,0.0,12,32.847,35.0,0.611,28,25,1.125,5
6.562,11,0,3,4,63.102,56,59,55.12,29,0,0.0,12,36.37,37.0,0.6,30,27,1.127,5
8.301,7,0,4,8,72.813,65,69,65.32,28,0,0.0,22,43.978,54.0,0.65,41,37,1.12,6
7.745,5,0,3,6,51.86,46,48,46.24,21,0,0.0,14,30.233,35.0,0.629,27,25,1.127,5
7.301,7,1,3,9,73.279,65,68,65.941,28,1,1.5,21,43.125,52.0,0.644,40,37,1.127,8
6.013,6,0,3,6,55.275,49,51,49.123,23,0,0.0,14,31.995,36.0,0.622,28,26,1.128,6
7.921,5,0,4,5,41.109,36,37,35.92,18,0,0.0,8,22.807,25.0,0.597,19,18,1.142,4
7.62,6,0,4,5,42.109,37,39,36.92,18,0,0.0,8,23.807,27.0,0.608,21,19,1.138,5
6.726,10,0,3,7,68.73,61,64,61.101,29,0,0.0,15,39.733,44.0,0.619,35,32,1.127,6
8.642,4,0,4,5,37.694,33,34,33.036,16,0,0.0,8,21.046,24.0,0.605,18,17,1.142,3
8.396,5,0,4,5,41.109,36,37,35.92,18,0,0.0,8,22.807,25.0,0.597,19,18,1.142,3
7.721,8,0,4,5,48.939,43,45,42.687,22,0,0.0,8,27.33,29.0,0.594,23,21,1.138,4
8.523,7,0,4,5,45.524,40,42,39.803,20,0,0.0,8,25.569,28.0,0.6,22,20,1.138,3
6.854,4,0,5,9,43.531,38,39,38.869,17,0,0.0,8,24.608,30.0,0.621,22,21,1.146,5
7.721,3,0,4,5,34.279,30,31,30.153,14,0,0.0,8,19.284,23.0,0.614,17,16,1.143,2
6.955,3,0,3,4,40.196,36,39,35.934,15,0,0.0,14,25.04,33.0,0.665,24,21,1.117,1
7.301,6,0,4,5,42.109,37,39,36.92,18,0,0.0,8,23.807,27.0,0.608,21,19,1.138,2
7.244,0,0,1,4,29.787,27,29,27.618,9,0,0.0,14,19.415,29.0,0.714,20,18,1.103,1
7.013,6,0,3,6,53.86,48,51,48.24,21,0,0.0,15,32.233,40.0,0.645,30,27,1.122,6
7.495,4,0,4,5,37.694,33,34,33.036,16,0,0.0,8,21.046,24.0,0.605,18,17,1.142,4
7.347,9,0,4,5,52.355,46,48,45.571,24,0,0.0,8,29.091,30.0,0.588,24,22,1.138,6
8.523,6,0,4,6,55.883,50,53,50.011,21,1,2.0,16,35.188,43.0,0.667,32,29,1.118,5
5.959,1,0,2,4,38.907,35,37,35.16,14,0,0.0,16,24.489,32.5,0.675,23,21,1.112,3
6.996,0,0,4,5,34.448,31,33,31.385,10,0,0.0,15,22.762,34.5,0.722,23,21,1.111,2
5.237,0,0,2,3,27.867,25,26,25.065,10,0,0.0,12,17.512,23.5,0.675,16,15,1.115,2
4.638,0,0,2,4,35.491,32,34,32.276,12,0,0.0,16,22.727,32.5,0.691,22,20,1.109,2
6.699,11,0,3,7,72.145,64,67,63.985,31,0,0.0,15,41.495,45.0,0.614,36,33,1.127,7
8.097,10,0,4,7,68.604,61,65,60.992,28,0,0.0,16,40.523,47.0,0.632,37,33,1.125,4
6.123,0,0,3,5,34.285,31,33,31.244,11,0,0.0,15,23.165,31.5,0.712,22,20,1.106,3
7.432,5,0,4,5,51.939,46,48,45.687,22,0,0.0,14,30.33,35.0,0.62,26,24,1.129,6
6.987,11,1,3,8,72.485,64,67,64.498,30,1,1.6,15,41.432,46.0,0.62,37,34,1.133,7
6.762,4,0,2,4,24.787,22,23,22.142,10,0,0.0,4,15.159,16.0,0.639,13,12,1.127,0
6.632,0,0,2,5,28.87,26,28,26.836,8,0,0.0,13,18.659,30.0,0.722,20,18,1.11,1
6.0,5,0,4,5,38.694,34,36,34.036,16,0,0.0,8,22.046,26.0,0.617,20,18,1.138,2
7.509,6,0,4,5,42.109,37,39,36.92,18,0,0.0,8,23.807,27.0,0.608,21,19,1.138,2
6.959,6,0,4,5,42.109,37,39,36.92,18,0,0.0,8,23.807,27.0,0.608,21,19,1.138,3
6.796,4,0,4,5,35.279,31,33,31.153,14,0,0.0,8,20.284,25.0,0.627,19,17,1.138,2
7.485,5,0,4,5,38.694,34,36,34.036,16,0,0.0,8,22.046,26.0,0.617,20,18,1.138,2
7.621,5,0,4,5,38.694,34,36,34.036,16,0,0.0,8,22.046,26.0,0.617,20,18,1.138,2
7.79,5,0,4,5,38.694,34,36,34.036,16,0,0.0,8,22.046,26.0,0.617,20,18,1.138,2
7.745,4,0,4,5,35.279,31,33,31.153,14,0,0.0,8,20.284,25.0,0.627,19,17,1.138,2
7.66,4,0,4,5,35.279,31,33,31.153,14,0,0.0,8,20.284,25.0,0.627,19,17,1.138,2
8.097,9,0,5,9,68.896,61,65,61.538,27,0,0.0,16,40.222,48.0,0.635,38,34,1.129,3
8.523,9,1,4,9,66.738,59,63,59.949,25,1,1.7,16,39.154,48.0,0.646,38,34,1.131,4
8.222,7,1,4,7,58.904,52,55,52.411,23,1,1.9,15,34.483,41.0,0.638,32,29,1.133,4
8.301,5,1,4,7,52.073,46,49,46.643,19,1,2.2,15,30.961,39.0,0.655,30,27,1.132,3
8.222,5,1,4,8,65.113,58,62,58.738,23,1,1.7,22,39.938,52.0,0.67,39,35,1.123,4
7.921,7,1,4,8,60.113,53,56,53.738,23,1,1.9,15,34.938,42.0,0.639,33,30,1.134,5
7.921,7,0,4,9,61.903,55,58,55.629,24,0,0.0,15,37.102,45.0,0.644,34,31,1.126,5
8.097,7,1,4,10,62.243,55,58,56.142,23,1,1.8,15,37.04,46.0,0.651,35,32,1.132,5
8.222,8,1,4,7,62.319,55,58,55.294,25,1,1.8,15,36.245,42.0,0.631,33,30,1.133,5
8.301,9,1,4,7,65.734,58,61,58.178,27,1,1.7,15,38.006,43.0,0.624,34,31,1.133,6
7.959,5,0,4,7,64.773,58,62,58.225,24,0,0.0,22,40.0,51.0,0.664,38,34,1.117,4
8.301,7,1,4,8,61.113,54,57,54.738,23,1,1.9,16,35.938,44.0,0.646,34,31,1.132,4
8.222,9,1,5,10,69.236,61,65,62.051,26,1,1.6,16,40.159,49.0,0.642,39,35,1.135,3
8.097,10,1,5,10,72.651,64,68,64.934,28,1,1.6,16,41.921,50.0,0.635,40,36,1.135,3
7.921,9,1,4,8,65.528,58,62,58.621,25,1,1.7,16,38.699,47.0,0.645,37,33,1.13,4
7.292,5,0,4,6,62.564,56,60,55.898,24,0,0.0,21,38.546,48.0,0.657,36,32,1.117,4
8.301,5,1,4,7,62.904,56,60,56.411,23,1,1.8,21,38.483,49.0,0.664,37,33,1.123,4
8.222,6,1,4,8,57.698,51,54,51.854,21,1,2.0,16,34.176,43.0,0.654,33,30,1.131,3
7.745,7,0,4,6,69.394,62,66,61.665,28,0,0.0,21,42.069,50.0,0.643,38,34,1.119,5
7.699,10,0,5,9,72.312,64,68,64.421,29,0,0.0,16,41.983,49.0,0.629,39,35,1.13,3
8.0,5,0,5,7,61.647,55,59,55.116,23,0,0.0,20,37.79,48.0,0.66,36,32,1.121,4
8.611,5,1,4,6,39.034,34,36,34.549,15,1,2.9,8,21.983,27.0,0.628,21,19,1.148,2
6.921,4,0,4,5,35.279,31,33,31.153,14,0,0.0,8,20.284,25.0,0.627,19,17,1.138,2
6.886,6,0,4,5,42.109,37,39,36.92,18,0,0.0,8,23.807,27.0,0.608,21,19,1.138,2
5.481,6,3,4,8,43.128,37,39,38.458,15,3,8.1,8,23.62,30.0,0.639,24,22,1.166,2
8.097,9,0,4,5,52.355,46,48,45.571,24,0,0.0,8,29.091,30.0,0.588,24,22,1.138,3
8.461,8,0,4,5,48.939,43,45,42.687,22,0,0.0,8,27.33,29.0,0.594,23,21,1.138,3
7.602,5,0,4,5,38.694,34,36,34.036,16,0,0.0,8,22.046,26.0,0.617,20,18,1.138,2
5.0,4,0,3,4,39.196,35,38,34.934,15,0,0.0,12,24.04,30.5,0.655,23,20,1.12,1
6.975,4,0,3,4,39.196,35,38,34.934,15,0,0.0,12,24.04,30.5,0.655,23,20,1.12,1
8.35,7,0,4,5,56.355,50,53,49.571,24,0,0.0,14,33.091,38.0,0.621,29,26,1.127,5
7.596,4,0,4,6,37.488,33,35,33.48,14,0,0.0,9,21.739,28.0,0.641,21,19,1.136,2
5.0,6,0,3,4,35.196,31,33,30.934,15,0,0.0,6,20.04,23.0,0.611,18,16,1.135,0
8.161,5,0,3,5,39.116,35,38,35.011,15,0,0.0,10,24.688,30.0,0.661,23,20,1.118,1
6.957,3,0,3,5,36.7,33,36,33.127,13,0,0.0,12,23.926,30.5,0.685,23,20,1.112,1
6.368,3,0,3,6,33.205,30,33,30.32,11,0,0.0,10,22.813,29.0,0.709,22,19,1.107,1
7.509,9,0,4,5,49.939,44,47,43.687,22,0,0.0,8,28.33,31.0,0.603,25,22,1.135,3
8.412,5,0,4,5,38.694,34,36,34.036,16,0,0.0,8,22.046,26.0,0.617,20,18,1.138,2
8.373,6,0,4,5,42.109,37,39,36.92,18,0,0.0,8,23.807,27.0,0.608,21,19,1.138,2
5.012,5,0,3,4,42.611,38,41,37.818,17,0,0.0,12,25.801,31.5,0.644,24,21,1.121,1
5.0,4,0,3,4,50.026,45,49,44.702,19,0,0.0,18,31.563,40.5,0.667,30,26,1.112,2
8.301,6,0,4,5,42.109,37,39,36.92,18,0,0.0,8,23.807,27.0,0.608,21,19,1.138,2
8.222,6,1,4,6,53.279,47,50,47.2,21,1,2.1,14,31.267,38.0,0.637,29,26,1.134,4
8.427,12,0,4,5,60.185,53,56,52.338,28,0,0.0,8,33.614,34.0,0.587,28,25,1.136,3
5.0,3,0,3,4,46.611,42,46,41.818,17,0,0.0,18,29.801,39.5,0.678,29,25,1.11,2
8.31,7,0,4,5,45.524,40,42,39.803,20,0,0.0,8,25.569,28.0,0.6,22,20,1.138,4
5.344,2,0,2,6,48.866,44,46,44.331,18,0,0.0,18,31.114,38.5,0.672,28,26,1.111,6
5.638,0,0,2,3,25.452,23,24,23.182,8,0,0.0,10,16.75,24.5,0.71,16,15,1.107,1
5.721,0,0,2,3,23.452,21,22,21.182,8,0,0.0,10,14.75,20.5,0.683,14,13,1.117,1
8.398,9,1,4,7,63.319,56,60,56.294,25,1,1.8,15,37.245,44.0,0.637,35,31,1.131,5
7.855,5,0,4,5,38.694,34,36,34.036,16,0,0.0,8,22.046,26.0,0.617,20,18,1.138,2
7.785,8,0,4,5,46.524,41,44,40.803,20,0,0.0,8,26.569,30.0,0.61,24,21,1.135,3
5.658,1,0,2,3,28.867,26,27,26.065,10,0,0.0,10,18.512,25.5,0.687,17,16,1.11,1
5.469,1,0,2,3,26.867,24,25,24.065,10,0,0.0,10,16.512,21.5,0.661,15,14,1.119,1
7.745,8,0,4,7,63.189,56,59,56.109,26,0,0.0,15,36.762,42.0,0.625,33,30,1.128,5
5.735,7,0,3,5,39.531,35,37,34.894,17,0,0.0,6,23.449,24.5,0.619,20,18,1.129,1
6.699,3,0,4,5,31.863,28,30,28.269,12,0,0.0,8,18.523,24.0,0.64,18,16,1.138,2
7.561,7,0,4,5,45.524,40,42,39.803,20,0,0.0,8,25.569,28.0,0.6,22,20,1.138,3
6.828,4,0,3,5,35.7,32,35,32.127,13,0,0.0,10,22.926,29.0,0.675,22,19,1.116,1
8.285,7,0,4,5,45.524,40,42,39.803,20,0,0.0,8,25.569,28.0,0.6,22,20,1.138,3
8.5,5,0,4,5,38.694,34,36,34.036,16,0,0.0,8,22.046,26.0,0.617,20,18,1.138,2
7.886,6,0,4,5,42.109,37,39,36.92,18,0,0.0,8,23.807,27.0,0.608,21,19,1.138,3
7.8,7,0,4,5,45.524,40,42,39.803,20,0,0.0,8,25.569,28.0,0.6,22,20,1.138,3
7.617,8,0,4,5,48.939,43,45,42.687,22,0,0.0,8,27.33,29.0,0.594,23,21,1.138,3
7.526,5,0,3,4,31.78,28,30,28.051,13,0,0.0,6,18.279,21.5,0.622,17,15,1.135,0
7.602,4,0,4,5,35.279,31,33,31.153,14,0,0.0,8,20.284,25.0,0.627,19,17,1.138,2
6.886,8,0,4,5,48.939,43,45,42.687,22,0,0.0,8,27.33,29.0,0.594,23,21,1.138,4
7.347,11,0,9,16,80.103,70,75,72.043,29,0,0.0,14,44.847,57.0,0.635,46,41,1.144,7
7.658,5,0,4,5,38.694,34,36,34.036,16,0,0.0,8,22.046,26.0,0.617,20,18,1.138,2
8.262,9,0,4,5,52.355,46,48,45.571,24,0,0.0,8,29.091,30.0,0.588,24,22,1.138,3
6.602,5,2,3,8,52.539,46,48,47.265,19,2,4.3,14,30.108,37.0,0.646,29,27,1.142,5
7.235,6,0,5,6,44.607,39,41,39.022,19,0,0.0,8,24.813,28.0,0.603,22,20,1.144,2
7.574,9,0,4,5,52.355,46,48,45.571,24,0,0.0,8,29.091,30.0,0.588,24,22,1.138,4
5.0,6,1,3,7,55.615,49,51,49.636,22,1,2.0,14,31.932,37.0,0.63,29,27,1.135,6
5.03,6,0,2,6,49.282,44,46,44.214,20,0,0.0,12,29.875,33.5,0.639,26,24,1.12,5
7.921,10,2,3,9,69.41,61,64,62.127,27,2,3.3,15,39.608,46.0,0.632,37,34,1.138,6
7.481,7,0,4,5,45.524,40,42,39.803,20,0,0.0,8,25.569,28.0,0.6,22,20,1.138,4
8.427,7,0,4,5,45.524,40,42,39.803,20,0,0.0,8,25.569,28.0,0.6,22,20,1.138,5
6.0,5,0,4,8,52.863,47,50,47.534,20,0,0.0,14,32.125,41.0,0.652,30,27,1.125,4
7.149,1,0,3,5,37.99,34,36,34.378,13,0,0.0,15,23.733,32.5,0.68,23,21,1.117,3
7.056,5,0,4,5,49.524,44,47,43.803,20,0,0.0,14,29.569,36.0,0.637,27,24,1.126,4
7.444,7,0,3,8,72.94,65,68,65.429,29,0,0.0,21,43.188,51.0,0.638,39,36,1.122,8
7.745,4,0,4,5,46.109,41,44,40.92,18,0,0.0,14,27.807,35.0,0.646,26,23,1.125,2
7.77,9,0,4,6,53.564,47,49,46.898,24,0,0.0,8,29.546,31.0,0.591,25,23,1.14,5
6.793,7,0,5,7,58.647,52,56,52.116,23,0,0.0,15,34.79,43.0,0.64,33,29,1.128,2
6.699,8,0,3,8,76.355,68,71,68.312,31,0,0.0,21,44.949,52.0,0.633,40,37,1.123,9
6.928,1,3,3,7,37.799,33,35,34.589,10,3,9.1,15,23.091,34.5,0.714,25,23,1.145,2
8.301,8,1,4,8,62.113,55,59,55.738,23,1,1.8,16,36.938,46.0,0.652,36,32,1.129,4
8.5,6,0,4,5,42.109,37,39,36.92,18,0,0.0,8,23.807,27.0,0.608,21,19,1.138,2
8.31,7,0,4,5,45.524,40,42,39.803,20,0,0.0,8,25.569,28.0,0.6,22,20,1.138,2
8.699,5,0,6,8,60.73,54,58,54.334,22,0,0.0,19,37.034,48.0,0.662,36,32,1.125,4
7.886,6,1,4,7,55.489,49,52,49.527,21,1,2.0,15,32.722,40.0,0.646,31,28,1.132,3
8.461,5,0,4,5,38.694,34,36,34.036,16,0,0.0,8,22.046,26.0,0.617,20,18,1.138,2
6.285,8,0,3,4,42.026,37,39,36.702,19,0,0.0,6,23.563,24.5,0.594,20,18,1.136,1
7.824,11,1,4,8,72.359,64,68,64.389,29,1,1.6,16,42.222,49.0,0.632,39,35,1.131,4
7.409,7,0,4,7,59.773,53,56,53.225,24,0,0.0,15,35.0,41.0,0.632,32,29,1.128,5
8.199,5,0,4,6,38.638,34,36,34.36,15,1,2.9,8,22.904,27.0,0.641,21,19,1.136,2
7.638,8,0,4,9,65.318,58,61,58.512,26,0,0.0,15,38.864,46.0,0.637,35,32,1.126,5
5.0,3,0,3,5,36.7,33,36,33.127,13,0,0.0,12,23.926,30.5,0.685,23,20,1.112,1
8.699,5,1,5,8,61.987,55,59,55.629,22,1,1.8,20,37.728,49.0,0.667,37,33,1.127,4
7.43,9,0,4,5,52.355,46,48,45.571,24,0,0.0,8,29.091,30.0,0.588,24,22,1.138,4
8.523,5,1,6,9,61.07,54,58,54.847,21,1,1.9,19,36.972,49.0,0.67,37,33,1.131,4
7.056,6,0,4,6,55.149,49,52,49.014,22,0,0.0,15,32.784,39.0,0.638,30,27,1.125,3
7.921,7,1,4,8,61.113,54,57,54.738,23,1,1.9,16,35.938,44.0,0.646,34,31,1.132,3
8.155,8,1,4,8,63.528,56,59,56.621,25,1,1.8,15,36.699,43.0,0.632,34,31,1.134,5
8.699,9,1,4,9,66.738,59,63,59.949,25,1,1.7,16,39.154,48.0,0.646,38,34,1.131,4
8.699,10,1,4,8,68.944,61,65,61.505,27,1,1.6,16,40.461,48.0,0.638,38,34,1.13,4
8.137,7,0,3,4,45.026,40,43,39.702,19,0,0.0,10,26.563,30.5,0.625,24,21,1.126,1
6.854,4,0,4,5,35.279,31,33,31.153,14,0,0.0,8,20.284,25.0,0.627,19,17,1.138,2
5.155,5,0,3,4,31.78,28,30,28.051,13,0,0.0,6,18.279,22.0,0.622,17,15,1.135,0
7.77,8,0,4,5,48.939,43,45,42.687,22,0,0.0,8,27.33,29.0,0.594,23,21,1.138,3
6.097,2,0,2,3,30.282,27,28,26.949,12,0,0.0,10,18.273,22.5,0.644,16,15,1.122,2
7.77,5,0,4,5,38.694,34,36,34.036,16,0,0.0,8,22.046,26.0,0.617,20,18,1.138,2
6.215,3,0,4,5,31.863,28,30,28.269,12,0,0.0,8,18.523,24.0,0.64,18,16,1.138,2
5.002,0,1,0,3,29.835,27,29,27.585,9,1,3.7,15,19.654,28.0,0.72,20,18,1.105,1
7.518,8,0,4,6,55.564,49,52,48.898,24,0,0.0,11,31.546,34.5,0.608,28,25,1.134,6
6.156,4,0,3,5,40.405,36,39,36.262,15,0,0.0,12,24.495,31.5,0.657,24,21,1.122,2
6.456,7,0,3,4,42.026,37,39,36.702,19,0,0.0,7,23.563,24.0,0.594,20,18,1.136,2
6.822,7,0,4,5,50.939,45,48,44.687,22,0,0.0,11,29.33,32.5,0.612,26,23,1.132,5
6.398,4,0,3,4,37.196,33,35,32.934,15,0,0.0,10,22.04,26.5,0.635,20,18,1.127,2
7.523,7,0,3,7,56.195,50,53,50.2,23,0,0.0,13,33.642,40.0,0.633,30,27,1.124,5
6.0,9,0,3,4,46.441,41,44,40.585,21,0,0.0,7,26.324,27.0,0.598,23,20,1.133,2
6.0,1,3,3,8,40.009,35,38,36.916,10,3,8.6,16,24.546,37.5,0.722,28,25,1.143,2
6.0,6,0,5,7,48.817,43,46,43.349,19,0,0.0,11,28.267,34.5,0.633,27,24,1.135,1
6.783,3,0,4,6,42.903,38,40,38.363,16,0,0.0,13,25.5,33.0,0.649,24,22,1.129,3
7.305,8,0,3,4,45.441,40,42,39.585,21,0,0.0,7,25.324,25.0,0.588,21,19,1.136,2
6.873,10,0,5,7,64.478,57,61,56.883,27,0,0.0,13,37.313,43.0,0.62,34,30,1.131,4
6.824,6,0,4,6,50.734,45,48,45.131,20,0,0.0,13,30.023,37.0,0.638,28,25,1.127,3
7.009,3,0,4,6,42.903,38,40,38.363,16,0,0.0,13,25.5,33.0,0.649,24,22,1.129,3
6.955,6,0,4,6,50.734,45,48,45.131,20,0,0.0,13,30.023,37.0,0.638,28,25,1.127,3
6.558,8,0,5,7,60.062,53,56,53.0,25,0,0.0,13,34.552,40.0,0.619,31,28,1.133,4
7.125,9,0,4,5,56.355,50,54,49.571,24,0,0.0,12,33.091,38.0,0.621,30,26,1.127,2
6.848,10,0,5,7,64.478,57,61,56.883,27,0,0.0,13,37.313,43.0,0.62,34,30,1.131,4
7.72,4,0,3,4,40.611,36,38,35.818,17,0,0.0,11,23.801,27.5,0.624,21,19,1.128,3
6.23,4,0,3,4,40.611,36,38,35.818,17,0,0.0,11,23.801,27.5,0.624,21,19,1.128,2
7.556,4,0,3,4,38.196,34,37,33.934,15,0,0.0,11,23.04,28.5,0.645,22,19,1.123,3
7.419,6,0,3,4,45.026,40,43,39.702,19,0,0.0,11,26.563,30.5,0.625,24,21,1.126,2
6.745,5,0,4,6,46.318,41,44,41.247,18,0,0.0,12,27.262,34.5,0.639,26,23,1.13,5
6.301,7,0,5,7,60.647,54,59,54.116,23,0,0.0,17,36.79,46.5,0.653,36,31,1.123,2
7.222,10,0,4,6,58.979,52,55,51.781,26,0,0.0,10,33.307,36.0,0.602,29,26,1.134,4
5.951,6,0,3,4,45.026,40,43,39.702,19,0,0.0,11,26.563,30.5,0.625,24,21,1.126,2
6.939,10,0,3,4,49.856,44,47,43.469,23,0,0.0,7,28.086,28.0,0.592,24,21,1.133,2
6.699,6,0,3,4,41.611,37,40,36.818,17,0,0.0,10,24.801,29.5,0.634,23,20,1.125,1
6.301,1,0,3,4,37.78,34,37,34.051,13,0,0.0,16,24.279,33.5,0.689,24,21,1.111,1
7.097,6,0,5,7,48.817,43,46,43.349,19,0,0.0,11,28.267,34.5,0.633,27,24,1.135,3
6.0,0,0,4,5,35.448,32,35,32.385,10,0,0.0,16,23.762,36.5,0.731,25,22,1.108,1
7.0,5,0,5,7,47.817,42,44,42.349,19,0,0.0,11,27.267,32.5,0.624,25,23,1.138,4
6.301,0,0,3,5,34.309,31,34,31.491,10,1,3.2,16,23.375,33.5,0.733,24,21,1.107,1
6.222,0,0,3,5,34.207,31,34,31.396,10,1,3.2,16,23.87,33.5,0.739,24,21,1.103,1
6.854,7,0,5,8,53.441,47,50,47.56,21,0,0.0,11,30.483,36.5,0.627,29,26,1.137,5
7.0,11,0,4,6,62.394,55,58,54.665,28,0,0.0,10,35.069,37.0,0.597,30,27,1.134,5
6.824,0,0,3,5,30.87,28,31,28.36,9,0,0.0,14,21.404,31.0,0.734,22,19,1.102,1
6.699,0,0,3,5,31.159,28,31,28.611,9,0,0.0,14,20.21,31.0,0.717,22,19,1.113,1
7.398,4,0,3,4,36.196,32,34,31.934,15,0,0.0,9,21.04,25.0,0.623,19,17,1.131,2
7.347,4,0,4,6,48.318,43,46,43.247,18,0,0.0,15,29.262,38.0,0.656,28,25,1.124,4
6.523,1,0,3,4,26.95,24,26,24.284,9,0,0.0,10,16.756,23.5,0.682,17,15,1.123,0
6.886,7,0,4,6,51.149,45,47,45.014,22,0,0.0,10,28.784,32.0,0.606,25,23,1.137,5
8.0,6,0,5,7,48.817,43,46,43.349,19,0,0.0,11,28.267,34.5,0.633,27,24,1.135,1
7.0,2,0,3,6,43.614,39,42,39.589,15,0,0.0,16,26.949,36.5,0.676,27,24,1.118,3
6.097,5,0,5,7,58.647,52,55,52.116,23,0,0.0,17,34.79,42.5,0.64,32,29,1.128,5
6.0,5,0,5,7,45.402,40,43,40.465,17,0,0.0,11,26.506,33.5,0.642,26,23,1.135,1
5.854,5,0,5,7,56.232,50,54,50.232,21,0,0.0,17,34.029,43.5,0.655,33,29,1.125,2
6.301,2,0,3,4,41.196,37,40,36.934,15,0,0.0,16,26.04,34.5,0.674,25,22,1.113,2
7.421,4,0,3,4,38.196,34,37,33.934,15,0,0.0,11,23.04,28.5,0.645,22,19,1.123,3
6.827,1,0,4,6,42.488,38,41,38.48,14,0,0.0,17,26.739,37.5,0.688,27,24,1.118,3
6.553,5,0,4,5,40.694,36,39,36.036,16,0,0.0,10,24.046,29.5,0.638,23,20,1.13,2
6.623,0,0,2,3,24.452,22,24,22.182,8,0,0.0,11,15.75,22.5,0.697,16,14,1.111,0
7.429,5,0,3,4,41.611,37,40,36.818,17,0,0.0,11,24.801,29.5,0.634,23,20,1.125,2
7.959,6,0,3,4,45.026,40,43,39.702,19,0,0.0,11,26.563,30.5,0.625,24,21,1.126,2
6.155,0,0,3,5,34.207,31,34,31.396,10,1,3.2,16,23.87,33.5,0.739,24,21,1.103,1
7.377,4,0,4,7,48.823,44,49,44.44,16,0,0.0,17,32.148,45.0,0.701,33,28,1.11,2
6.553,4,0,3,5,40.405,36,39,36.262,15,0,0.0,12,24.495,31.5,0.657,24,21,1.122,1
5.886,5,0,5,7,58.647,52,55,52.116,23,0,0.0,17,34.79,42.5,0.64,32,29,1.128,5
7.071,10,0,3,4,54.272,48,51,47.352,25,0,0.0,9,30.847,32.0,0.595,26,23,1.131,4
6.301,6,0,5,6,51.023,45,48,44.905,21,0,0.0,12,29.574,35.5,0.623,27,24,1.134,5
6.622,6,0,4,6,49.734,44,47,44.131,20,0,0.0,12,29.023,34.5,0.63,27,24,1.13,4
7.523,5,0,5,7,45.402,40,43,40.465,17,0,0.0,11,26.506,33.5,0.642,26,23,1.135,1
6.638,9,0,4,7,56.773,50,53,50.225,24,0,0.0,10,32.0,36.0,0.61,29,26,1.135,5
7.066,8,0,5,7,60.062,53,56,53.0,25,0,0.0,13,34.552,40.0,0.619,31,28,1.133,4
7.602,8,0,5,7,54.647,48,51,48.116,23,0,0.0,10,30.79,35.0,0.61,28,25,1.138,3
6.638,10,0,5,7,72.308,64,68,63.65,31,0,0.0,16,41.836,47.0,0.615,37,33,1.13,5
5.959,10,0,5,8,61.272,54,58,54.327,25,0,0.0,11,35.006,40.5,0.621,33,29,1.135,3
7.046,11,0,5,8,64.687,57,61,57.211,27,0,0.0,11,36.767,41.5,0.615,34,30,1.135,5
6.0,5,0,5,7,45.402,40,43,40.465,17,0,0.0,11,26.506,33.5,0.642,26,23,1.135,1
6.301,5,0,4,5,55.939,50,54,49.687,22,0,0.0,18,34.33,43.5,0.651,32,28,1.119,5
7.013,4,0,4,6,48.318,43,46,43.247,18,0,0.0,15,29.262,38.0,0.656,28,25,1.124,4
7.357,4,0,4,6,48.318,43,46,43.247,18,0,0.0,15,29.262,38.0,0.656,28,25,1.124,4
6.523,5,0,5,7,45.402,40,43,40.465,17,0,0.0,11,26.506,33.5,0.642,26,23,1.135,1
6.699,2,0,3,6,43.614,39,42,39.589,15,0,0.0,16,26.949,36.5,0.676,27,24,1.118,3
6.409,9,2,5,9,58.742,51,54,52.025,23,2,3.9,10,32.427,38.0,0.619,31,28,1.152,3
6.0,5,0,5,7,56.232,50,54,50.232,21,0,0.0,17,34.029,43.5,0.655,33,29,1.125,2
7.569,9,0,5,7,58.062,51,54,51.0,25,0,0.0,10,32.552,36.0,0.604,29,26,1.138,3
7.155,7,0,5,7,52.232,46,49,46.232,21,0,0.0,11,30.029,35.5,0.625,28,25,1.135,3
6.0,0,1,3,5,34.705,31,34,31.68,10,1,3.2,16,22.455,33.5,0.718,24,21,1.12,1
6.0,6,0,5,8,50.026,44,47,44.676,19,0,0.0,11,28.722,35.5,0.635,28,25,1.137,4
7.523,3,0,3,7,48.239,43,46,43.8,17,0,0.0,16,29.165,38.5,0.665,29,26,1.122,4
6.523,8,0,5,7,53.232,47,51,47.232,21,0,0.0,11,31.029,37.5,0.633,30,26,1.133,3
6.789,2,0,3,4,44.611,40,43,39.818,17,0,0.0,17,27.801,35.5,0.662,26,23,1.115,4
4.364,5,0,3,6,55.445,50,55,50.356,19,0,0.0,20,35.472,48.5,0.688,36,31,1.109,3
7.276,9,0,4,6,55.564,49,52,48.898,24,0,0.0,10,31.546,35.0,0.608,28,25,1.134,4
6.0,3,0,3,4,44.611,40,43,39.818,17,0,0.0,16,27.801,35.5,0.662,26,23,1.115,3
5.602,7,0,5,7,60.647,54,59,54.116,23,0,0.0,17,36.79,46.5,0.653,36,31,1.123,2
6.222,7,0,5,7,49.817,44,48,44.349,19,0,0.0,11,29.267,36.5,0.641,29,25,1.132,1
6.699,2,0,3,6,43.614,39,42,39.589,15,0,0.0,16,26.949,36.5,0.676,27,24,1.118,3
6.854,6,0,5,8,50.026,44,47,44.676,19,0,0.0,11,28.722,35.5,0.635,28,25,1.137,4
6.796,9,0,4,6,55.564,49,52,48.898,24,0,0.0,10,31.546,35.0,0.608,28,25,1.134,4
6.155,10,0,5,8,61.272,54,58,54.327,25,0,0.0,11,35.006,40.5,0.621,33,29,1.135,3
6.921,9,0,6,8,64.561,57,61,57.101,26,0,0.0,14,37.557,45.0,0.629,35,31,1.133,5
6.301,0,0,3,5,34.309,31,34,31.491,10,1,3.2,16,23.375,33.5,0.733,24,21,1.107,1
6.886,8,0,3,4,49.856,44,46,43.469,23,0,0.0,9,28.086,29.0,0.592,23,21,1.133,5
7.237,10,0,5,7,61.478,54,57,53.883,27,0,0.0,10,34.313,37.0,0.599,30,27,1.138,3
6.0,0,1,3,5,34.705,31,34,31.68,10,1,3.2,16,22.455,33.5,0.718,24,21,1.12,1
7.387,9,0,5,7,65.478,58,62,57.883,27,0,0.0,15,38.313,45.0,0.626,35,31,1.129,5
6.0,4,0,3,4,48.026,43,46,42.702,19,0,0.0,16,29.563,36.5,0.651,27,24,1.117,2
8.658,0,0,5,6,40.362,36,39,36.371,13,0,0.0,17,25.529,37.5,0.692,26,23,1.121,3
9.062,0,0,4,6,39.073,35,38,35.596,12,0,0.0,17,24.977,37.5,0.703,26,23,1.116,3
7.699,0,0,7,8,38.528,34,37,34.807,11,0,0.0,15,24.017,37.5,0.703,26,23,1.133,3
6.0,0,0,4,6,39.073,35,38,35.596,12,0,0.0,17,24.977,37.5,0.703,26,23,1.116,3
7.086,7,0,3,4,46.441,41,43,40.585,21,0,0.0,9,26.324,28.0,0.598,22,20,1.133,4
8.432,0,0,5,7,38.156,34,37,34.814,11,0,0.0,16,24.222,37.5,0.709,26,23,1.122,3
6.469,5,0,5,6,47.607,42,45,42.022,19,0,0.0,12,27.813,34.5,0.631,26,23,1.134,5
7.699,1,3,5,9,51.211,45,49,46.676,14,3,6.7,21,31.864,49.0,0.714,35,31,1.138,3
6.484,0,0,5,8,39.076,35,38,35.891,11,0,0.0,16,25.869,38.5,0.723,27,24,1.116,3
6.285,3,0,4,5,36.279,32,34,32.153,14,0,0.0,10,21.284,26.5,0.639,20,18,1.134,2
7.0,0,0,3,4,34.365,31,34,31.167,11,0,0.0,16,22.517,32.5,0.706,23,20,1.109,1
8.262,5,0,3,4,41.611,37,40,36.818,17,0,0.0,11,24.801,29.5,0.634,23,20,1.125,2
9.011,0,0,4,5,42.279,38,41,38.153,14,0,0.0,19,27.284,39.0,0.696,27,24,1.113,3
6.959,5,0,3,4,50.441,45,48,44.585,21,0,0.0,15,30.324,36.0,0.634,27,24,1.121,5
7.585,0,0,5,7,41.282,37,40,37.447,13,0,0.0,17,27.176,38.5,0.706,27,24,1.116,3
8.601,0,0,4,6,38.783,35,38,35.345,12,0,0.0,17,26.171,37.5,0.717,26,23,1.108,3
8.677,0,0,5,6,40.362,36,39,36.371,13,0,0.0,17,25.529,37.5,0.692,26,23,1.121,3
8.699,0,0,4,5,42.279,38,41,38.153,14,0,0.0,19,27.284,39.0,0.696,27,24,1.113,3
7.194,0,0,5,8,39.365,35,38,36.142,11,0,0.0,16,24.676,38.0,0.709,27,24,1.125,3
8.604,0,0,4,5,42.279,38,41,38.153,14,0,0.0,19,27.284,39.0,0.696,27,24,1.113,3
7.149,0,0,3,4,43.196,39,42,38.934,15,0,0.0,20,28.04,39.0,0.691,27,24,1.108,3
7.699,0,0,5,6,46.777,42,46,42.254,15,0,0.0,21,30.29,45.0,0.701,31,27,1.114,3
7.796,0,0,5,8,39.365,35,38,36.142,11,0,0.0,16,24.676,38.0,0.709,27,24,1.125,3
7.699,1,0,5,6,43.777,39,42,39.254,15,0,0.0,17,27.29,38.5,0.678,27,24,1.122,3
8.22,1,0,5,7,41.571,37,40,37.698,13,0,0.0,16,25.983,38.5,0.693,27,24,1.124,3
6.336,0,0,5,8,39.076,35,38,35.891,11,0,0.0,16,25.869,38.0,0.723,27,24,1.116,3
7.745,1,0,4,6,42.488,38,41,38.48,14,0,0.0,17,26.739,38.5,0.688,27,24,1.118,3
8.509,5,1,6,11,59.958,53,57,54.494,19,3,5.7,18,37.688,49.5,0.695,38,34,1.131,4
6.583,2,0,2,4,37.907,34,36,34.16,14,0,0.0,14,23.489,30.0,0.666,22,20,1.115,2
7.886,9,1,4,9,64.622,57,60,57.825,25,3,5.3,14,38.722,43.5,0.647,35,32,1.134,6
8.143,7,1,5,11,62.499,55,58,56.487,22,3,5.5,15,37.659,45.5,0.665,36,33,1.136,3
5.022,2,0,3,5,36.99,33,35,33.378,13,0,0.0,13,22.733,30.0,0.671,22,20,1.121,3
6.426,6,0,3,5,40.82,36,38,36.145,17,0,0.0,8,23.256,26.0,0.616,21,19,1.134,3
8.268,10,1,4,9,65.622,58,62,58.825,25,3,5.2,14,39.722,45.5,0.653,37,33,1.131,4
9.0,9,1,4,9,62.207,55,59,55.942,23,3,5.5,14,37.96,44.5,0.661,36,32,1.131,4
6.699,6,1,3,8,51.878,46,49,47.073,18,3,6.5,14,32.432,39.5,0.68,31,28,1.128,3
8.086,8,1,4,9,58.792,52,56,53.058,21,3,5.8,14,36.199,43.5,0.67,35,31,1.131,3
8.585,8,1,4,9,61.207,54,57,54.942,23,3,5.6,14,36.96,42.5,0.655,34,31,1.133,4
7.854,11,1,4,9,69.037,61,65,61.709,27,3,4.9,14,41.483,46.5,0.646,38,34,1.132,4
8.602,12,2,5,10,83.027,73,77,73.77,33,2,2.7,18,47.688,55.0,0.629,44,40,1.137,6
7.658,10,1,4,9,68.037,60,63,60.709,27,3,5.0,14,40.483,44.5,0.64,36,33,1.134,6
8.046,7,1,5,11,60.084,53,57,54.603,20,3,5.7,15,36.898,46.5,0.68,37,33,1.134,3
8.745,12,1,5,9,76.272,67,70,67.374,32,1,1.5,14,42.989,47.0,0.612,38,35,1.138,6
8.689,9,1,5,11,69.33,61,64,62.254,26,3,4.9,15,41.182,47.5,0.649,38,35,1.137,5
8.745,5,1,5,10,67.29,60,65,61.16,22,3,5.0,23,43.205,57.0,0.697,43,38,1.122,4
8.638,5,1,4,9,50.961,45,48,46.291,17,3,6.7,14,31.676,39.5,0.684,31,28,1.132,3
7.387,6,1,4,9,54.377,48,51,49.174,19,3,6.3,14,33.438,40.5,0.673,32,29,1.133,3
8.481,12,1,5,9,82.687,73,77,73.258,34,1,1.4,18,47.75,54.0,0.624,43,39,1.133,6
9.155,5,1,6,11,61.958,55,59,56.494,19,3,5.5,19,39.688,53.5,0.706,40,36,1.127,4
8.244,12,1,5,9,71.857,63,66,63.49,30,1,1.6,12,40.228,44.0,0.611,36,33,1.141,5
7.921,13,1,5,9,75.272,66,69,66.374,32,1,1.5,12,41.989,45.0,0.606,37,34,1.14,4
8.509,11,1,5,9,68.442,60,63,60.607,28,1,1.7,12,38.466,43.0,0.616,35,32,1.141,4
7.824,6,1,5,11,65.499,58,62,59.487,22,3,5.2,19,40.659,51.5,0.682,40,36,1.129,5
8.42,13,1,5,9,75.272,66,69,66.374,32,1,1.5,12,41.989,45.0,0.606,37,34,1.14,5
7.62,5,2,4,10,62.131,55,59,56.571,20,4,7.3,20,39.137,50.5,0.695,39,35,1.13,4
8.444,12,2,5,10,83.027,73,77,73.77,33,2,2.7,18,47.688,55.0,0.629,44,40,1.137,6
8.377,12,2,5,10,83.027,73,77,73.77,33,2,2.7,18,47.688,55.0,0.629,44,40,1.137,6
7.886,7,1,4,10,59.001,52,55,53.385,21,3,5.8,14,35.654,42.5,0.664,34,31,1.135,5
8.678,8,1,4,10,63.416,56,59,57.269,23,3,5.4,15,38.415,45.5,0.662,36,33,1.132,4
6.509,9,0,3,5,61.896,55,58,54.563,27,0,0.0,14,36.063,39.0,0.615,31,28,1.125,5
6.886,9,0,4,7,64.189,57,61,57.109,26,0,0.0,15,37.762,44.0,0.632,35,31,1.126,2
8.398,3,2,5,9,48.081,42,45,43.491,15,2,4.8,15,28.381,40.0,0.678,30,27,1.145,4
5.37,1,0,3,4,33.365,30,33,30.167,11,0,0.0,14,21.517,31.0,0.696,22,19,1.112,0
7.796,6,1,5,8,57.987,51,54,51.629,22,1,2.0,15,33.728,42.0,0.64,32,29,1.137,4
5.553,9,0,3,6,50.86,45,48,45.24,21,0,0.0,9,29.233,33.0,0.621,27,24,1.13,1
8.0,4,0,5,7,53.232,47,49,47.232,21,0,0.0,15,31.029,38.0,0.633,28,26,1.133,6
7.699,6,0,5,7,57.647,51,54,51.116,23,0,0.0,15,33.79,41.0,0.633,31,28,1.13,6
5.886,6,0,2,5,52.072,47,51,46.887,20,0,0.0,16,33.421,41.0,0.668,31,27,1.108,2
6.377,7,0,4,6,49.734,44,47,44.131,20,0,0.0,11,29.023,34.5,0.63,27,24,1.13,3
5.495,8,0,3,5,45.235,40,43,40.029,19,0,0.0,8,26.017,29.0,0.618,24,21,1.131,1
6.18,7,0,3,5,41.82,37,40,37.145,17,0,0.0,8,24.256,28.0,0.627,23,20,1.13,1
7.699,6,0,5,7,57.647,51,54,51.116,23,0,0.0,15,33.79,41.0,0.633,31,28,1.13,5
7.523,5,0,5,8,55.441,49,52,49.56,21,0,0.0,15,32.483,41.0,0.642,31,28,1.131,5
7.658,7,0,5,7,61.062,54,57,54.0,25,0,0.0,15,35.552,42.0,0.626,32,29,1.131,5
6.638,5,0,3,5,44.82,40,43,40.145,17,0,0.0,13,27.256,34.0,0.655,26,23,1.121,2
5.337,5,0,3,5,44.82,40,43,40.145,17,0,0.0,13,27.256,34.0,0.655,26,23,1.121,2
7.187,4,0,5,7,50.817,45,48,45.349,19,0,0.0,15,30.267,39.0,0.649,29,26,1.129,5
8.301,3,3,4,8,46.128,40,42,41.458,15,3,7.5,14,26.62,36.0,0.666,27,25,1.153,4
5.284,5,0,2,3,43.528,39,42,38.6,18,0,0.0,13,26.557,31.0,0.64,24,21,1.116,2
8.398,3,0,4,6,46.318,41,43,41.247,18,0,0.0,14,27.262,34.0,0.639,25,23,1.13,5
6.26,9,0,2,4,46.152,41,44,40.811,20,0,0.0,8,26.773,29.0,0.615,24,21,1.126,1
8.097,2,1,4,6,42.034,37,39,37.549,15,1,2.7,14,24.983,33.0,0.658,24,22,1.136,4
7.699,2,1,4,6,42.034,37,39,37.549,15,1,2.7,14,24.983,33.0,0.658,24,22,1.136,4
7.602,2,2,4,7,42.373,37,39,38.062,14,2,5.4,14,24.921,34.0,0.668,25,23,1.145,4
7.268,6,0,5,8,58.857,52,55,52.443,23,0,0.0,15,34.245,42.0,0.634,32,29,1.132,6
5.231,0,0,3,5,29.894,27,30,27.607,8,1,3.7,14,20.614,31.0,0.748,22,19,1.107,0
5.238,0,0,4,5,29.033,26,29,26.502,8,0,0.0,13,19.0,30.0,0.725,21,18,1.117,0
5.386,0,0,3,4,36.365,33,37,33.167,11,0,0.0,18,24.517,37.5,0.724,26,22,1.102,0
7.611,0,0,3,4,32.365,29,31,29.167,11,0,0.0,14,20.517,29.0,0.686,20,18,1.116,2
7.745,5,0,5,7,54.232,48,51,48.232,21,0,0.0,15,32.029,40.0,0.641,30,27,1.13,5
8.0,6,0,5,7,57.647,51,54,51.116,23,0,0.0,15,33.79,41.0,0.633,31,28,1.13,4
4.828,0,0,3,5,29.894,27,30,27.607,8,1,3.7,14,20.614,31.0,0.748,22,19,1.107,0
6.699,5,0,2,5,45.579,41,44,41.156,17,1,2.4,14,29.364,35.0,0.676,27,24,1.112,2
6.237,6,0,2,5,61.192,55,59,54.905,24,0,0.0,20,37.75,46.0,0.654,35,31,1.113,5
6.268,1,0,1,2,25.369,23,25,22.964,9,0,0.0,11,16.506,22.5,0.689,16,14,1.103,0
5.569,5,0,2,6,46.866,42,45,42.331,18,0,0.0,13,29.114,36.0,0.657,27,24,1.116,3
7.444,7,0,5,10,60.986,54,58,54.847,23,0,0.0,14,36.347,46.0,0.646,35,31,1.129,6
4.918,0,0,3,5,29.792,27,30,27.513,8,1,3.7,14,21.108,31.0,0.755,22,19,1.103,0
6.387,2,0,2,3,24.867,22,23,22.065,10,0,0.0,7,14.511,17.0,0.63,13,12,1.13,0
8.222,2,2,4,7,42.373,37,39,38.062,14,2,5.4,14,24.921,34.0,0.668,25,23,1.145,4
7.301,9,0,4,7,64.189,57,61,57.109,26,0,0.0,15,37.762,44.0,0.632,35,31,1.126,2
6.187,5,0,2,5,45.681,41,44,41.251,17,1,2.4,14,28.87,35.0,0.671,27,24,1.114,2
7.432,4,0,2,5,42.266,38,41,38.367,15,1,2.6,14,27.108,34.0,0.684,26,23,1.112,1
6.444,5,0,3,5,44.82,40,43,40.145,17,0,0.0,13,27.256,34.0,0.655,26,23,1.121,2
5.538,6,0,3,6,44.74,40,43,40.222,17,0,0.0,11,27.904,33.5,0.659,26,23,1.119,2
4.0,1,0,4,6,33.658,30,33,30.713,10,0,0.0,13,21.216,32.0,0.703,23,20,1.122,1
7.921,6,2,5,9,58.327,51,54,52.141,21,2,3.9,15,33.665,43.0,0.648,33,30,1.144,4
5.921,6,0,2,5,50.362,45,48,45.138,20,0,0.0,14,30.228,36.0,0.643,28,25,1.119,3
5.77,6,0,2,5,50.362,45,48,45.138,20,0,0.0,14,30.228,36.0,0.643,28,25,1.119,3
4.0,1,0,3,4,33.365,30,33,30.167,11,0,0.0,14,21.517,31.0,0.696,22,19,1.112,0
5.456,10,0,4,6,54.564,48,51,47.898,24,0,0.0,8,30.546,32.0,0.6,27,24,1.137,2
6.387,10,0,3,5,62.896,56,60,55.563,27,0,0.0,14,37.063,41.0,0.622,33,29,1.123,3
5.553,8,0,3,6,49.86,44,46,44.24,21,0,0.0,9,28.233,31.0,0.612,25,23,1.133,3
5.301,7,0,2,6,45.156,40,42,40.582,18,0,0.0,9,25.921,30.0,0.628,24,22,1.129,4
6.161,5,0,3,5,48.235,43,46,43.029,19,0,0.0,14,29.017,35.0,0.644,27,24,1.122,2
5.854,4,0,2,5,43.531,39,42,39.371,16,0,0.0,14,26.705,34.0,0.663,26,23,1.116,2
6.886,5,0,2,5,46.946,42,45,42.254,18,0,0.0,14,28.466,35.0,0.652,27,24,1.118,3
8.301,3,1,5,8,47.741,42,45,42.978,16,1,2.4,15,28.443,39.0,0.669,29,26,1.137,4
7.42,7,0,5,7,61.062,54,57,54.0,25,0,0.0,15,35.552,42.0,0.626,32,29,1.131,6
8.0,1,0,5,7,50.402,45,48,45.465,17,0,0.0,20,31.506,44.0,0.682,31,28,1.12,5
8.222,4,1,5,8,51.156,45,48,45.862,18,1,2.2,15,30.205,40.0,0.658,30,27,1.137,4
5.959,5,0,2,5,45.681,41,44,41.251,17,1,2.4,14,28.87,35.0,0.671,27,24,1.114,2
6.046,5,0,2,5,45.681,41,44,41.251,17,1,2.4,14,28.87,35.0,0.671,27,24,1.114,2
6.796,6,0,2,5,50.362,45,48,45.138,20,0,0.0,14,30.228,36.0,0.643,28,25,1.119,3
6.071,0,0,3,4,29.95,27,30,27.284,9,0,0.0,14,19.756,30.0,0.717,21,18,1.109,0
4.0,2,0,3,4,36.78,33,36,33.051,13,0,0.0,14,23.279,32.0,0.679,23,20,1.115,0
7.523,0,0,5,7,46.986,42,45,42.582,15,0,0.0,20,29.745,43.0,0.695,30,27,1.119,4
7.658,5,0,5,7,54.232,48,51,48.232,21,0,0.0,15,32.029,40.0,0.641,30,27,1.13,3
7.398,5,0,5,7,54.232,48,51,48.232,21,0,0.0,15,32.029,40.0,0.641,30,27,1.13,3
6.076,4,0,2,4,42.322,38,41,38.043,16,0,0.0,14,26.25,33.0,0.662,25,22,1.114,1
5.796,6,0,4,6,52.734,47,51,47.131,20,0,0.0,15,32.023,41.0,0.654,31,27,1.122,3
7.77,5,0,5,7,54.232,48,51,48.232,21,0,0.0,15,32.029,40.0,0.641,30,27,1.13,4
7.699,2,0,4,6,41.638,37,39,37.36,15,1,2.7,14,25.904,33.0,0.67,24,22,1.125,4
6.745,2,0,4,6,41.638,37,39,37.36,15,1,2.7,14,25.904,33.0,0.67,24,22,1.125,4
6.638,5,0,2,4,45.737,41,44,40.927,18,0,0.0,14,28.012,34.0,0.651,26,23,1.116,2
6.456,6,0,2,4,49.152,44,47,43.811,20,0,0.0,14,29.773,35.0,0.641,27,24,1.117,3
5.959,4,0,3,5,44.82,40,43,40.145,17,0,0.0,14,27.256,34.0,0.655,26,23,1.121,1
6.268,2,0,4,6,42.903,38,40,38.363,16,0,0.0,14,25.5,33.0,0.649,24,22,1.129,4
5.48,1,0,3,4,33.365,30,33,30.167,11,0,0.0,14,21.517,31.0,0.696,22,19,1.112,0
8.398,2,1,4,6,42.034,37,39,37.549,15,1,2.7,14,24.983,33.0,0.658,24,22,1.136,4
8.301,2,0,4,6,41.638,37,39,37.36,15,1,2.7,14,25.904,33.0,0.67,24,22,1.125,4
7.921,2,0,4,6,42.903,38,40,38.363,16,0,0.0,14,25.5,33.0,0.649,24,22,1.129,4
8.569,16,1,5,9,83.103,73,77,73.141,36,1,1.4,12,46.512,49.0,0.604,41,37,1.138,5
8.854,5,1,6,11,66.373,59,64,60.378,21,3,5.1,22,42.449,57.0,0.701,43,38,1.125,4
8.301,7,1,4,9,57.792,51,54,52.058,21,3,5.9,14,35.199,41.5,0.663,33,30,1.133,3
7.721,7,1,4,10,60.001,53,56,54.385,21,3,5.7,15,36.654,44.5,0.67,35,32,1.132,3
7.276,6,0,3,5,51.651,46,49,45.912,21,0,0.0,14,30.779,36.0,0.636,28,25,1.123,4
6.408,6,0,3,5,51.651,46,49,45.912,21,0,0.0,14,30.779,36.0,0.636,28,25,1.123,4
6.503,6,0,3,5,51.651,46,49,45.912,21,0,0.0,14,30.779,36.0,0.636,28,25,1.123,3
8.585,6,1,4,9,54.377,48,51,49.174,19,3,6.3,14,33.438,40.5,0.673,32,29,1.133,3
8.62,7,1,5,13,63.629,56,59,57.891,22,3,5.4,14,38.761,47.5,0.669,37,34,1.136,5
8.602,8,1,5,11,65.915,58,61,59.371,24,3,5.2,15,39.421,46.5,0.657,37,34,1.136,5
8.569,13,1,5,9,75.272,66,69,66.374,32,1,1.5,12,41.989,45.0,0.606,37,34,1.14,5
8.62,16,1,5,9,83.103,73,77,73.141,36,1,1.4,12,46.512,49.0,0.604,41,37,1.138,7
8.292,10,1,5,11,72.745,64,67,65.138,28,3,4.7,15,42.943,48.5,0.643,39,36,1.137,5
8.745,6,1,4,7,54.489,48,51,48.527,21,1,2.1,14,31.722,38.5,0.638,30,27,1.135,3
8.328,11,1,4,7,63.734,56,59,56.178,27,1,1.8,11,36.006,39.0,0.611,32,29,1.138,3
6.382,7,0,2,4,41.737,37,39,36.927,18,0,0.0,8,24.012,26.0,0.613,21,19,1.128,2
6.796,5,0,3,5,37.405,33,35,33.262,15,0,0.0,8,21.495,25.0,0.626,20,18,1.133,2
7.387,6,0,3,5,40.82,36,38,36.145,17,0,0.0,8,23.256,26.0,0.616,21,19,1.134,2
8.046,7,1,4,12,61.131,54,57,55.789,21,3,5.6,14,37.756,46.5,0.675,36,33,1.132,5
8.42,12,1,5,9,71.857,63,66,63.49,30,1,1.6,12,40.228,44.0,0.611,36,33,1.141,4
8.886,12,1,5,9,71.857,63,66,63.49,30,1,1.6,12,40.228,44.0,0.611,36,33,1.141,4
6.854,6,0,3,5,40.82,36,38,36.145,17,0,0.0,8,23.256,26.0,0.616,21,19,1.134,2
6.416,7,0,3,5,44.235,39,41,39.029,19,0,0.0,8,25.017,27.0,0.608,22,20,1.134,3
6.785,7,0,3,5,44.235,39,41,39.029,19,0,0.0,8,25.017,27.0,0.608,22,20,1.134,3
8.553,12,1,4,9,70.568,62,65,62.716,29,1,1.6,12,39.676,44.0,0.616,36,33,1.138,4
8.585,11,1,4,7,63.734,56,59,56.178,27,1,1.8,11,36.006,39.0,0.611,32,29,1.138,3
8.409,11,1,5,9,68.442,60,63,60.607,28,1,1.7,12,38.466,43.0,0.616,35,32,1.141,4
8.347,12,1,4,7,67.149,59,62,59.061,29,1,1.7,11,37.767,40.0,0.606,33,30,1.138,3
8.013,13,1,4,7,70.565,62,65,61.945,31,1,1.6,11,39.529,41.0,0.601,34,31,1.138,4
9.0,9,1,4,10,66.832,59,62,60.152,25,3,5.1,15,40.176,46.5,0.654,37,34,1.133,4
8.432,10,1,4,10,67.832,60,64,61.152,25,3,5.0,15,41.176,48.5,0.66,39,35,1.131,4
8.62,5,1,5,11,63.084,56,60,57.603,20,3,5.4,20,39.898,52.5,0.697,40,36,1.127,4
8.409,12,1,5,9,82.687,73,77,73.258,34,1,1.4,18,47.75,54.0,0.624,43,39,1.133,6
8.495,15,1,5,9,79.687,70,74,70.258,34,1,1.4,12,44.75,48.0,0.608,40,36,1.138,7
7.489,6,0,4,6,54.149,48,51,48.014,22,0,0.0,14,31.784,37.0,0.63,29,26,1.128,3
8.509,11,1,5,9,68.442,60,63,60.607,28,1,1.7,12,38.466,43.0,0.616,35,32,1.141,4
8.398,6,1,4,9,54.377,48,51,49.174,19,3,6.3,14,33.438,40.5,0.673,32,29,1.133,3
7.229,5,1,3,9,49.672,44,47,45.516,16,3,6.8,14,31.125,39.5,0.692,31,28,1.129,3
8.796,6,1,4,9,54.377,48,51,49.174,19,3,6.3,14,33.438,40.5,0.673,32,29,1.133,3
7.854,9,1,4,9,64.622,57,60,57.825,25,3,5.3,14,38.722,43.5,0.647,35,32,1.134,5
8.432,11,1,5,9,70.857,62,64,62.49,30,1,1.6,12,39.228,42.0,0.605,34,32,1.143,5
8.444,11,1,5,9,68.442,60,63,60.607,28,1,1.7,12,38.466,43.0,0.616,35,32,1.141,5
7.745,9,1,5,10,67.12,59,62,59.927,26,3,5.1,14,39.728,44.5,0.642,36,33,1.138,6
8.208,10,1,4,9,65.622,58,62,58.825,25,3,5.2,14,39.722,45.5,0.653,37,33,1.131,3
8.201,6,1,4,10,56.586,50,53,51.502,19,3,6.0,15,34.892,43.5,0.68,34,31,1.132,3
7.854,5,1,6,11,61.958,55,59,56.494,19,3,5.5,19,39.688,53.5,0.706,40,36,1.127,4
9.0,5,1,6,11,66.373,59,64,60.378,21,3,5.1,22,42.449,57.0,0.701,43,38,1.125,4
8.509,14,1,5,9,78.687,69,72,69.258,34,1,1.4,12,43.75,46.0,0.602,38,35,1.14,6
7.456,4,0,2,5,42.266,38,41,38.367,15,1,2.6,14,27.108,34.0,0.684,26,23,1.112,1
8.638,7,1,4,9,57.792,51,54,52.058,21,3,5.9,14,35.199,41.5,0.663,33,30,1.133,4
7.921,5,1,5,10,60.875,54,58,55.276,20,3,5.6,19,38.443,49.5,0.691,38,34,1.127,4
8.509,5,1,6,12,61.167,54,58,55.822,19,3,5.6,18,38.142,51.0,0.695,39,35,1.133,4
8.699,7,1,5,12,64.709,57,60,58.814,22,3,5.3,16,39.114,48.5,0.671,38,35,1.135,4
8.553,5,1,5,10,60.875,54,58,55.276,20,3,5.6,19,38.443,49.5,0.691,38,34,1.127,4
9.0,6,1,4,8,54.433,48,51,48.851,20,2,4.2,14,32.58,39.5,0.656,31,28,1.134,3
8.337,10,1,4,7,60.319,53,56,53.294,25,1,1.9,11,34.245,38.0,0.617,31,28,1.138,3
8.149,6,1,4,9,54.377,48,51,49.174,19,3,6.3,14,33.438,40.5,0.673,32,29,1.133,3
7.523,6,0,5,7,57.647,51,54,51.116,23,0,0.0,15,33.79,41.0,0.633,31,28,1.13,4
8.0,5,0,5,7,54.232,48,51,48.232,21,0,0.0,15,32.029,40.0,0.641,30,27,1.13,5
8.495,7,1,4,10,60.001,53,56,54.385,21,3,5.7,15,36.654,44.5,0.67,35,32,1.132,4
8.553,12,1,5,9,71.857,63,66,63.49,30,1,1.6,12,40.228,44.0,0.611,36,33,1.141,4
8.745,12,1,5,9,74.272,65,67,65.374,32,1,1.5,12,40.989,43.0,0.6,35,33,1.143,5
7.602,8,0,5,7,64.478,57,60,56.883,27,0,0.0,15,37.313,43.0,0.62,33,30,1.131,5
8.569,11,1,5,9,68.442,60,63,60.607,28,1,1.7,12,38.466,43.0,0.616,35,32,1.141,4
8.456,17,1,5,9,86.518,76,80,76.025,38,1,1.3,12,48.273,50.0,0.6,42,38,1.138,7
7.337,6,0,5,7,57.647,51,54,51.116,23,0,0.0,15,33.79,41.0,0.633,31,28,1.13,4
8.222,4,2,5,9,51.496,45,48,46.374,17,2,4.4,15,30.142,41.0,0.666,31,28,1.144,4
8.602,9,1,4,9,62.207,55,59,55.942,23,3,5.5,14,37.96,44.5,0.661,36,32,1.131,3
7.699,6,0,5,7,57.647,51,54,51.116,23,0,0.0,15,33.79,41.0,0.633,31,28,1.13,4
6.328,1,0,3,4,33.365,30,33,30.167,11,0,0.0,14,21.517,31.0,0.696,22,19,1.112,0
6.921,6,0,3,5,51.651,46,49,45.912,21,0,0.0,14,30.779,36.0,0.636,28,25,1.123,3
6.252,1,0,4,5,32.448,29,32,29.385,10,0,0.0,13,20.762,31.0,0.703,22,19,1.119,0
7.824,3,0,5,7,49.817,44,46,44.349,19,0,0.0,15,29.267,37.0,0.641,27,25,1.132,5
6.854,4,0,2,3,29.282,26,28,25.949,12,0,0.0,7,17.273,20.0,0.63,16,14,1.126,0
6.481,6,0,4,6,47.318,42,45,42.247,18,0,0.0,12,28.262,35.0,0.648,27,24,1.127,3
8.699,2,2,4,7,42.373,37,39,38.062,14,2,5.4,14,24.921,34.0,0.668,25,23,1.145,4
6.476,5,0,2,4,37.322,33,34,33.043,16,0,0.0,8,21.25,23.0,0.611,18,17,1.131,3
8.361,2,0,4,5,41.694,37,39,37.036,16,0,0.0,14,25.046,32.0,0.648,23,21,1.127,4
8.796,7,1,4,7,57.904,51,54,51.411,23,1,2.0,14,33.483,39.5,0.631,31,28,1.135,3
6.745,8,0,3,5,45.235,40,43,40.029,19,0,0.0,8,26.017,29.0,0.618,24,21,1.131,1
8.854,2,1,4,6,42.034,37,39,37.549,15,1,2.7,14,24.983,33.0,0.658,24,22,1.136,4
8.0,3,0,5,7,47.402,42,45,42.465,17,0,0.0,15,28.506,38.0,0.659,28,25,1.129,4
6.585,4,0,2,5,42.266,38,41,38.367,15,1,2.6,14,27.108,34.0,0.684,26,23,1.112,1
6.0,3,0,4,6,46.318,41,43,41.247,18,0,0.0,14,27.262,34.0,0.639,25,23,1.13,5
6.553,10,0,3,5,52.066,46,49,45.796,23,0,0.0,8,29.54,31.0,0.604,26,23,1.132,2
6.699,5,0,3,5,46.82,42,45,42.145,17,0,0.0,14,29.256,38.0,0.671,28,25,1.115,2
5.491,0,0,4,5,29.033,26,29,26.502,8,0,0.0,13,19.0,30.0,0.725,21,18,1.117,0
6.357,9,0,4,6,61.979,55,59,54.781,26,0,0.0,14,36.307,41.0,0.624,33,29,1.127,3
6.91,2,0,2,4,27.076,24,25,24.393,10,0,0.0,8,15.966,20.0,0.649,15,14,1.128,1
6.429,3,0,3,5,43.82,39,41,39.145,17,0,0.0,14,26.256,32.0,0.646,24,22,1.124,3
8.387,2,0,3,4,36.78,33,36,33.051,13,0,0.0,14,23.279,32.0,0.679,23,20,1.115,1
8.377,3,0,3,5,41.405,37,40,37.262,15,0,0.0,14,25.495,34.0,0.666,25,22,1.119,2
8.237,5,0,4,5,49.524,44,47,43.803,20,0,0.0,14,29.569,36.0,0.637,27,24,1.126,3
6.114,1,0,2,3,33.282,30,32,29.949,12,0,0.0,14,21.273,28.0,0.68,20,18,1.109,2
8.244,2,0,3,5,36.724,33,36,33.374,12,1,3.0,14,24.137,33.0,0.704,24,21,1.113,1
8.347,5,0,4,7,54.358,48,50,48.342,22,0,0.0,14,31.239,37.0,0.624,28,26,1.132,8
7.991,5,0,4,5,49.524,44,47,43.803,20,0,0.0,14,29.569,36.0,0.637,27,24,1.126,4
8.347,3,0,4,5,45.109,40,42,39.92,18,0,0.0,14,26.807,33.0,0.637,24,22,1.128,4
6.565,5,0,4,7,54.358,48,50,48.342,22,0,0.0,14,31.239,37.0,0.624,28,26,1.132,8
7.77,0,0,3,4,32.365,29,31,29.167,11,0,0.0,14,20.517,29.0,0.686,20,18,1.116,2
8.06,6,0,5,6,55.438,49,52,48.789,23,0,0.0,14,32.336,38.0,0.624,29,26,1.131,4
4.737,0,0,2,3,20.452,18,18,18.182,8,0,0.0,7,11.75,14.0,0.63,10,10,1.136,1
7.004,14,0,4,6,70.225,62,66,61.432,32,0,0.0,10,39.591,40.5,0.595,34,30,1.133,4
6.893,0,0,2,3,25.452,23,25,23.182,8,0,0.0,12,16.75,25.0,0.71,17,15,1.107,0
8.252,3,0,4,5,45.109,40,42,39.92,18,0,0.0,14,26.807,33.0,0.637,24,22,1.128,4
6.447,14,0,4,8,71.354,63,67,62.836,32,0,0.0,9,40.694,42.5,0.6,35,31,1.133,5
7.523,3,0,2,3,30.282,27,29,26.949,12,0,0.0,9,18.273,22.5,0.644,17,15,1.122,0
6.457,14,0,4,8,71.354,63,67,62.836,32,0,0.0,9,40.694,42.5,0.6,35,31,1.133,5
6.777,4,0,1,2,31.199,28,30,27.731,13,0,0.0,9,19.029,22.5,0.639,17,15,1.114,0
8.398,2,0,4,5,41.694,37,39,37.036,16,0,0.0,14,25.046,32.0,0.648,23,21,1.127,4
8.229,3,0,4,6,57.149,51,54,51.014,22,0,0.0,20,34.784,44.0,0.652,32,29,1.121,6
5.125,6,0,1,2,33.614,30,32,29.614,15,0,0.0,7,19.79,21.0,0.614,17,15,1.12,0
7.602,10,1,3,6,56.821,50,53,50.192,24,1,2.0,10,32.239,35.0,0.613,29,26,1.136,3
7.229,9,0,3,5,53.066,47,50,46.796,23,0,0.0,10,30.54,33.5,0.612,27,24,1.129,2
6.678,10,0,3,7,57.61,51,54,51.083,25,0,0.0,9,33.404,36.5,0.612,29,26,1.13,4
7.932,6,0,4,5,52.939,47,50,46.687,22,0,0.0,14,31.33,37.0,0.629,28,25,1.126,4
7.495,14,1,4,7,70.565,62,66,61.945,31,1,1.6,10,39.529,41.5,0.601,35,31,1.138,4
7.377,10,0,3,5,56.481,50,53,49.68,25,0,0.0,10,32.302,34.5,0.606,28,25,1.13,3
6.79,9,0,3,5,53.066,47,50,46.796,23,0,0.0,10,30.54,33.5,0.612,27,24,1.129,2
7.456,3,0,2,3,30.282,27,29,26.949,12,0,0.0,9,18.273,22.5,0.644,17,15,1.122,0
6.733,13,0,4,6,66.81,59,63,58.549,30,0,0.0,10,37.83,39.5,0.599,33,29,1.132,3
