pXC50,nS,nCsp2,nAB,Sp,nBT,Sv,Si,nH,nBO,nHet,nBM,nC,nHM,Se,nDB,MW,nCsp3,SCBO,C.,nSK,RBF,nO,nAT,AMW
4.0,0,9,10,18.938,30,18.327,32.618,13,17,4,11,12,0,29.385,1,219.26,3,23.0,41.4,16,0.1,3,29,7.561
7.678,0,13,12,19.028,27,18.606,28.648,9,18,4,13,13,1,26.724,1,248.67,0,25.0,50.0,17,0.074,3,26,9.564
7.77,0,13,12,20.79,30,20.133,32.063,11,19,4,13,14,1,29.607,1,262.7,1,26.0,48.3,18,0.067,3,29,9.059
7.201,0,13,12,20.79,30,20.133,32.063,11,19,4,13,14,1,29.607,1,262.7,1,26.0,48.3,18,0.067,3,29,9.059
6.775,0,13,12,21.028,29,20.606,30.648,9,20,4,14,15,1,28.724,1,272.69,0,29.0,53.6,19,0.034,3,28,9.739
8.824,0,13,12,18.108,27,18.162,29.044,9,18,4,13,13,0,26.913,1,232.22,0,25.0,50.0,17,0.074,3,26,8.932
5.523,0,13,12,24.767,37,23.901,40.103,15,22,5,13,16,1,36.702,1,306.76,3,29.0,44.4,21,0.108,4,36,8.521
7.854,0,13,12,26.074,39,24.713,42.309,17,22,4,13,17,1,38.258,1,304.79,4,29.0,44.7,21,0.128,3,38,8.021
7.538,0,13,12,26.074,39,24.713,42.309,17,22,4,13,17,1,38.258,1,304.79,4,29.0,44.7,21,0.103,3,38,8.021
6.328,0,13,12,26.074,39,24.713,42.309,17,22,4,13,17,1,38.258,1,304.79,4,29.0,44.7,21,0.077,3,38,8.021
7.585,0,13,12,21.057,31,21.997,34.292,8,23,8,13,14,1,32.473,1,332.67,1,30.0,46.7,22,0.097,4,30,11.089
4.242,1,11,11,22.04,33,21.229,35.747,13,20,6,14,13,1,32.789,3,279.34,2,28.5,40.6,19,0.152,4,32,8.729
5.955,0,13,12,20.938,32,20.327,34.618,13,19,4,13,14,0,31.385,1,243.28,1,26.0,45.2,18,0.125,3,31,7.848
4.046,0,12,11,21.847,34,21.756,37.037,13,21,6,13,14,0,34.04,2,275.28,2,28.5,42.4,20,0.088,5,33,8.342
4.523,1,13,12,24.04,36,23.229,37.747,13,23,6,15,15,1,34.789,3,303.36,2,32.0,44.1,21,0.083,4,34,8.922
4.481,0,12,11,21.392,33,21.041,35.827,13,20,5,13,14,0,32.713,2,259.28,2,27.5,43.8,19,0.152,4,32,8.103
4.504,0,11,11,20.693,32,19.832,34.535,14,18,3,12,14,0,31.167,1,230.28,3,24.5,45.2,17,0.094,3,31,7.428
4.523,1,13,12,25.801,39,24.755,41.162,15,24,6,15,16,1,37.673,3,317.39,3,33.0,43.2,22,0.077,4,37,8.578
6.553,0,13,12,19.875,30,20.009,32.495,10,20,6,15,13,0,30.047,3,258.25,0,29.0,44.8,19,0.133,4,29,8.905
6.155,0,13,12,20.938,32,20.327,34.618,13,19,4,13,14,0,31.385,1,243.28,1,26.0,45.2,18,0.125,3,31,7.848
4.888,0,13,12,18.722,28,18.085,29.993,11,17,3,13,13,0,27.174,1,213.25,0,24.0,48.1,16,0.107,2,27,7.898
5.523,0,13,12,18.722,28,18.085,29.993,11,17,3,13,13,0,27.174,1,213.25,0,24.0,48.1,16,0.107,2,27,7.898
5.47,0,13,12,19.875,30,20.009,32.495,10,20,6,15,13,0,30.047,3,258.25,0,29.0,44.8,19,0.133,4,29,8.905
4.716,0,14,12,21.938,33,21.327,35.618,13,20,4,14,15,0,32.385,2,255.29,1,28.0,46.9,19,0.121,3,32,7.978
4.818,0,13,12,20.296,31,20.762,34.427,10,21,6,13,14,0,31.596,1,281.25,1,28.0,46.7,20,0.097,2,30,9.375
4.72,0,13,12,19.58,28,18.913,29.937,10,18,4,13,13,1,27.498,1,247.69,0,25.0,48.1,17,0.107,2,27,9.174
4.744,0,13,12,20.074,28,19.11,29.835,10,18,4,13,13,1,27.404,1,292.14,0,25.0,48.1,17,0.107,2,27,10.82
4.508,0,13,12,25.767,40,24.192,43.654,19,21,3,13,17,0,38.709,1,269.37,4,28.0,43.6,20,0.1,2,39,6.907
4.949,0,13,12,20.938,32,20.327,34.618,13,19,4,13,14,0,31.385,1,243.28,1,26.0,45.2,18,0.125,3,31,7.848
4.251,0,13,12,20.483,31,19.612,33.408,13,18,3,13,14,0,30.058,1,227.28,1,25.0,46.7,17,0.097,2,30,7.576
4.523,1,13,12,25.801,39,24.755,41.162,15,24,6,15,16,1,37.673,3,317.39,3,33.0,43.2,22,0.077,4,37,8.578
4.523,1,7,6,26.875,43,25.116,46.282,20,23,6,9,15,1,41.214,3,308.44,8,29.0,36.6,21,0.07,3,41,7.523
4.373,0,7,6,20.762,33,19.171,37.156,18,15,2,7,13,0,32.607,1,206.31,6,19.0,39.4,15,0.121,2,33,6.252
4.215,0,16,16,27.852,43,27.478,45.997,16,27,6,18,19,0,41.993,2,341.36,3,37.0,46.3,25,0.093,4,41,8.326
4.248,0,16,16,30.534,46,29.449,49.017,18,28,6,18,20,1,44.687,2,371.84,4,38.0,45.5,26,0.109,4,44,8.451
4.264,0,16,16,29.676,46,28.622,49.073,19,27,5,18,20,0,44.363,2,337.4,4,37.0,45.5,25,0.087,4,44,7.668
4.523,1,13,12,24.801,37,23.755,40.162,15,22,6,15,15,1,36.673,3,305.38,2,31.0,41.7,21,0.162,4,36,8.483
5.088,0,17,17,24.636,37,24.536,38.91,12,25,6,20,17,0,35.931,3,308.31,0,36.5,48.6,23,0.108,4,35,8.809
6.009,0,14,12,22.847,35,22.756,38.037,13,22,6,14,15,0,35.04,2,287.29,1,30.0,44.1,21,0.143,5,34,8.45
5.201,0,14,12,20.631,31,20.515,33.412,11,20,5,14,14,0,30.829,2,257.26,0,28.0,46.7,19,0.129,4,30,8.575
6.155,0,13,12,27.983,44,26.434,48.279,21,23,4,13,18,0,42.92,1,299.4,5,30.0,41.9,22,0.114,3,43,6.963
5.169,0,13,12,25.369,40,24.81,43.867,17,23,6,13,16,0,39.807,1,303.34,3,30.0,41.0,22,0.15,5,39,7.778
5.489,0,13,12,24.46,38,23.38,41.448,17,21,4,13,16,0,37.153,1,271.34,3,28.0,43.2,20,0.105,3,37,7.334
5.573,0,14,12,23.512,36,24.003,40.052,12,24,7,14,16,0,36.807,2,323.29,2,32.0,45.7,23,0.111,3,35,9.237
5.419,0,14,12,21.938,33,21.327,35.618,13,20,4,14,15,0,32.385,2,255.29,1,28.0,46.9,19,0.121,3,32,7.978
5.401,0,14,12,23.091,35,23.251,38.12,12,23,7,16,15,0,35.258,4,300.29,1,33.0,44.1,22,0.143,5,34,8.832
4.896,0,15,12,25.154,38,24.568,41.242,15,23,5,15,17,0,37.596,3,297.33,2,32.0,45.9,22,0.132,4,37,8.036
5.684,0,14,12,23.512,36,24.003,40.052,12,24,7,14,16,0,36.807,2,323.29,2,32.0,45.7,23,0.111,3,35,9.237
5.047,0,14,12,24.154,37,23.568,40.242,15,22,5,14,16,0,36.596,2,285.32,2,30.0,44.4,21,0.135,4,36,7.926
5.499,0,14,12,23.091,35,23.251,38.12,12,23,7,16,15,0,35.258,4,300.29,1,33.0,44.1,22,0.143,5,34,8.832
5.726,0,15,12,25.154,38,24.568,41.242,15,23,5,15,17,0,37.596,3,297.33,2,32.0,45.9,22,0.132,4,37,8.036
5.593,0,14,12,22.796,33,22.154,35.562,12,21,5,14,15,1,32.709,2,289.73,1,29.0,46.9,20,0.121,3,32,9.054
5.446,0,14,12,24.154,37,23.568,40.242,15,22,5,14,16,0,36.596,2,285.32,2,30.0,44.4,21,0.135,4,36,7.926
5.547,0,14,12,23.699,36,22.853,39.033,15,21,4,14,16,0,35.269,2,269.32,2,29.0,45.7,20,0.111,3,35,7.695
5.876,0,14,12,23.091,35,23.251,38.12,12,23,7,16,15,0,35.258,4,300.29,1,33.0,44.1,22,0.143,5,34,8.832
4.728,0,15,12,25.154,38,24.568,41.242,15,23,5,15,17,0,37.596,3,297.33,2,32.0,45.9,22,0.132,4,37,8.036
5.564,0,14,12,23.512,36,24.003,40.052,12,24,7,14,16,0,36.807,2,323.29,2,32.0,45.7,23,0.111,3,35,9.237
5.652,0,14,12,22.796,33,22.154,35.562,12,21,5,14,15,1,32.709,2,289.73,1,29.0,46.9,20,0.121,3,32,9.054
6.31,0,14,12,23.29,33,22.352,35.459,12,21,5,14,15,1,32.614,2,334.18,1,29.0,46.9,20,0.121,3,32,10.443
6.041,0,14,12,24.154,37,23.568,40.242,15,22,5,14,16,0,36.596,2,285.32,2,30.0,44.4,21,0.135,4,36,7.926
5.085,0,14,12,23.699,36,22.853,39.033,15,21,4,14,16,0,35.269,2,269.32,2,29.0,45.7,20,0.111,3,35,7.695
5.152,0,14,12,28.983,45,27.434,49.279,21,24,4,14,19,0,43.92,2,311.41,5,32.0,43.2,23,0.111,3,44,7.077
4.724,0,15,12,23.847,36,23.756,39.037,13,23,6,15,16,0,36.04,3,299.3,1,32.0,45.7,22,0.139,5,35,8.551
5.406,0,14,12,25.307,39,25.492,42.744,14,25,8,16,16,0,39.469,4,330.32,2,35.0,42.1,24,0.154,6,38,8.693
4.796,0,14,12,25.085,39,26.68,44.486,11,28,10,14,17,0,41.229,2,391.29,3,36.0,44.7,27,0.103,3,38,10.297
4.572,0,14,12,26.369,41,25.81,44.867,17,24,6,14,17,0,40.807,2,315.35,3,32.0,42.5,23,0.146,5,40,7.884
4.975,0,14,12,25.46,39,24.38,42.448,17,22,4,14,17,0,38.153,2,283.35,3,30.0,44.7,21,0.103,3,38,7.457
4.5,0,16,12,25.756,39,26.186,42.455,13,26,8,16,17,0,39.695,4,343.31,1,36.0,44.7,25,0.154,7,38,9.034
4.796,0,13,12,20.296,31,20.762,34.427,10,21,6,13,14,0,31.596,1,281.25,1,28.0,46.7,20,0.097,2,30,9.375
5.321,0,13,12,19.875,30,20.009,32.495,10,20,6,15,13,0,30.047,3,258.25,0,29.0,44.8,19,0.133,4,29,8.905
4.487,0,14,12,21.938,33,21.327,35.618,13,20,4,14,15,0,32.385,2,255.29,1,28.0,46.9,19,0.121,3,32,7.978
4.821,0,13,12,20.296,31,20.762,34.427,10,21,6,13,14,0,31.596,1,281.25,1,28.0,46.7,20,0.097,2,30,9.375
4.575,0,13,12,20.938,32,20.327,34.618,13,19,4,13,14,0,31.385,1,243.28,1,26.0,45.2,18,0.125,3,31,7.848
4.714,0,13,12,19.875,30,20.009,32.495,10,20,6,15,13,0,30.047,3,258.25,0,29.0,44.8,19,0.133,4,29,8.905
4.437,0,14,12,21.938,33,21.327,35.618,13,20,4,14,15,0,32.385,2,255.29,1,28.0,46.9,19,0.121,3,32,7.978
5.144,0,13,12,19.58,28,18.913,29.937,10,18,4,13,13,1,27.498,1,247.69,0,25.0,48.1,17,0.107,2,27,9.174
4.818,0,13,12,20.938,32,20.327,34.618,13,19,4,13,14,0,31.385,1,243.28,1,26.0,45.2,18,0.125,3,31,7.848
4.64,0,13,12,20.483,31,19.612,33.408,13,18,3,13,14,0,30.058,1,227.28,1,25.0,46.7,17,0.097,2,30,7.576
4.0,0,14,12,20.631,31,20.515,33.412,11,20,5,14,14,0,30.829,2,257.26,0,28.0,46.7,19,0.129,4,30,8.575
4.701,0,14,12,20.631,31,20.515,33.412,11,20,5,14,14,0,30.829,2,257.26,0,28.0,46.7,19,0.129,4,30,8.575
4.987,0,13,12,22.245,34,21.139,36.824,15,19,3,13,15,0,32.942,1,241.31,2,26.0,45.5,18,0.088,2,33,7.312
5.193,0,15,12,23.847,36,23.756,39.037,13,23,6,15,16,0,36.04,3,299.3,1,32.0,45.7,22,0.139,5,35,8.551
5.362,0,13,12,21.449,33,22.686,36.929,9,24,9,15,14,0,34.469,3,326.25,1,33.0,43.8,23,0.121,4,32,10.195
5.255,0,13,12,22.091,34,22.251,37.12,12,22,7,15,14,0,34.258,3,288.28,1,31.0,42.4,21,0.147,5,33,8.736
5.75,0,13,12,21.903,34,23.401,38.139,9,25,10,15,14,0,35.796,3,342.25,1,34.0,42.4,24,0.147,5,33,10.371
4.717,0,13,12,21.87,34,23.438,38.862,9,25,9,13,15,0,36.018,1,349.25,2,32.0,45.5,24,0.088,2,33,10.583
4.25,0,13,12,23.154,36,22.568,39.242,15,21,5,13,15,0,35.596,1,273.31,2,28.0,42.9,20,0.139,4,35,7.809
4.351,0,13,12,22.245,34,21.139,36.824,15,19,3,13,15,0,32.942,1,241.31,2,26.0,45.5,18,0.088,2,33,7.312
4.0,0,15,12,22.54,34,22.944,36.831,11,23,7,15,15,0,34.484,3,301.27,0,32.0,45.5,22,0.147,6,33,9.129
4.955,0,13,12,20.296,31,20.762,34.427,10,21,6,13,14,0,31.596,1,281.25,1,28.0,46.7,20,0.097,2,30,9.375
4.533,0,13,12,20.938,32,20.327,34.618,13,19,4,13,14,0,31.385,1,243.28,1,26.0,45.2,18,0.125,3,31,7.848
4.0,0,13,12,19.875,30,20.009,32.495,10,20,6,15,13,0,30.047,3,258.25,0,29.0,44.8,19,0.133,4,29,8.905
4.074,0,13,12,20.938,32,20.327,34.618,13,19,4,13,14,0,31.385,1,243.28,1,26.0,45.2,18,0.125,3,31,7.848
4.668,0,13,12,20.483,31,19.612,33.408,13,18,3,13,14,0,30.058,1,227.28,1,25.0,46.7,17,0.097,2,30,7.576
4.955,0,13,12,19.875,30,20.009,32.495,10,20,6,15,13,0,30.047,3,258.25,0,29.0,44.8,19,0.133,4,29,8.905
4.611,0,14,12,21.938,33,21.327,35.618,13,20,4,14,15,0,32.385,2,255.29,1,28.0,46.9,19,0.121,3,32,7.978
4.699,0,13,12,19.58,28,18.913,29.937,10,18,4,13,13,1,27.498,1,247.69,0,25.0,48.1,17,0.107,2,27,9.174
4.523,0,13,12,20.074,28,19.11,29.835,10,18,4,13,13,1,27.404,1,292.14,0,25.0,48.1,17,0.107,2,27,10.82
4.64,0,13,12,20.938,32,20.327,34.618,13,19,4,13,14,0,31.385,1,243.28,1,26.0,45.2,18,0.125,3,31,7.848
4.317,0,13,12,20.483,31,19.612,33.408,13,18,3,13,14,0,30.058,1,227.28,1,25.0,46.7,17,0.097,2,30,7.576
4.987,0,13,12,25.767,40,24.192,43.654,19,21,3,13,17,0,38.709,1,269.37,4,28.0,43.6,20,0.1,2,39,6.907
4.228,0,13,12,22.091,34,22.251,37.12,12,22,7,15,14,0,34.258,3,288.28,1,31.0,42.4,21,0.147,5,33,8.736
4.307,0,13,12,22.245,34,21.139,36.824,15,19,3,13,15,0,32.942,1,241.31,2,26.0,45.5,18,0.088,2,33,7.312
4.156,0,13,12,23.154,36,22.568,39.242,15,21,5,13,15,0,35.596,1,273.31,2,28.0,42.9,20,0.139,4,35,7.809
5.893,0,13,12,20.938,32,20.327,34.618,13,19,4,13,14,0,31.385,1,243.28,1,26.0,45.2,18,0.125,3,31,7.848
6.292,0,13,12,19.875,30,20.009,32.495,10,20,6,15,13,0,30.047,3,258.25,0,29.0,44.8,19,0.133,4,29,8.905
5.81,0,14,12,21.938,33,21.327,35.618,13,20,4,14,15,0,32.385,2,255.29,1,28.0,46.9,19,0.121,3,32,7.978
6.398,0,14,12,21.938,33,21.327,35.618,13,20,4,14,15,0,32.385,2,255.29,1,28.0,46.9,19,0.121,3,32,7.978
6.387,0,13,12,19.58,28,18.913,29.937,10,18,4,13,13,1,27.498,1,247.69,0,25.0,48.1,17,0.107,2,27,9.174
5.836,0,13,12,20.483,31,19.612,33.408,13,18,3,13,14,0,30.058,1,227.28,1,25.0,46.7,17,0.097,2,30,7.576
5.971,0,13,12,25.767,40,24.192,43.654,19,21,3,13,17,0,38.709,1,269.37,4,28.0,43.6,20,0.1,2,39,6.907
5.487,0,14,12,20.631,31,20.515,33.412,11,20,5,14,14,0,30.829,2,257.26,0,28.0,46.7,19,0.129,4,30,8.575
6.036,0,13,12,22.091,34,22.251,37.12,12,22,7,15,14,0,34.258,3,288.28,1,31.0,42.4,21,0.147,5,33,8.736
5.469,0,13,12,23.154,36,22.568,39.242,15,21,5,13,15,0,35.596,1,273.31,2,28.0,42.9,20,0.139,4,35,7.809
5.627,0,13,12,22.245,34,21.139,36.824,15,19,3,13,15,0,32.942,1,241.31,2,26.0,45.5,18,0.088,2,33,7.312
6.658,0,13,12,22.512,35,23.003,39.052,12,23,7,13,15,0,35.807,1,311.28,2,30.0,44.1,22,0.114,3,34,9.155
5.827,0,13,12,20.938,32,20.327,34.618,13,19,4,13,14,0,31.385,1,243.28,1,26.0,45.2,18,0.125,3,31,7.848
5.62,0,13,12,23.154,36,22.568,39.242,15,21,5,13,15,0,35.596,1,273.31,2,28.0,42.9,20,0.139,4,35,7.809
6.721,0,13,12,22.091,34,22.251,37.12,12,22,7,15,14,0,34.258,3,288.28,1,31.0,42.4,21,0.147,5,33,8.736
6.553,0,13,12,21.796,32,21.154,34.562,12,20,5,13,14,1,31.709,1,277.72,1,27.0,45.2,19,0.125,3,31,8.959
5.833,0,13,12,23.154,36,22.568,39.242,15,21,5,13,15,0,35.596,1,273.31,2,28.0,42.9,20,0.139,4,35,7.809
6.06,0,13,12,22.699,35,21.853,38.033,15,20,4,13,15,0,34.269,1,257.31,2,27.0,44.1,19,0.114,3,34,7.568
5.077,0,14,12,22.847,35,22.756,38.037,13,22,6,14,15,0,35.04,2,287.29,1,30.0,44.1,21,0.143,5,34,8.45
6.721,0,13,12,22.091,34,22.251,37.12,12,22,7,15,14,0,34.258,3,288.28,1,31.0,42.4,21,0.147,5,33,8.736
6.569,0,14,12,24.154,37,23.568,40.242,15,22,5,14,16,0,36.596,2,285.32,2,30.0,44.4,21,0.135,4,36,7.926
6.538,0,13,12,21.796,32,21.154,34.562,12,20,5,13,14,1,31.709,1,277.72,1,27.0,45.2,19,0.125,3,31,8.959
6.268,0,13,12,22.29,32,21.352,34.459,12,20,5,13,14,1,31.614,1,322.17,1,27.0,45.2,19,0.125,3,31,10.393
6.041,0,13,12,23.154,36,22.568,39.242,15,21,5,13,15,0,35.596,1,273.31,2,28.0,42.9,20,0.139,4,35,7.809
5.955,0,13,12,22.699,35,21.853,38.033,15,20,4,13,15,0,34.269,1,257.31,2,27.0,44.1,19,0.114,3,34,7.568
4.807,0,14,12,22.619,32,23.133,34.886,8,24,9,16,14,1,33.116,4,383.14,0,34.0,45.2,23,0.125,5,31,12.359
4.318,0,14,12,20.631,31,20.515,33.412,11,20,5,14,14,0,30.829,2,257.26,0,28.0,46.7,19,0.097,4,30,8.575
4.299,0,14,12,21.489,31,21.342,33.356,10,21,6,14,14,1,31.153,2,291.7,0,29.0,46.7,20,0.097,4,30,9.723
4.523,0,14,12,25.063,39,24.998,42.661,15,24,7,14,16,0,39.251,2,317.32,2,32.0,42.1,23,0.128,6,38,8.351
4.381,0,14,12,21.784,33,22.439,35.914,10,23,8,16,14,0,33.702,4,302.26,0,33.0,43.8,22,0.121,6,32,9.446
4.201,0,14,12,21.983,31,21.54,33.254,10,21,6,14,14,1,31.058,2,336.15,0,29.0,46.7,20,0.097,4,30,11.205
4.767,0,14,12,25.506,37,24.593,40.084,14,23,6,14,16,1,36.825,2,364.21,2,31.0,44.4,22,0.135,4,36,10.117
5.31,0,14,12,29.029,43,27.647,46.914,18,25,6,14,18,1,42.593,2,392.27,4,33.0,42.9,24,0.163,4,42,9.34
5.187,0,14,12,28.83,45,28.546,49.575,18,27,8,16,18,0,45.236,4,358.38,4,37.0,40.9,26,0.178,6,44,8.145
4.523,1,13,12,26.563,40,25.282,43.578,17,23,6,15,16,1,39.556,3,319.41,3,32.0,41.0,22,0.15,4,39,8.19
4.523,1,13,12,30.182,45,28.636,47.937,18,27,7,15,18,2,43.764,3,379.89,5,36.0,41.9,25,0.089,4,43,8.835
4.523,1,13,12,30.182,45,28.636,47.937,18,27,7,15,18,2,43.764,3,379.89,5,36.0,41.9,25,0.089,4,43,8.835
4.523,1,15,16,31.324,48,29.809,49.993,19,29,6,19,20,1,45.44,3,369.47,5,40.0,44.4,26,0.063,4,45,8.21
4.523,1,19,18,36.847,56,34.862,58.823,23,33,6,21,24,1,53.207,3,421.55,5,45.0,45.3,30,0.089,4,53,7.954
4.523,1,14,12,28.261,43,27.492,45.87,16,27,8,16,17,1,42.102,4,360.42,3,37.0,41.5,25,0.093,5,41,8.791
4.523,1,13,17,27.392,42,26.358,43.906,15,27,8,19,16,1,39.658,2,341.43,3,37.5,41.0,24,0.071,2,39,8.755
4.523,1,13,12,26.352,40,25.062,42.451,16,24,6,15,16,1,38.447,3,316.41,3,33.0,42.1,22,0.075,3,38,8.327
4.523,1,13,12,33.091,52,31.357,54.906,22,30,7,15,20,1,49.425,3,386.51,7,39.0,40.8,27,0.058,4,49,7.888
4.523,2,13,12,34.284,52,31.829,54.617,22,30,7,15,20,2,49.174,3,402.58,7,39.0,40.8,27,0.058,3,49,8.216
4.523,1,13,12,34.404,54,32.191,58.61,25,29,7,15,20,1,52.083,3,387.55,7,38.0,38.5,27,0.111,3,52,7.453
4.523,1,13,12,28.114,43,26.589,45.866,18,25,6,15,17,1,41.331,3,330.44,4,34.0,41.5,23,0.07,3,41,8.06
4.523,1,13,12,29.875,46,28.116,49.282,20,26,6,15,18,1,44.214,3,344.47,5,35.0,40.9,24,0.065,3,44,7.829
4.523,1,13,12,34.091,54,32.357,55.906,22,32,7,15,21,1,50.425,3,398.52,8,41.0,42.0,28,0.056,4,50,7.97
4.523,1,18,18,36.642,56,34.664,59.195,23,33,7,21,23,1,53.2,3,421.56,5,45.0,43.4,30,0.107,3,53,7.954
4.523,1,13,12,30.875,48,29.116,50.282,20,28,6,15,19,1,45.214,3,356.48,6,37.0,42.2,25,0.063,3,45,7.922
5.523,1,11,11,26.563,41,25.282,43.578,17,24,6,14,16,1,39.556,3,319.41,5,32.5,41.0,22,0.073,4,39,8.19
4.523,1,11,11,26.563,41,25.282,43.578,17,24,6,14,16,1,39.556,3,319.41,5,32.5,41.0,22,0.073,4,39,8.19
4.523,1,11,11,24.801,38,23.755,40.162,15,23,6,14,15,1,36.673,3,305.38,4,31.5,41.7,21,0.079,4,36,8.483
4.523,1,14,16,22.523,33,22.196,34.415,10,23,7,19,14,1,32.124,3,302.33,0,34.0,45.2,21,0.091,4,31,9.753
4.523,1,14,17,29.301,45,28.787,47.325,15,30,10,20,17,1,43.313,3,385.44,3,41.5,40.5,27,0.089,4,42,9.177
4.523,1,13,12,26.955,41,26.68,43.664,14,27,9,17,16,1,40.545,5,362.39,3,38.0,41.0,25,0.098,6,39,9.292
4.523,1,13,12,25.739,39,25.139,41.502,14,25,7,15,16,1,38.185,3,335.38,3,34.0,43.2,23,0.077,4,37,9.064
4.523,1,13,12,26.659,39,25.583,41.106,14,25,7,15,16,2,37.996,3,351.83,3,34.0,43.2,23,0.077,4,37,9.509
4.523,1,13,12,27.154,39,25.781,41.004,14,25,7,15,16,2,37.902,3,396.28,3,34.0,43.2,23,0.077,4,37,10.71
4.523,1,13,12,28.46,39,26.072,40.883,14,25,7,15,16,2,37.742,3,443.28,3,34.0,43.2,23,0.077,4,37,11.981
4.523,1,13,12,27.046,40,26.25,42.245,14,26,7,16,17,1,38.891,3,342.4,3,37.0,44.7,24,0.075,4,38,9.011
4.523,1,13,12,28.017,43,26.997,45.787,17,26,7,15,17,1,41.884,3,347.42,4,35.0,41.5,24,0.093,5,41,8.474
4.917,1,13,12,26.659,39,25.583,41.106,14,25,7,15,16,2,37.996,3,351.83,3,34.0,43.2,23,0.077,4,37,9.509
4.523,1,13,12,30.233,47,29.239,50.412,19,28,8,15,18,1,46.094,3,377.45,5,37.0,40.0,26,0.106,6,45,8.388
4.523,1,12,12,25.046,38,24.25,40.245,14,24,7,15,15,1,36.891,3,318.38,3,33.0,41.7,22,0.079,4,36,8.844
4.523,1,13,12,24.739,37,24.139,40.502,14,23,7,15,15,1,37.185,3,323.37,2,32.0,41.7,22,0.162,4,36,8.982
4.523,1,13,12,25.659,37,24.583,40.106,14,23,7,15,15,2,36.996,3,339.82,2,32.0,41.7,22,0.162,4,36,9.439
4.523,1,13,12,25.659,37,24.583,40.106,14,23,7,15,15,2,36.996,3,339.82,2,32.0,41.7,22,0.162,4,36,9.439
4.523,1,13,12,27.017,41,25.997,44.787,17,24,7,15,16,1,40.884,3,335.41,3,33.0,40.0,23,0.171,5,40,8.385
4.523,1,13,12,27.017,41,25.997,44.787,17,24,7,15,16,1,40.884,3,335.41,3,33.0,40.0,23,0.171,5,40,8.385
4.523,1,19,18,32.779,49,31.524,52.202,19,30,7,21,21,1,47.767,3,397.48,2,42.0,44.7,28,0.163,5,47,8.457
4.523,1,13,12,26.563,40,25.282,43.578,17,23,6,15,16,1,39.556,3,319.41,3,32.0,41.0,22,0.15,4,39,8.19
4.523,1,13,12,25.801,39,24.755,41.162,15,24,6,15,16,1,37.673,3,317.39,3,33.0,43.2,22,0.077,4,37,8.578
4.523,1,17,17,26.04,38,25.229,39.747,13,25,6,20,17,1,36.789,3,327.38,0,36.5,47.2,23,0.105,4,36,9.094
4.523,1,15,16,24.631,34,23.727,35.174,10,24,7,19,15,2,33.135,3,380.23,0,35.0,46.9,22,0.088,4,32,11.882
4.523,1,13,12,27.563,42,26.282,44.578,17,25,6,15,17,1,40.556,3,331.42,4,34.0,42.5,23,0.071,4,40,8.285
4.523,1,13,12,27.563,42,26.282,44.578,17,25,6,15,17,1,40.556,3,331.42,4,34.0,42.5,23,0.071,4,40,8.285
4.523,1,13,12,26.807,41,25.777,43.661,16,25,7,15,16,1,39.774,3,332.41,3,34.0,41.0,23,0.073,4,39,8.523
4.523,1,13,12,26.955,41,26.68,43.664,14,27,9,17,16,1,40.545,5,362.39,3,38.0,41.0,25,0.098,6,39,9.292
5.031,1,13,12,26.659,39,25.583,41.106,14,25,7,15,16,2,37.996,3,351.83,3,34.0,43.2,23,0.077,4,37,9.509
4.523,1,13,12,27.154,39,25.781,41.004,14,25,7,15,16,2,37.902,3,396.28,3,34.0,43.2,23,0.077,4,37,10.71
4.523,1,13,12,28.46,39,26.072,40.883,14,25,7,15,16,2,37.742,3,443.28,3,34.0,43.2,23,0.077,4,37,11.981
4.523,1,13,12,26.256,40,25.47,42.372,15,25,7,15,16,1,39.0,3,333.39,3,34.0,42.1,23,0.075,5,38,8.773
4.523,1,13,12,28.017,43,26.997,45.787,17,26,7,15,17,1,41.884,3,347.42,4,35.0,41.5,24,0.093,5,41,8.474
4.523,1,13,12,27.563,42,26.282,44.578,17,25,6,15,17,1,40.556,3,331.42,4,34.0,42.5,23,0.071,4,40,8.285
4.523,1,13,12,26.955,41,26.68,43.664,14,27,9,17,16,1,40.545,5,362.39,3,38.0,41.0,25,0.098,6,39,9.292
4.523,1,13,12,27.046,40,26.25,42.245,14,26,7,16,17,1,38.891,3,342.4,3,37.0,44.7,24,0.075,4,38,9.011
4.523,1,13,12,26.659,39,25.583,41.106,14,25,7,15,16,2,37.996,3,351.83,3,34.0,43.2,23,0.077,4,37,9.509
4.523,1,13,12,27.154,39,25.781,41.004,14,25,7,15,16,2,37.902,3,396.28,3,34.0,43.2,23,0.077,4,37,10.71
4.523,1,13,12,28.46,39,26.072,40.883,14,25,7,15,16,2,37.742,3,443.28,3,34.0,43.2,23,0.077,4,37,11.981
4.523,1,13,12,26.256,40,25.47,42.372,15,25,7,15,16,1,39.0,3,333.39,3,34.0,42.1,23,0.075,5,38,8.773
4.523,1,13,12,28.017,43,26.997,45.787,17,26,7,15,17,1,41.884,3,347.42,4,35.0,41.5,24,0.093,5,41,8.474
4.523,1,13,12,27.563,42,26.282,44.578,17,25,6,15,17,1,40.556,3,331.42,4,34.0,42.5,23,0.071,4,40,8.285
4.523,1,13,12,27.801,41,26.755,43.162,15,26,6,16,18,1,39.673,3,341.41,3,37.0,46.2,24,0.073,4,39,8.754
4.523,1,19,18,37.352,56,37.2,59.636,18,38,10,22,25,1,55.189,3,501.51,4,52.0,47.2,35,0.071,5,53,9.462
4.523,1,9,6,21.04,32,20.229,34.747,13,19,6,10,12,1,31.789,4,267.33,3,26.0,38.7,18,0.094,4,31,8.624
4.523,2,11,11,24.688,36,23.416,37.667,13,23,7,14,14,2,34.865,3,323.42,3,31.5,41.2,21,0.083,4,34,9.512
4.523,1,13,12,24.04,36,23.229,37.747,13,23,6,15,15,1,34.789,3,303.36,2,32.0,44.1,21,0.083,4,34,8.922
4.237,0,14,12,21.182,32,20.821,34.701,12,20,5,14,14,0,31.604,2,256.28,0,28.0,45.2,19,0.094,3,31,8.267
4.398,0,13,16,22.733,35,22.128,36.99,13,22,5,17,15,0,33.378,1,267.31,2,31.0,45.5,20,0.086,2,33,8.1
4.672,0,14,12,21.08,32,21.208,33.123,10,22,5,14,15,0,31.055,2,270.25,1,30.0,50.0,20,0.094,5,30,9.008
4.74,0,11,6,23.154,36,22.568,39.242,15,21,5,10,15,0,35.596,4,273.31,4,28.0,42.9,20,0.111,4,35,7.809
4.184,1,16,16,33.642,50,32.373,53.644,19,31,9,20,20,2,49.193,4,434.93,4,43.0,41.7,29,0.1,5,48,9.061
6.824,0,13,12,19.58,28,18.913,29.937,10,18,4,13,13,1,27.498,1,247.69,0,25.0,48.1,17,0.107,2,27,9.174
4.39,0,16,16,30.534,46,29.449,49.017,18,28,6,18,20,1,44.687,2,371.84,4,38.0,45.5,26,0.087,4,44,8.451
4.345,0,16,16,30.131,47,29.337,50.282,19,28,6,18,20,0,45.691,2,353.4,4,38.0,44.4,26,0.106,5,45,7.853
4.447,0,16,16,29.489,46,29.772,50.092,16,30,8,18,20,0,45.902,2,391.37,4,40.0,45.5,28,0.087,4,44,8.895
4.71,0,16,16,29.489,46,29.772,50.092,16,30,8,18,20,0,45.902,2,391.37,4,40.0,45.5,28,0.087,4,44,8.895
5.208,0,16,16,26.494,39,26.064,41.317,13,26,6,18,18,1,38.105,2,345.77,2,36.0,48.6,24,0.077,3,37,9.345
5.106,0,16,16,27.21,42,27.913,45.807,13,29,8,18,19,0,42.203,2,379.33,3,39.0,47.5,27,0.071,3,40,9.483
4.361,0,16,16,31.438,49,30.149,52.488,21,28,5,18,21,0,47.247,2,351.43,5,38.0,44.7,26,0.102,4,47,7.477
4.0,0,16,16,31.25,49,31.299,53.507,18,31,8,18,21,0,48.785,2,405.4,5,41.0,44.7,29,0.102,4,47,8.626
4.0,0,16,16,31.892,50,30.863,53.697,21,29,6,18,21,0,48.574,2,367.43,5,39.0,43.8,27,0.12,5,48,7.655
4.092,1,16,16,33.455,50,33.523,54.664,16,34,12,20,20,2,50.731,4,488.9,4,46.0,41.7,32,0.1,5,48,10.185
4.868,0,16,16,28.256,42,27.591,44.732,15,27,6,18,19,1,40.989,2,359.8,3,37.0,47.5,25,0.095,3,40,8.995
4.62,0,15,16,25.102,37,23.966,38.768,14,23,4,17,17,1,35.265,1,299.77,2,32.0,48.6,21,0.054,2,35,8.565
4.0,0,16,16,28.773,43,27.923,45.602,16,27,6,18,19,1,41.804,2,357.81,3,37.0,46.3,25,0.116,4,41,8.727
4.0,0,16,16,26.091,40,25.952,42.582,14,26,6,18,18,0,39.109,2,327.33,2,36.0,47.4,24,0.1,4,38,8.614
4.0,0,16,16,27.727,43,28.245,46.677,14,29,8,18,19,0,43.018,2,377.34,3,39.0,46.3,27,0.093,4,41,9.203
4.0,0,16,16,27.727,43,28.245,46.677,14,29,8,18,19,0,43.018,2,377.34,3,39.0,46.3,27,0.093,4,41,9.203
4.634,0,16,16,24.733,36,24.537,37.901,11,25,6,18,17,1,35.222,2,331.74,1,35.0,50.0,23,0.083,3,34,9.757
4.778,1,16,16,31.881,47,30.846,50.229,17,30,9,20,19,2,46.309,4,420.9,3,42.0,42.2,28,0.106,5,45,9.353
4.3,1,16,16,31.693,47,31.996,51.248,14,33,12,20,19,2,47.847,4,474.87,3,45.0,42.2,31,0.106,5,45,10.553
4.369,1,22,22,39.403,58,37.899,61.06,21,37,9,26,25,2,56.076,4,497.0,3,52.0,45.5,34,0.103,5,55,9.036
4.774,1,26,27,42.403,62,40.899,64.06,21,41,9,31,28,2,59.076,4,533.03,2,58.5,48.3,37,0.097,5,58,9.19
4.816,1,22,22,39.403,58,37.899,61.06,21,37,9,26,25,2,56.076,4,497.0,3,52.0,45.5,34,0.103,5,55,9.036
4.418,1,22,22,39.216,58,39.049,62.079,18,40,12,26,25,2,57.614,4,550.97,3,55.0,45.5,37,0.103,5,55,10.018
4.226,1,22,22,39.67,59,39.764,63.288,18,41,13,26,25,2,58.942,4,566.97,3,56.0,44.6,38,0.119,6,56,10.124
4.821,2,20,21,37.386,52,35.86,54.093,16,36,11,25,22,4,50.709,4,523.44,2,50.5,44.9,33,0.115,5,49,10.682
4.762,1,23,22,40.858,60,39.614,63.269,21,39,10,27,26,2,58.404,5,525.01,3,55.0,45.6,36,0.117,6,57,9.211
5.102,1,22,22,42.926,64,40.953,67.89,25,39,9,26,27,2,61.843,4,525.06,5,54.0,44.3,36,0.109,5,61,8.608
4.399,1,22,22,39.858,59,38.614,62.269,21,38,10,26,25,2,57.404,4,513.0,3,53.0,44.6,35,0.119,6,56,9.161
4.399,1,22,22,37.58,55,36.756,57.984,18,37,10,26,24,2,53.705,4,500.96,2,52.0,46.2,34,0.109,5,52,9.634
4.482,1,22,22,38.886,56,37.867,58.728,18,38,10,27,25,2,54.411,4,507.98,2,55.0,47.2,35,0.107,5,53,9.585
4.399,1,22,22,38.994,55,37.398,57.486,18,37,10,26,24,3,53.422,4,561.86,2,52.0,46.2,34,0.109,5,52,10.805
4.716,1,22,22,40.79,61,41.726,66.513,17,44,15,26,26,2,62.036,4,618.97,4,59.0,44.8,41,0.098,5,58,10.672
4.0,0,10,10,22.154,35,21.568,38.242,15,20,5,12,14,0,34.596,2,261.3,4,27.0,41.2,19,0.114,4,34,7.685
4.0,0,10,10,23.915,38,23.095,41.658,17,21,5,12,15,0,37.48,2,275.33,5,28.0,40.5,20,0.132,4,37,7.441
4.84,0,16,16,30.534,46,29.449,49.017,18,28,6,18,20,1,44.687,2,371.84,4,38.0,45.5,26,0.109,4,44,8.451
4.305,0,16,16,32.296,49,30.976,52.432,20,29,6,18,21,1,47.571,2,385.87,5,39.0,44.7,27,0.122,4,47,8.21
5.008,0,16,16,34.057,52,32.503,55.847,22,30,6,18,22,1,50.454,2,399.9,6,40.0,44.0,28,0.096,4,50,7.998
4.911,0,16,16,32.296,49,30.976,52.432,20,29,6,18,21,1,47.571,2,385.87,5,39.0,44.7,27,0.102,4,47,8.21
4.032,1,16,16,35.404,53,33.899,57.06,21,32,9,20,21,2,52.076,4,448.96,5,44.0,41.2,30,0.113,5,51,8.803
4.912,1,22,22,42.926,64,40.953,67.89,25,39,9,26,27,2,61.843,4,525.06,5,54.0,44.3,36,0.109,5,61,8.608
4.141,1,26,27,45.926,68,43.953,70.89,25,43,9,31,30,2,64.843,4,561.09,4,60.5,46.9,39,0.103,5,64,8.767
4.675,1,22,22,42.926,64,40.953,67.89,25,39,9,26,27,2,61.843,4,525.06,5,54.0,44.3,36,0.109,5,61,8.608
4.472,1,22,22,42.739,64,42.103,68.909,22,42,12,26,27,2,63.382,4,579.03,5,57.0,44.3,39,0.109,5,61,9.492
4.393,1,22,22,43.193,65,42.818,70.119,22,43,13,26,27,2,64.709,4,595.03,5,58.0,43.5,40,0.123,6,62,9.597
4.563,1,23,22,44.381,66,42.668,70.099,25,41,10,27,28,2,64.171,5,553.07,5,57.0,44.4,38,0.121,6,63,8.779
4.257,1,22,22,46.449,70,44.007,74.72,29,41,9,26,29,2,67.611,4,553.12,7,56.0,43.3,38,0.114,5,67,8.256
4.27,0,16,16,31.534,48,30.449,50.017,18,30,6,18,21,1,45.687,2,383.85,5,40.0,46.7,27,0.063,4,45,8.53
4.0,0,16,16,32.25,51,32.299,54.507,18,33,8,18,22,0,49.785,2,417.41,6,43.0,45.8,30,0.059,4,48,8.696
4.0,1,16,16,36.403,55,34.899,58.06,21,34,9,20,22,2,53.076,4,460.97,6,46.0,42.3,31,0.073,5,52,8.865
4.317,0,16,16,31.534,48,30.449,50.017,18,30,6,18,21,1,45.687,2,383.85,5,40.0,46.7,27,0.063,4,45,8.53
4.523,1,7,6,28.637,46,26.642,49.697,22,24,6,9,16,1,44.098,3,322.47,9,30.0,36.4,22,0.065,3,44,7.329
4.523,1,7,6,28.637,46,26.642,49.697,22,24,6,9,16,1,44.098,3,322.47,9,30.0,36.4,22,0.065,3,44,7.329
4.523,1,7,6,28.637,46,26.642,49.697,22,24,6,9,16,1,44.098,3,322.47,9,30.0,36.4,22,0.065,3,44,7.329
4.523,1,7,6,28.637,46,26.642,49.697,22,24,6,9,16,1,44.098,3,322.47,9,30.0,36.4,22,0.065,3,44,7.329
4.523,1,7,6,30.398,49,28.169,53.112,24,25,6,9,17,1,46.982,3,336.5,10,31.0,36.2,23,0.061,3,47,7.16
4.523,1,7,6,27.33,44,25.83,47.491,20,24,7,9,15,1,42.542,3,324.44,8,30.0,35.7,22,0.068,4,42,7.725
4.523,1,7,6,27.33,44,25.83,47.491,20,24,7,9,15,1,42.542,3,324.44,8,30.0,35.7,22,0.068,4,42,7.725
4.523,1,7,6,26.875,43,25.116,46.282,20,23,6,9,15,1,41.214,3,308.44,8,29.0,36.6,21,0.07,3,41,7.523
4.523,1,7,6,30.398,49,28.169,53.112,24,25,6,9,17,1,46.982,3,336.5,10,31.0,36.2,23,0.061,3,47,7.16
4.523,1,6,6,27.881,45,26.137,48.78,21,24,7,9,15,1,43.316,3,323.46,9,30.0,34.9,22,0.067,3,43,7.522
4.523,1,7,6,31.159,50,28.696,55.527,26,24,6,9,17,1,48.865,3,338.52,10,30.0,34.7,23,0.08,3,49,6.909
4.523,2,6,6,29.739,47,27.544,50.826,22,25,8,10,15,2,45.502,4,358.53,9,32.0,33.3,23,0.064,4,45,7.967
4.129,1,15,12,26.148,36,24.759,38.506,13,23,6,16,16,2,35.8,4,381.26,1,33.0,45.7,22,0.111,4,35,10.893
4.114,0,15,12,27.063,42,26.699,46.124,17,25,6,14,18,0,42.102,2,332.35,3,33.0,43.9,24,0.143,5,41,8.106
4.616,0,19,17,29.671,45,28.6,47.574,18,27,4,19,21,0,43.262,2,334.39,2,37.5,48.8,25,0.111,4,43,7.777
4.385,1,15,12,23.887,34,22.304,36.245,14,20,3,14,16,1,32.916,2,270.37,1,28.0,48.5,19,0.118,2,33,8.193
4.599,1,16,12,27.256,40,26.47,43.372,15,25,7,17,17,1,40.0,5,345.4,1,36.0,43.6,24,0.125,5,39,8.856
4.564,1,15,12,24.744,34,23.132,36.189,13,21,4,14,16,2,33.24,2,304.81,1,29.0,48.5,20,0.118,2,33,9.237
4.57,1,15,12,25.653,36,24.561,38.608,13,23,6,16,16,2,35.895,4,336.81,1,33.0,45.7,22,0.111,4,35,9.623
4.682,1,15,12,24.744,34,23.132,36.189,13,21,4,14,16,2,33.24,2,304.81,1,29.0,48.5,20,0.118,2,33,9.237
4.636,1,15,12,25.653,36,24.561,38.608,13,23,6,16,16,2,35.895,4,336.81,1,33.0,45.7,22,0.111,4,35,9.623
6.42,0,13,12,20.483,31,19.612,33.408,13,18,3,13,14,0,30.058,1,227.28,1,25.0,46.7,17,0.097,2,30,7.576
5.503,0,13,12,20.296,31,20.762,34.427,10,21,6,13,14,0,31.596,1,281.25,1,28.0,46.7,20,0.097,2,30,9.375
6.357,0,13,12,18.722,28,18.085,29.993,11,17,3,13,13,0,27.174,1,213.25,0,24.0,48.1,16,0.107,2,27,7.898
5.222,0,15,12,24.909,38,24.074,41.159,16,22,4,14,17,0,37.378,2,284.33,2,30.0,45.9,21,0.158,4,37,7.685
5.706,0,13,12,19.523,27,18.804,28.546,9,18,4,13,13,1,26.629,1,293.12,0,25.0,50.0,17,0.074,3,26,11.274
5.381,0,14,12,20.631,31,20.515,33.412,11,20,5,14,14,0,30.829,2,257.26,0,28.0,46.7,19,0.129,4,30,8.575
4.185,0,13,12,23.034,36,21.918,36.697,14,22,3,13,16,0,32.833,1,250.32,3,29.0,48.5,19,0.028,1,33,7.585
7.06,0,13,12,19.523,27,18.804,28.546,9,18,4,13,13,1,26.629,1,293.12,0,25.0,50.0,17,0.074,3,26,11.274
4.463,1,15,12,24.796,36,23.734,38.664,14,22,5,16,16,1,35.571,4,302.37,1,32.0,45.7,21,0.111,4,35,8.639
4.351,1,15,12,24.733,36,24.117,39.004,13,23,6,16,16,1,36.084,4,320.36,1,33.0,45.7,22,0.111,4,35,9.153
7.086,0,7,6,13.352,16,12.775,17.557,4,12,5,7,7,2,17.091,1,295.91,0,16.0,43.8,12,0.063,3,16,18.494
7.155,0,7,6,12.364,16,12.38,17.762,4,12,5,7,7,2,17.28,1,207.01,0,16.0,43.8,12,0.063,3,16,12.938
4.745,0,4,0,20.216,33,18.886,37.365,18,15,3,3,12,0,32.934,3,210.3,8,18.0,36.4,15,0.152,3,33,6.373
4.0,0,16,16,27.011,40,26.396,42.186,14,26,6,18,18,1,38.92,2,343.78,2,36.0,47.4,24,0.1,4,38,9.047
5.058,0,13,12,22.199,31,21.267,33.296,11,20,5,13,14,2,30.705,1,296.16,1,27.0,46.7,19,0.097,2,30,9.872
4.488,0,13,12,21.176,32,20.501,34.665,13,19,3,13,15,0,31.353,1,244.28,2,26.0,48.4,18,0.094,2,31,7.88
4.125,0,16,16,28.773,43,27.923,45.602,16,27,6,18,19,1,41.804,2,357.81,3,37.0,46.3,25,0.093,4,41,8.727
5.157,0,13,12,22.245,34,21.139,36.824,15,19,3,13,15,0,32.942,1,241.31,2,26.0,45.5,18,0.088,2,33,7.312
5.387,0,5,0,38.762,65,35.815,69.896,34,31,4,4,24,0,61.33,4,386.58,19,35.0,38.7,28,0.046,4,62,6.235
4.0,0,16,16,30.534,46,29.449,49.017,18,28,6,18,20,1,44.687,2,371.84,4,38.0,45.5,26,0.109,4,44,8.451
