pXC50,nCsp3,nC,MW,RBN,nSK,Se,SCBO,nAT,Si,nBT,nDB,Sp,Sv,nCsp2,nBO,nHet,nH,nCsp,nTB
5.3,1,21,377.47,4,27,43.407,42.5,43,47.87,46,1,31.387,30.037,20,30,6,16,0,0
7.546,1,20,346.84,4,25,40.033,39.5,40,44.428,43,0,29.449,28.074,19,28,5,15,0,0
6.0,5,21,448.39,9,30,53.647,41.0,53,59.95,55,0,36.267,34.46,16,32,9,23,0,0
4.523,8,23,467.6,5,33,58.731,46.5,58,65.401,62,1,39.108,37.421,15,37,10,25,0,0
5.346,11,31,527.73,8,39,75.629,55.0,76,85.763,80,1,49.574,46.68,20,43,8,37,0,0
5.0,4,17,478.68,6,25,40.345,34.0,39,44.081,41,1,29.404,27.598,13,27,8,14,0,0
4.523,6,22,418.5,4,31,53.662,45.5,53,59.94,56,1,35.489,34.487,15,34,9,22,1,1
5.77,2,15,350.23,4,23,36.902,33.5,36,40.665,38,0,26.006,25.111,13,25,8,13,0,0
8.357,4,20,395.46,5,29,50.887,41.5,50,56.651,52,2,32.938,32.181,16,31,9,21,0,0
6.4,5,17,319.41,2,24,41.131,38.0,41,46.564,45,0,27.847,26.784,12,28,7,17,0,0
8.071,4,24,429.52,5,32,55.443,48.0,55,61.857,58,2,37.245,35.993,20,35,8,23,0,0
5.6,7,16,319.47,2,22,42.989,31.5,43,48.571,45,2,28.426,26.422,9,24,6,21,0,0
5.6,5,21,507.55,7,35,57.378,50.0,55,63.377,58,3,36.955,36.846,16,38,14,20,0,0
7.523,5,23,448.53,9,33,57.872,47.5,57,64.564,60,0,37.705,36.729,18,36,10,24,0,0
7.921,4,22,434.5,8,32,54.989,46.5,54,61.149,57,0,35.943,35.202,18,35,10,22,0,0
5.0,3,16,340.64,2,21,33.585,30.0,33,36.446,35,1,25.364,23.906,13,23,5,12,0,0
7.252,5,24,447.54,9,33,58.654,47.5,58,65.481,61,0,38.46,37.234,19,36,9,25,0,0
6.845,5,23,448.53,9,33,57.872,47.5,57,64.564,60,0,37.705,36.729,18,36,10,24,0,0
6.462,2,15,349.25,4,23,37.676,33.5,37,41.954,39,0,26.557,25.417,13,25,8,14,0,0
5.701,2,15,315.79,4,22,36.578,32.5,36,40.721,38,0,25.148,24.283,13,24,7,14,0,0
7.398,10,27,525.53,7,36,66.072,50.0,66,74.485,70,1,45.103,42.347,17,40,9,30,0,0
7.244,10,27,526.51,7,36,65.298,50.0,65,73.196,69,1,44.551,42.04,17,40,9,29,0,0
5.0,3,16,306.2,2,20,33.262,29.0,33,36.502,35,1,24.506,23.079,13,22,4,13,0,0
5.7,5,19,338.42,3,25,44.316,37.0,44,49.864,47,1,29.506,28.398,14,28,6,19,0,0
5.9,5,33,587.76,8,43,72.163,66.5,72,80.394,78,1,50.972,48.561,28,49,10,29,0,0
6.0,5,33,587.76,8,43,72.163,66.5,72,80.394,78,1,50.972,48.561,28,49,10,29,0,0
5.6,0,14,349.22,3,20,29.698,31.0,29,31.838,31,1,22.966,21.792,14,22,6,9,0,0
6.5,9,25,503.02,4,35,62.076,48.0,61,69.935,65,0,40.841,39.427,16,39,10,26,0,0
6.4,8,24,471.0,4,33,58.68,46.0,58,66.18,62,0,39.142,37.517,16,37,9,25,0,0
9.398,11,26,470.64,4,35,64.861,50.5,65,73.763,68,3,42.875,40.681,13,38,9,30,2,2
8.721,12,26,523.73,5,37,70.258,52.5,70,79.434,73,5,45.949,43.33,13,40,11,33,1,1
9.301,8,23,417.51,4,31,54.443,45.5,54,60.857,57,4,36.245,34.993,14,34,8,23,1,1
8.638,7,21,390.49,4,29,51.334,42.5,51,57.73,54,3,34.034,32.772,13,32,8,22,1,1
9.301,9,23,418.55,4,31,57.101,44.5,57,64.561,60,3,37.557,35.826,13,34,8,26,1,1
8.602,9,24,442.58,5,33,59.094,48.5,59,66.933,62,3,39.353,37.627,13,36,9,26,2,2
9.097,9,24,431.54,4,32,57.327,46.5,57,64.272,60,4,38.006,36.519,14,35,8,25,1,1
9.523,11,25,446.61,4,33,62.869,46.5,63,71.391,66,3,41.08,38.88,13,36,8,30,1,1
9.046,10,24,432.58,4,32,59.985,45.5,60,67.976,63,3,39.319,37.353,13,35,8,28,1,1
8.538,7,20,426.55,4,30,52.738,44.5,52,58.86,55,4,35.137,33.674,12,33,10,22,1,1
8.77,9,22,454.61,4,32,58.505,46.5,58,65.69,61,4,38.659,36.728,12,35,10,26,1,1
7.222,4,23,368.47,4,28,47.803,43.5,48,53.524,51,2,33.569,32.015,18,31,5,20,1,1
9.0,7,22,403.48,4,30,51.56,44.5,51,57.441,54,4,34.483,33.466,14,33,8,21,1,1
8.149,4,22,385.46,4,29,48.349,45.5,48,53.817,51,3,33.267,32.224,17,32,7,19,1,1
7.959,4,22,369.46,4,28,47.022,43.5,47,52.607,50,2,32.813,31.509,17,31,6,19,1,1
8.347,4,22,384.48,4,29,49.123,44.5,49,55.106,52,2,33.819,32.531,17,32,7,20,1,1
7.387,7,25,427.55,5,32,57.0,47.5,57,64.062,60,2,38.551,36.805,17,35,7,25,1,1
8.824,4,22,385.46,4,29,48.349,45.5,48,53.817,51,3,33.267,32.224,17,32,7,19,1,1
8.347,4,22,369.46,4,28,47.022,43.5,47,52.607,50,2,32.813,31.509,17,31,6,19,1,1
8.854,4,22,385.46,4,29,48.349,45.5,48,53.817,51,3,33.267,32.224,17,32,7,19,1,1
8.638,4,22,369.46,4,28,47.022,43.5,47,52.607,50,2,32.813,31.509,17,31,6,19,1,1
7.699,6,25,475.62,6,34,59.403,51.5,59,66.192,62,4,40.654,38.706,18,37,9,25,1,1
7.638,4,23,383.49,4,29,49.905,44.5,50,56.023,53,2,34.574,33.036,18,32,6,21,1,1
5.0,7,24,485.99,8,34,60.047,47.5,59,66.971,62,2,39.563,38.257,17,37,10,25,0,0
4.3,1,15,251.31,3,19,32.051,29.5,32,35.78,34,0,22.279,21.413,14,21,4,13,0,0
6.2,2,20,390.44,6,29,47.894,44.0,47,53.109,50,1,31.966,31.434,18,32,9,18,0,0
5.593,0,19,436.28,3,28,38.8,42.0,37,41.268,40,5,29.517,29.022,19,31,9,9,0,0
6.0,7,28,533.65,9,38,65.949,56.5,65,72.654,69,6,44.529,42.862,21,42,10,27,0,0
6.0,8,28,518.69,8,37,67.28,54.5,67,75.148,71,5,45.387,42.98,20,41,9,30,0,0
5.569,3,17,413.86,6,27,42.898,40.0,41,46.573,43,3,29.091,28.677,14,29,10,14,0,0
5.6,6,19,388.41,4,28,47.483,39.0,46,52.622,49,2,30.353,30.211,13,31,9,18,0,0
5.6,2,16,278.34,2,21,35.153,34.0,35,39.279,38,0,24.284,23.434,14,24,5,14,0,0
5.0,1,18,359.45,3,26,39.44,43.0,39,43.654,43,0,28.972,27.917,17,30,8,13,0,0
5.7,7,22,440.5,9,32,57.207,46.0,56,63.402,58,4,36.364,35.642,15,34,10,24,0,0
5.263,11,26,495.64,9,36,69.516,48.5,69,78.351,72,1,43.961,42.056,15,39,10,33,0,0
6.252,9,35,586.69,3,44,74.531,69.0,74,82.438,82,2,51.193,49.508,26,52,9,30,0,0
7.9,3,20,440.46,9,32,53.76,46.0,52,59.153,54,3,34.091,34.105,17,34,12,20,0,0
5.481,3,16,308.38,2,23,39.356,36.0,39,44.275,42,0,26.296,25.477,13,26,7,16,0,0
5.6,3,22,401.53,2,29,48.098,45.0,48,53.527,52,1,34.461,32.697,19,33,7,19,0,0
5.801,3,25,479.5,6,35,56.654,51.0,55,62.666,58,1,37.603,37.428,22,38,10,20,0,0
5.465,16,31,562.79,10,41,82.825,54.5,83,94.301,87,1,52.557,49.47,15,45,10,42,0,0
5.854,15,30,564.76,10,41,81.269,54.5,81,92.095,85,1,51.25,48.658,15,45,11,40,0,0
5.6,5,27,519.52,7,38,59.981,56.5,58,65.876,61,3,40.057,40.142,20,41,11,20,2,2
6.208,11,27,524.76,11,37,72.923,51.0,73,82.766,76,2,47.466,44.362,16,40,10,36,0,0
7.678,1,22,386.51,5,28,45.996,44.0,46,51.029,49,2,33.455,31.675,21,31,6,18,0,0
4.699,3,17,263.37,2,20,36.491,30.5,37,41.401,39,0,25.347,23.752,14,22,3,17,0,0
7.553,2,21,464.86,5,32,50.32,45.0,48,54.906,50,2,33.148,33.422,19,34,11,16,0,0
5.301,1,15,269.75,2,19,31.047,29.5,31,34.515,33,0,22.682,21.526,14,21,4,12,0,0
4.301,3,17,329.81,4,23,39.469,33.5,39,43.764,41,0,27.114,26.009,14,25,6,16,0,0
4.301,4,18,325.4,5,24,43.356,34.5,43,48.445,45,0,28.472,27.423,14,26,6,19,0,0
6.745,2,13,239.31,2,18,31.043,28.0,31,35.152,33,0,21.074,20.214,11,20,5,13,0,0
5.6,2,19,315.41,4,24,40.811,38.0,41,45.983,44,0,28.597,27.268,17,27,5,17,0,0
5.6,2,15,332.84,4,22,35.553,32.5,35,39.143,37,0,25.79,24.449,13,24,7,13,0,0
4.0,0,13,194.25,1,15,24.738,25.0,25,27.657,27,0,18.057,17.15,13,17,2,10,0,0
5.6,1,18,335.82,4,24,38.251,38.0,38,42.512,41,0,27.693,26.569,17,27,6,14,0,0
4.0,0,13,220.25,1,17,25.174,29.0,25,27.824,27,0,18.546,18.139,12,19,4,8,1,1
8.166,8,22,488.07,7,33,59.603,45.5,59,66.923,62,1,40.068,37.862,14,36,11,26,0,0
5.6,1,13,274.39,3,18,28.218,28.5,28,30.707,30,1,21.807,20.239,12,20,5,10,0,0
4.2,0,12,213.26,2,16,27.167,24.0,27,30.365,28,1,18.517,17.886,12,17,4,11,0,0
5.6,0,14,255.27,2,19,29.68,30.0,29,32.705,31,1,20.455,20.27,14,21,5,10,0,0
5.0,8,19,354.51,8,26,51.774,36.0,52,59.351,54,0,33.103,31.111,11,28,7,26,0,0
5.6,1,17,275.33,1,21,34.051,34.0,34,37.78,37,2,24.279,23.413,16,24,4,13,0,0
6.42,2,20,371.39,5,27,44.24,39.0,43,49.045,45,1,29.375,29.143,18,29,7,16,0,0
7.921,8,22,398.53,7,29,56.178,39.5,56,63.734,58,3,36.006,34.22,14,31,7,27,0,0
5.0,3,17,457.71,6,27,43.64,38.0,42,47.653,44,1,29.864,29.154,14,29,10,15,0,0
5.6,6,20,415.89,4,29,49.069,41.5,48,54.516,51,1,32.824,31.962,14,32,9,19,0,0
7.921,9,28,466.58,2,35,61.109,55.0,61,68.189,68,1,41.762,40.025,19,42,7,26,0,0
5.6,5,20,416.39,3,30,47.112,43.0,45,51.547,49,3,30.529,31.068,15,34,10,15,0,0
6.206,3,15,364.83,6,25,43.218,34.0,42,48.053,43,2,27.824,27.261,12,26,10,17,0,0
5.6,1,16,275.34,3,21,34.043,34.5,34,38.152,37,0,24.074,23.214,15,24,5,13,0,0
5.6,1,16,275.34,3,21,34.043,34.5,34,38.152,37,0,24.074,23.214,15,24,5,13,0,0
5.6,1,16,290.36,3,22,36.145,35.5,36,40.651,39,0,25.08,24.236,15,25,6,14,0,0
5.6,1,17,275.33,3,21,34.051,34.5,34,37.78,37,0,24.279,23.413,16,24,4,13,0,0
5.6,3,13,227.29,3,17,30.051,26.5,30,33.78,32,0,20.279,19.413,10,19,4,13,0,0
5.6,6,16,282.38,3,21,38.92,31.5,39,44.109,42,0,25.807,24.488,10,24,5,18,0,0
5.6,0,13,235.27,1,18,27.276,31.0,27,30.322,30,0,19.551,19.161,13,21,5,9,0,0
5.6,0,16,292.39,3,21,33.018,34.5,33,36.574,36,0,24.716,23.38,16,24,5,12,0,0
5.6,1,17,306.42,4,22,35.902,35.5,36,39.989,39,0,26.478,24.907,16,25,5,14,0,0
5.6,6,19,332.45,3,25,44.796,39.0,45,50.896,49,0,30.364,28.816,13,29,6,20,0,0
5.6,3,16,292.38,3,22,38.029,35.0,38,43.066,41,0,25.841,24.762,13,25,6,16,0,0
5.6,6,22,391.49,5,29,51.301,43.5,51,57.777,55,0,34.273,32.946,16,33,7,22,0,0
8.444,9,23,442.54,6,32,59.832,43.5,59,67.153,62,3,37.915,36.65,14,35,9,27,0,0
4.1,0,13,210.25,0,16,26.065,25.0,26,28.867,28,1,18.512,17.865,13,18,3,10,0,0
5.6,1,21,361.47,4,26,42.08,40.5,42,46.661,45,0,30.932,29.322,20,29,5,16,0,0
4.903,3,19,378.5,5,27,45.316,41.0,45,50.61,48,0,31.705,30.191,16,30,8,18,0,0
4.903,4,20,392.53,6,28,48.2,42.0,48,54.026,51,0,33.466,31.718,16,31,8,20,0,0
5.367,3,19,378.5,6,27,45.316,41.0,45,50.61,48,0,31.705,30.191,16,30,8,18,0,0
5.8,5,20,319.44,3,24,44.585,36.0,45,50.441,48,1,30.324,28.52,15,27,4,21,0,0
4.854,3,19,393.52,6,28,47.418,42.0,47,53.109,50,0,32.711,31.213,16,31,9,19,0,0
5.0,2,19,333.37,3,25,40.589,38.5,40,44.614,43,2,27.949,27.369,17,28,6,15,0,0
5.0,2,24,409.48,4,31,50.349,48.5,50,55.817,54,2,35.267,34.224,22,35,7,19,0,0
5.0,2,19,412.26,3,26,40.818,39.5,40,44.456,43,2,29.301,28.395,17,29,7,14,0,0
5.0,4,25,427.49,5,32,53.567,49.0,53,59.069,57,2,36.688,35.665,21,36,7,21,0,0
5.0,2,19,332.39,3,25,41.363,38.5,41,45.903,44,2,28.5,27.676,17,28,6,16,0,0
5.0,2,19,349.44,3,25,40.338,38.5,40,44.325,43,2,29.142,27.842,17,28,6,15,0,0
5.0,7,17,306.41,4,23,40.912,35.5,41,46.481,44,0,27.603,26.289,9,26,6,18,1,1
6.174,6,30,557.1,11,40,69.52,58.5,69,77.544,72,2,47.392,45.422,23,43,10,29,1,1
5.6,7,21,450.38,5,30,52.832,41.5,52,59.081,55,0,35.75,34.128,14,33,9,22,0,0
5.6,3,23,371.47,3,28,48.912,42.0,49,54.651,52,2,33.779,32.235,20,31,5,21,0,0
5.6,3,23,371.47,3,28,48.912,42.0,49,54.651,52,2,33.779,32.235,20,31,5,21,0,0
7.2,2,22,357.44,3,27,46.029,41.0,46,51.235,49,2,32.017,30.708,20,30,5,19,0,0
5.6,6,15,342.41,3,25,43.887,36.5,43,49.481,46,1,27.762,27.235,9,28,10,18,0,0
6.5,4,30,469.58,3,36,58.789,58.0,59,65.438,64,1,42.336,40.563,25,41,6,23,1,1
5.6,11,24,447.6,5,33,62.087,46.0,62,70.474,66,3,40.324,38.374,13,37,9,29,0,0
8.119,7,28,498.71,7,36,65.618,52.5,66,74.102,70,1,45.273,42.352,21,40,8,30,0,0
7.319,7,29,481.65,6,36,66.65,53.0,67,75.308,71,2,44.836,42.385,22,40,7,31,0,0
8.745,13,34,634.74,12,46,83.418,63.5,82,92.987,87,4,53.569,52.097,21,51,12,36,0,0
5.0,9,27,543.67,7,38,67.265,53.5,66,75.247,70,1,44.296,42.722,18,42,11,28,0,0
8.495,12,26,460.64,6,34,65.752,47.5,66,74.806,69,3,42.841,40.406,13,37,8,32,1,1
9.081,5,24,480.59,8,34,58.956,49.0,58,65.112,61,1,39.557,38.115,19,37,10,24,0,0
6.921,4,20,332.44,3,25,44.803,38.0,45,50.524,48,2,30.569,29.015,16,28,5,20,0,0
9.161,12,26,460.64,6,34,65.752,47.5,66,74.806,69,3,42.841,40.406,13,37,8,32,1,1
5.639,0,15,394.4,4,27,41.229,40.5,39,44.878,41,3,26.966,27.334,15,29,12,12,0,0
4.523,12,25,554.6,7,36,69.469,46.5,69,78.156,71,3,46.176,42.995,13,38,11,33,0,0
6.0,3,21,422.46,7,31,51.291,46.0,50,56.864,53,1,33.665,33.344,18,34,10,19,0,0
6.046,4,22,434.5,8,32,54.989,47.0,54,61.149,57,1,35.943,35.202,18,35,10,22,0,0
6.222,5,23,447.55,8,33,58.647,48.0,58,65.853,61,1,38.256,37.035,18,36,10,25,0,0
6.0,5,22,448.54,8,33,57.865,48.0,57,64.936,60,1,37.5,36.53,17,36,11,24,0,0
7.699,5,22,449.52,8,33,57.091,48.0,56,63.647,59,1,36.949,36.223,17,36,11,23,0,0
8.0,4,22,435.48,8,32,54.214,47.0,53,59.86,56,1,35.392,34.895,18,35,10,21,0,0
8.097,6,24,479.54,11,35,61.309,50.0,60,67.9,63,1,39.369,38.664,18,38,11,25,0,0
7.046,6,24,479.54,11,35,61.309,50.0,60,67.9,63,1,39.369,38.664,18,38,11,25,0,0
6.398,10,28,532.66,11,39,71.734,55.0,71,80.434,75,1,46.205,44.551,18,43,11,32,0,0
7.523,9,27,518.63,11,38,68.851,54.0,68,77.019,72,1,44.443,43.024,18,42,11,30,0,0
7.0,4,22,435.48,8,32,54.214,47.0,53,59.86,56,1,35.392,34.895,18,35,10,21,0,0
7.301,3,23,429.47,7,32,52.003,49.0,51,57.236,54,1,35.176,34.654,19,35,9,19,1,1
7.398,4,23,434.49,8,32,54.996,47.0,54,60.777,57,1,36.148,35.401,19,35,9,22,0,0
6.699,5,20,423.48,8,31,53.207,45.5,52,59.232,55,1,34.188,33.697,15,34,11,21,0,0
6.0,5,21,422.49,8,31,53.989,45.5,53,60.149,56,1,34.943,34.202,16,34,10,22,0,0
6.222,5,25,459.55,8,34,59.654,49.5,59,66.481,62,1,39.46,38.234,20,37,9,25,0,0
6.523,4,25,445.51,8,33,56.778,48.5,56,62.694,59,1,37.904,36.906,21,36,8,23,0,0
6.0,4,25,444.53,8,33,57.552,48.5,57,63.983,60,1,38.455,37.213,21,36,8,24,0,0
6.0,4,25,445.51,8,33,56.778,48.5,56,62.694,59,1,37.904,36.906,21,36,8,23,0,0
6.0,4,25,460.53,8,34,58.88,49.5,58,65.192,61,1,38.909,37.928,21,37,9,24,0,0
6.0,4,24,481.57,9,34,58.182,50.5,57,63.823,60,2,39.006,37.808,20,37,10,23,0,0
6.0,4,25,445.51,8,33,56.778,48.5,56,62.694,59,1,37.904,36.906,21,36,8,23,0,0
6.0,4,25,445.51,8,33,56.778,48.5,56,62.694,59,1,37.904,36.906,21,36,8,23,0,0
7.523,4,25,445.51,8,33,56.778,48.5,56,62.694,59,1,37.904,36.906,21,36,8,23,0,0
6.523,4,24,418.48,8,31,53.676,45.5,53,59.196,56,0,35.898,34.885,20,34,7,22,0,0
6.222,5,23,433.51,8,32,55.771,47.0,55,62.066,58,1,36.699,35.707,18,35,9,23,0,0
6.0,5,23,433.51,8,32,55.771,47.0,55,62.066,58,1,36.699,35.707,18,35,9,23,0,0
6.0,3,21,405.45,7,30,50.003,45.0,49,55.236,52,1,33.176,32.654,18,33,9,19,0,0
6.0,4,22,419.48,7,31,52.887,46.0,52,58.651,55,1,34.938,34.181,18,34,9,21,0,0
6.097,5,23,433.51,8,32,55.771,47.0,55,62.066,58,1,36.699,35.707,18,35,9,23,0,0
7.398,5,24,432.52,8,32,56.552,47.0,56,62.983,59,1,37.455,36.213,19,35,8,24,0,0
7.0,6,24,447.54,8,33,58.654,48.0,58,65.481,61,1,38.46,37.234,18,36,9,25,0,0
6.0,6,24,446.56,8,33,59.429,48.0,59,66.77,62,1,39.012,37.541,18,36,9,26,0,0
4.4,0,8,180.6,0,12,17.622,18.0,17,18.98,18,2,12.847,12.639,8,13,4,5,0,0
6.0,5,25,427.55,6,32,57.0,47.5,57,64.062,60,1,38.551,36.805,20,35,7,25,0,0
6.0,5,25,427.55,6,32,57.0,47.5,57,64.062,60,1,38.551,36.805,20,35,7,25,0,0
6.0,5,26,426.56,6,32,57.781,47.5,58,64.979,61,1,39.307,37.31,21,35,6,26,0,0
5.6,6,15,270.37,3,20,37.92,28.0,38,43.109,40,3,24.807,23.488,9,22,5,18,0,0
8.611,1,20,375.49,3,27,44.214,42.0,44,49.112,47,1,31.699,30.17,19,30,7,17,0,0
5.6,2,17,307.39,3,23,40.138,34.5,40,45.192,42,1,27.051,25.983,15,25,6,17,0,0
7.9,2,22,356.46,4,27,46.803,42.0,47,52.524,50,1,32.569,31.015,20,30,5,20,0,0
5.6,3,15,637.87,2,21,33.32,28.0,33,35.865,34,0,30.023,25.328,12,22,6,12,0,0
5.6,8,22,425.54,7,31,58.538,42.0,58,65.896,60,3,37.222,35.761,14,33,9,27,0,0
5.6,3,18,411.34,3,29,42.887,42.5,40,47.021,43,0,27.222,28.568,15,32,11,11,0,0
8.3,3,25,441.6,4,32,54.865,49.0,55,61.358,58,1,38.983,36.75,20,35,7,23,2,1
5.6,2,17,346.34,2,25,39.574,36.5,38,43.713,40,1,25.858,26.111,15,27,8,13,0,0
5.6,1,11,278.32,4,19,30.116,28.5,29,32.787,30,3,20.318,19.998,10,20,8,10,0,0
7.7,4,23,415.56,2,30,50.982,46.0,51,56.943,55,1,36.222,34.223,19,34,7,21,0,0
6.5,2,21,426.44,3,31,49.661,46.0,48,55.125,51,1,32.631,32.681,19,34,10,17,0,0
4.0,2,8,163.2,0,12,21.284,17.0,21,23.95,22,4,13.756,13.359,6,13,4,9,0,0
5.6,0,14,288.32,3,20,29.982,31.0,29,32.336,31,1,21.551,21.15,14,22,6,9,0,0
5.6,3,17,343.44,6,24,41.549,36.5,41,45.95,43,2,28.358,27.083,14,26,7,17,0,0
5.6,5,27,471.55,8,35,60.662,52.0,60,67.109,63,3,40.665,39.433,22,38,8,25,0,0
5.6,5,21,362.47,4,27,49.014,40.0,49,55.149,52,2,32.784,31.256,16,30,6,22,0,0
5.6,10,31,526.75,9,39,76.403,55.0,77,87.052,80,2,50.126,46.987,21,42,8,38,0,0
5.6,2,19,406.37,3,29,45.298,41.0,43,49.677,45,4,29.012,29.736,17,31,10,14,0,0
5.6,1,17,379.28,3,24,36.884,36.0,36,39.715,38,2,27.852,26.475,16,26,7,12,0,0
5.6,1,13,288.16,1,17,27.069,27.0,27,29.997,29,0,20.415,19.197,12,19,4,10,0,0
8.4,4,27,530.66,8,38,64.832,56.5,64,71.899,68,1,44.114,42.443,23,42,11,26,0,0
7.5,3,27,501.03,8,36,61.425,54.5,61,68.505,65,1,42.415,40.653,24,40,9,25,0,0
5.6,4,22,405.54,4,29,49.167,45.5,49,55.073,53,0,34.705,32.892,18,33,7,20,0,0
7.2,1,14,234.28,1,18,28.058,30.0,28,31.239,30,0,20.307,19.666,12,20,4,10,1,1
5.6,1,21,418.52,4,30,48.643,46.0,48,53.82,51,2,34.159,32.906,20,33,9,18,0,0
6.7,0,24,444.52,4,32,49.836,50.5,49,54.578,53,1,35.847,34.773,24,36,8,17,0,0
5.6,5,21,408.45,5,30,49.149,45.0,48,54.785,52,0,32.694,32.297,16,34,9,18,0,0
5.6,4,20,375.48,6,28,49.225,42.5,49,55.604,52,1,32.824,31.552,16,31,8,21,0,0
5.6,0,15,348.21,3,23,35.018,34.5,34,38.25,36,1,25.244,24.584,15,25,8,11,0,0
5.6,5,23,442.48,7,32,54.436,46.0,53,60.583,56,0,35.358,34.933,18,35,9,21,0,0
5.6,6,22,376.5,4,28,51.898,41.0,52,58.564,55,2,34.546,32.783,16,31,6,24,0,0
5.9,11,29,467.67,6,35,67.207,51.0,68,76.514,73,0,45.143,42.197,18,40,6,33,0,0
8.3,2,24,427.57,3,31,51.982,48.0,52,57.943,55,1,37.222,35.223,20,34,7,21,2,1
5.6,2,17,293.35,3,22,37.262,33.0,37,41.405,39,3,25.495,24.655,15,24,5,15,0,0
5.6,1,16,316.36,3,24,36.582,40.5,36,40.817,40,0,25.568,25.225,15,28,8,12,0,0
5.6,4,16,267.36,4,20,36.818,29.0,37,41.611,39,1,24.801,23.467,12,22,4,17,0,0
5.6,7,17,322.41,2,24,42.24,37.0,42,47.69,45,1,28.057,27.004,9,27,7,18,1,1
5.6,3,24,477.59,8,34,57.847,51.0,57,63.986,60,5,39.347,37.894,21,37,10,23,0,0
5.6,4,14,256.34,3,19,35.036,28.5,35,39.694,37,0,23.046,21.961,10,21,5,16,0,0
5.6,6,26,442.56,8,33,59.109,49.0,59,66.189,63,1,39.762,38.025,20,37,7,26,0,0
7.8,0,24,444.52,4,32,49.836,50.5,49,54.578,53,1,35.847,34.773,24,36,8,17,0,0
5.6,3,23,400.54,6,29,48.88,46.0,49,54.444,53,0,35.216,33.202,20,33,6,20,0,0
7.0,6,17,308.43,3,23,42.796,34.0,43,48.896,46,0,28.364,26.816,11,26,6,20,0,0
5.6,7,19,325.42,1,24,44.098,34.5,44,49.781,47,2,29.262,27.904,12,27,5,20,0,0
5.6,1,21,411.94,5,28,46.429,41.0,46,51.099,48,2,33.523,31.723,20,30,7,18,0,0
5.6,4,16,323.41,1,23,36.447,36.0,36,40.282,40,1,26.176,25.116,12,27,7,13,0,0
5.9,1,16,350.3,2,25,37.203,36.5,35,40.637,37,1,24.034,24.968,15,27,9,10,0,0
8.4,2,21,444.43,3,32,50.174,47.0,48,55.464,51,1,32.569,33.064,19,35,11,16,0,0
6.3,5,33,589.78,10,43,74.047,65.5,74,82.809,79,1,51.733,49.088,28,48,10,31,0,0
5.6,1,19,367.88,4,25,39.334,39.5,39,43.06,42,1,29.546,27.954,18,28,6,14,0,0
8.801,2,25,454.6,4,33,55.083,51.5,55,61.441,59,1,39.228,37.245,23,37,8,22,0,0
4.0,0,11,214.22,1,16,23.687,26.0,23,26.163,25,0,16.483,16.523,11,18,5,7,0,0
4.5,1,13,209.27,1,16,26.84,26.0,27,30.156,29,0,19.063,18.171,12,18,3,11,0,0
5.6,4,24,398.5,6,30,52.014,46.0,52,58.149,56,1,35.784,34.256,20,34,6,22,0,0
5.6,0,14,301.28,2,22,32.513,33.5,31,35.626,33,1,21.642,22.169,14,24,8,9,0,0
5.6,1,16,366.75,2,25,37.014,36.5,35,40.242,37,1,24.955,25.412,15,27,9,10,0,0
6.7,0,19,361.46,3,26,41.331,41.0,41,45.697,44,1,29.938,28.643,19,29,7,15,0,0
4.2,2,9,220.28,0,15,23.578,23.5,23,25.953,25,2,16.648,16.041,7,17,6,8,0,0
5.6,4,28,497.67,7,36,62.96,56.0,63,70.398,67,2,43.961,41.518,24,40,8,27,0,0
5.6,15,27,522.73,7,38,76.05,50.0,76,86.843,80,2,47.83,45.218,12,42,11,38,0,0
5.6,3,14,254.32,3,19,33.153,29.5,33,37.279,35,1,22.284,21.434,11,21,5,14,0,0
8.3,3,27,529.65,6,38,62.909,57.5,62,69.903,66,2,43.387,41.891,24,42,11,24,0,0
6.9,11,24,451.61,6,33,63.156,45.0,63,72.02,67,2,40.569,38.569,13,37,9,30,0,0
5.6,3,15,268.35,4,20,36.036,30.0,36,40.694,38,0,24.046,22.961,12,22,5,16,0,0
5.6,1,19,285.37,4,22,36.607,35.0,37,40.986,39,0,26.586,25.225,17,24,3,15,1,1
8.2,6,23,449.01,6,32,57.091,47.0,57,64.667,61,0,38.756,36.74,17,36,9,25,0,0
5.6,0,12,289.7,1,20,29.255,30.0,28,31.685,30,2,20.318,20.418,12,22,8,8,0,0
5.6,7,22,408.53,7,30,55.287,43.5,55,62.691,58,0,36.04,34.494,15,33,8,25,0,0
4.1,0,5,169.59,0,11,15.833,17.0,15,17.436,16,0,10.886,10.935,5,12,6,4,0,0
5.6,0,12,269.31,1,19,26.796,31.0,26,29.036,29,1,19.892,19.536,12,22,7,7,0,0
5.6,3,23,404.93,7,29,50.011,44.0,50,55.883,53,1,35.188,33.369,20,32,6,21,0,0
5.6,16,28,521.74,7,38,76.832,50.0,77,87.76,81,2,48.586,45.723,12,42,10,39,0,0
4.0,2,15,223.29,1,17,29.731,26.0,30,33.199,32,1,21.029,19.897,13,19,2,13,0,0
5.6,4,23,415.56,3,30,50.982,46.0,51,56.943,55,1,36.222,34.223,19,34,7,21,0,0
4.0,2,10,203.22,0,15,24.611,22.0,24,27.159,26,2,16.21,16.074,8,17,5,9,0,0
8.4,2,19,380.53,3,26,42.189,41.0,42,46.534,45,2,31.341,29.335,17,29,7,16,0,0
5.6,9,31,535.71,10,40,72.854,59.5,73,82.305,78,1,48.847,46.428,22,45,9,33,0,0
6.9,11,29,467.67,7,35,67.207,51.0,68,76.514,73,0,45.143,42.197,18,40,6,33,0,0
5.6,0,11,246.67,0,17,24.825,26.0,24,26.977,26,1,17.858,17.682,11,19,6,7,0,0
5.6,1,17,357.32,2,26,37.909,39.5,36,41.381,38,1,25.341,26.079,15,28,9,10,1,1
5.6,1,14,268.37,4,19,31.018,29.5,31,34.574,33,0,22.716,21.38,13,21,5,12,0,0
5.6,0,21,359.41,4,27,44.473,41.5,44,49.03,47,0,30.71,29.896,21,30,6,17,0,0
5.6,4,22,346.46,5,26,47.694,38.0,48,53.567,50,1,32.534,30.74,18,28,4,22,0,0
8.6,1,24,440.57,4,32,52.2,50.5,52,58.026,56,1,37.466,35.718,23,36,8,20,0,0
5.6,3,20,379.4,3,28,44.163,44.5,43,48.872,47,0,29.926,29.749,17,32,8,15,0,0
6.3,8,19,370.93,4,26,48.887,37.0,49,55.671,52,0,32.745,30.697,11,29,7,23,0,0
4.2,0,12,210.26,1,16,26.058,26.0,26,29.239,28,0,18.307,17.666,12,18,4,10,0,0
5.6,1,21,410.41,4,30,47.6,45.0,46,52.207,49,1,31.591,31.684,20,33,9,16,0,0
5.6,4,19,318.41,2,24,41.92,38.0,42,47.109,45,1,28.807,27.488,15,27,5,18,0,0
5.6,11,27,457.63,7,34,64.65,49.0,65,73.308,68,2,42.836,40.385,15,37,7,31,1,1
5.6,3,19,364.42,6,27,44.752,41.0,44,50.03,47,0,29.995,29.387,16,30,8,17,0,0
6.2,7,35,630.84,9,46,80.032,69.5,80,89.723,86,1,55.5,52.636,28,52,11,34,0,0
5.6,3,20,344.4,3,26,42.363,41.0,42,46.903,46,3,29.5,28.676,17,30,6,16,0,0
5.6,5,23,497.58,8,35,59.502,52.0,58,65.405,61,6,39.256,38.324,18,38,12,23,0,0
5.9,7,21,379.51,5,28,53.0,39.0,53,60.062,55,3,34.552,32.805,14,30,7,25,0,0
5.6,3,11,320.46,0,20,28.724,33.0,28,31.165,32,0,22.739,21.217,8,24,9,8,0,0
5.6,5,21,374.49,5,28,50.007,42.5,50,56.521,53,1,33.58,32.058,16,31,7,22,0,0
6.8,1,19,334.83,4,24,39.033,38.0,39,43.428,42,0,28.449,27.074,18,27,5,15,0,0
5.6,5,19,334.41,3,25,43.247,38.0,43,48.318,46,0,29.262,28.203,13,28,6,18,1,1
5.6,5,21,426.92,6,30,50.843,44.0,50,56.805,53,0,34.375,33.268,16,33,9,20,0,0
5.6,3,21,350.42,6,26,45.323,38.0,45,50.492,47,1,30.711,29.597,18,28,5,19,0,0
5.6,6,15,283.37,3,21,38.138,31.5,38,43.192,41,0,25.051,23.983,9,24,6,17,0,0
5.6,8,15,303.41,3,22,43.232,30.0,43,49.232,45,1,27.029,25.751,7,24,7,21,0,0
5.6,0,20,346.39,3,26,41.549,41.0,41,46.034,44,1,28.983,28.345,20,29,6,15,0,0
7.5,2,22,410.43,3,30,48.341,45.0,47,53.543,50,1,32.381,32.165,20,33,8,17,0,0
7.7,1,26,523.55,4,37,56.032,56.0,54,61.301,58,1,38.972,38.756,25,41,11,17,0,0
6.5,4,18,290.4,2,22,39.592,35.0,40,44.9,43,0,27.353,25.773,14,25,4,18,0,0
8.0,4,28,525.69,6,38,65.28,57.5,65,72.979,69,2,45.211,43.034,24,42,10,27,0,0
5.6,2,14,286.74,1,20,31.593,30.5,31,34.807,33,1,22.381,21.735,11,22,6,11,1,1
5.8,2,22,432.55,4,31,51.527,47.0,51,57.235,54,2,35.921,34.433,20,34,9,20,0,0
5.6,4,22,346.46,5,26,47.694,38.0,48,53.567,50,1,32.534,30.74,18,28,4,22,0,0
5.6,10,31,526.75,10,39,76.403,55.0,77,87.052,80,2,50.126,46.987,21,42,8,38,0,0
5.6,0,16,263.32,2,20,33.051,31.5,33,36.78,35,1,23.279,22.413,16,22,4,13,0,0
8.699,1,24,458.56,4,33,52.712,51.5,52,58.365,56,1,37.404,36.101,23,37,9,19,0,0
5.3,0,13,226.25,1,17,27.393,27.0,27,30.076,29,0,18.966,18.58,13,19,4,10,0,0
5.6,3,22,471.31,4,27,45.105,41.5,45,49.584,48,1,33.881,31.224,19,30,5,18,0,0
5.8,1,17,326.4,3,23,37.564,34.0,37,41.036,39,3,26.591,25.535,16,25,6,14,0,0
5.6,1,15,345.22,3,21,34.382,32.0,34,38.12,36,1,24.637,23.46,14,23,6,13,0,0
5.6,4,16,323.41,1,23,36.447,36.0,36,40.282,40,1,26.176,25.116,12,27,7,13,0,0
4.4,1,14,224.28,0,17,28.949,26.0,29,32.282,31,1,20.273,19.392,13,19,3,12,0,0
6.1,13,34,621.82,6,46,85.152,67.0,85,96.341,91,2,55.836,53.239,21,52,12,39,0,0
5.6,4,24,397.52,6,30,52.789,47.0,53,59.438,57,0,36.336,34.563,20,34,6,23,0,0
5.6,5,17,310.39,4,23,41.247,34.5,41,46.318,43,2,27.262,26.203,12,25,6,18,0,0
5.6,0,14,272.32,2,19,28.654,30.0,28,31.127,30,1,21.097,20.435,14,21,5,9,0,0
5.6,4,24,439.47,3,32,53.334,46.0,52,59.085,55,2,35.353,34.912,20,35,8,20,0,0
6.8,7,24,590.56,8,37,66.047,52.0,65,73.655,68,3,44.233,42.016,17,40,13,28,0,0
6.4,1,21,345.43,4,26,45.029,39.0,45,50.235,47,2,31.017,29.708,20,28,5,19,0,0
5.6,5,22,438.48,6,32,53.36,47.0,52,59.41,55,1,34.909,34.539,17,35,10,20,0,0
5.6,5,20,378.45,4,28,47.636,42.5,47,53.445,51,0,31.756,30.914,15,32,8,19,0,0
6.1,5,23,428.55,5,32,56.211,48.0,56,63.517,60,1,37.591,36.1,18,36,9,24,0,0
5.6,2,12,264.33,3,18,30.68,25.0,30,33.621,31,3,20.83,20.008,10,19,6,12,0,0
5.6,5,26,425.58,7,32,58.556,47.0,59,66.268,62,3,39.858,37.617,21,35,6,27,0,0
5.1,0,13,227.26,1,17,27.353,27.0,27,30.495,29,0,19.0,18.555,13,19,4,10,0,0
4.0,0,8,178.23,1,12,18.375,19.0,18,19.956,19,1,13.636,12.998,8,13,4,6,0,0
5.6,5,23,378.48,7,28,51.091,40.0,51,57.322,53,1,34.233,32.651,18,30,5,23,0,0
5.6,1,22,387.45,3,29,47.534,44.5,47,52.947,50,1,32.75,31.893,21,32,7,18,0,0
5.6,4,12,282.38,6,19,34.625,26.5,34,38.954,35,1,22.631,21.532,8,20,7,15,0,0
5.6,0,11,212.23,0,16,24.502,25.0,24,27.033,26,1,17.0,16.854,11,18,5,8,0,0
5.6,1,18,402.82,4,28,42.705,42.0,41,46.899,44,0,29.029,29.071,17,31,10,13,0,0
7.8,1,28,475.61,3,35,55.982,56.0,56,61.943,60,1,41.222,39.223,25,39,7,21,2,1
5.6,5,20,417.43,3,30,49.771,42.5,48,55.251,51,1,31.841,31.901,15,33,10,18,0,0
5.6,3,29,462.59,8,35,60.781,54.0,61,67.979,65,1,42.307,40.31,26,39,6,26,0,0
5.6,1,21,327.41,4,25,41.818,40.0,42,46.611,45,1,29.801,28.467,20,28,4,17,0,0
5.6,1,22,366.46,4,28,45.912,45.5,46,51.481,50,0,32.603,31.289,21,32,6,18,0,0
8.0,3,26,536.61,7,38,61.647,56.5,60,67.954,64,1,41.773,40.968,23,42,12,22,0,0
5.6,5,19,386.52,7,27,49.418,40.0,49,55.278,51,3,32.887,31.158,14,29,8,22,0,0
5.6,2,19,312.35,2,24,36.269,39.5,36,39.863,39,0,26.523,25.908,14,27,5,12,3,2
5.6,3,15,255.35,6,19,35.818,27.0,36,40.611,37,1,23.801,22.467,12,20,4,17,0,0
5.6,7,20,366.52,9,27,52.774,38.0,53,60.351,55,1,34.103,32.111,13,29,7,26,0,0
5.6,0,14,244.26,2,18,30.611,26.0,30,33.329,31,1,20.386,20.02,14,19,4,12,0,0
5.7,2,18,322.34,2,24,38.814,37.0,38,42.325,41,2,26.398,26.063,16,27,6,14,0,0
5.6,1,15,332.43,3,22,34.756,35.0,34,37.541,36,3,25.477,24.195,14,24,7,12,0,0
4.6,0,12,210.26,1,16,26.058,26.0,26,29.239,28,0,18.307,17.666,12,18,4,10,0,0
4.0,1,9,175.21,0,13,22.284,20.0,22,24.95,23,1,14.756,14.359,8,14,4,9,0,0
5.6,0,14,271.72,2,19,29.491,30.0,29,32.309,31,1,21.375,20.714,14,21,5,10,0,0
5.6,1,21,418.52,4,30,48.643,46.0,48,53.82,51,2,34.159,32.906,20,33,9,18,0,0
4.0,0,13,238.27,2,18,28.385,29.0,28,31.448,30,1,19.762,19.381,13,20,5,10,0,0
6.2,12,33,591.79,5,44,80.941,65.0,81,91.716,87,2,53.62,50.997,21,50,11,37,0,0
5.6,5,23,358.47,3,27,48.694,40.5,49,54.567,52,2,33.534,31.74,18,30,4,22,0,0
5.6,0,15,283.25,2,21,31.273,32.0,30,33.206,32,3,21.324,21.703,15,23,6,9,0,0
5.6,3,23,400.54,6,29,48.88,46.0,49,54.444,53,0,35.216,33.202,20,33,6,20,0,0
5.6,4,20,410.42,4,30,47.592,46.5,46,52.579,50,0,31.387,31.485,16,34,10,16,0,0
4.9,0,6,151.21,0,10,15.265,16.0,15,16.83,16,0,11.426,10.778,6,11,4,5,0,0
5.6,1,17,310.4,3,22,36.236,33.0,36,39.827,38,3,26.137,24.82,16,24,5,14,0,0
6.3,4,11,328.27,4,18,32.233,24.5,32,36.329,33,0,22.836,20.953,7,19,7,14,0,0
5.6,1,11,267.35,2,17,26.771,24.0,26,28.627,27,3,19.71,18.647,10,18,6,9,0,0
5.6,10,34,579.76,7,43,79.956,61.0,80,89.972,84,5,53.029,50.395,24,47,9,37,0,0
5.6,1,11,303.18,2,18,27.116,26.0,26,28.884,27,2,20.33,19.422,10,19,7,8,0,0
8.5,1,20,390.51,3,28,46.316,43.0,46,51.61,49,1,32.705,31.191,19,31,8,18,0,0
8.3,2,22,458.43,5,33,52.323,48.0,50,57.172,53,1,33.745,34.309,20,36,11,17,0,0
8.0,6,28,481.67,4,35,61.632,53.0,62,69.188,66,1,43.506,40.804,20,39,7,27,2,1
5.6,3,29,497.03,8,36,61.105,55.0,61,67.923,65,1,43.165,41.137,26,40,7,25,0,0
5.9,0,12,272.24,3,20,29.484,32.5,28,31.661,30,3,19.364,19.998,12,22,8,8,0,0
5.6,5,17,294.39,2,22,39.92,33.0,40,45.109,43,0,26.807,25.488,12,25,5,18,0,0
4.2,2,8,196.25,1,13,21.585,18.5,21,23.581,22,2,14.852,14.24,6,14,5,8,0,0
5.6,2,17,400.31,2,28,41.112,39.5,38,44.732,40,1,25.671,27.261,15,30,11,10,0,0
7.75,6,24,439.58,6,33,57.985,50.0,58,65.806,62,0,39.142,37.407,17,37,9,25,1,1
6.6,0,21,449.55,5,31,47.062,51.0,46,51.036,50,3,34.494,33.26,21,35,10,15,0,0
6.4,0,13,287.67,0,20,27.378,31.0,26,28.898,28,4,19.761,20.09,12,22,7,6,1,1
6.9,6,17,342.87,3,24,43.12,35.0,43,48.84,46,0,29.222,27.644,11,27,7,19,0,0
5.6,0,19,429.31,3,26,39.793,41.0,39,42.878,42,3,29.943,28.56,19,29,7,13,0,0
4.0,1,14,209.26,1,16,26.847,25.0,27,29.784,29,1,19.267,18.37,13,18,2,11,0,0
5.6,0,14,271.72,2,19,29.491,30.0,29,32.309,31,1,21.375,20.714,14,21,5,10,0,0
5.6,2,15,270.38,4,19,32.909,29.0,33,36.617,35,0,23.682,22.106,13,21,4,14,0,0
5.6,0,14,222.26,1,17,27.065,27.5,27,29.867,29,0,19.512,18.865,14,19,3,10,0,0
5.6,4,18,372.49,6,26,46.534,39.0,46,51.863,48,3,31.125,29.632,14,28,8,20,0,0
7.8,1,21,436.34,3,28,46.251,43.0,46,51.449,49,1,33.165,31.535,20,31,7,18,0,0
5.6,7,27,491.59,6,36,63.792,52.0,63,71.572,67,1,41.949,40.625,20,40,9,27,0,0
8.6,3,26,484.63,6,35,59.294,53.5,59,66.065,63,1,41.443,39.486,23,39,9,24,0,0
5.6,2,20,318.4,5,24,41.927,36.0,42,46.737,44,1,29.012,27.687,18,26,4,18,0,0
5.6,0,14,272.32,2,19,28.654,30.0,28,31.127,30,1,21.097,20.435,14,21,5,9,0,0
6.0,7,18,340.48,5,25,48.891,34.0,49,55.936,51,1,31.341,29.584,11,27,7,24,0,0
5.9,0,20,349.36,3,26,39.96,41.0,39,43.875,42,1,27.915,27.706,20,29,6,13,0,0
5.6,0,14,273.3,2,19,27.88,30.0,27,29.838,29,1,20.546,20.129,14,21,5,8,0,0
6.0,3,13,351.18,4,21,33.153,30.5,32,36.124,34,2,22.784,22.362,10,23,8,11,0,0
4.0,1,11,215.23,2,16,25.611,25.5,25,28.159,27,0,17.21,17.074,10,18,5,9,0,0
8.0,2,19,347.41,5,26,43.465,40.5,43,48.402,46,1,29.506,28.697,17,29,7,17,0,0
5.6,1,11,330.59,0,17,23.036,26.0,22,23.868,24,2,19.057,18.071,10,19,6,5,0,0
5.6,4,22,392.92,6,28,49.011,42.0,49,54.883,52,0,34.188,32.369,18,31,6,21,0,0
4.0,2,8,212.25,1,14,22.913,19.5,22,24.79,23,2,15.307,14.955,6,15,6,8,0,0
5.6,3,23,370.49,7,28,49.687,43.0,50,55.939,53,1,34.33,32.542,20,31,5,22,0,0
5.6,3,21,332.43,5,25,44.811,37.0,45,50.152,47,1,30.773,29.214,18,27,4,20,0,0
5.6,1,16,416.25,3,23,36.214,36.5,36,40.371,39,0,27.739,25.552,15,26,7,13,0,0
5.6,1,21,395.49,5,28,46.618,41.0,46,51.495,48,2,32.603,31.279,20,30,7,18,0,0
5.7,0,12,227.31,1,16,25.033,26.0,25,27.661,27,0,18.949,17.832,12,18,4,9,0,0
5.6,2,14,317.76,3,22,35.022,32.0,34,38.515,35,1,23.841,23.471,11,23,8,12,1,1
5.6,0,14,386.46,5,26,37.505,41.0,36,40.66,39,2,27.011,26.502,14,29,12,10,0,0
5.6,4,19,315.41,4,24,40.811,38.5,41,45.983,45,0,28.597,27.268,15,28,5,17,0,0
5.6,4,24,414.5,7,31,53.342,47.0,53,59.358,57,1,36.239,34.971,20,35,7,22,0,0
5.6,4,25,460.53,6,34,58.88,49.0,58,65.192,61,3,38.909,37.928,21,37,9,24,0,0
4.0,0,12,226.26,1,17,27.385,26.0,27,30.448,29,4,18.762,18.381,12,19,5,10,0,0
5.6,4,10,363.19,4,18,32.651,24.0,32,36.707,33,0,22.404,20.487,6,19,8,14,0,0
6.0,0,14,283.29,2,21,32.0,32.5,31,35.286,33,1,21.705,21.786,14,23,7,10,0,0
5.7,0,14,290.31,2,20,29.167,31.0,28,31.466,30,1,21.034,20.819,14,22,6,8,0,0
5.6,1,16,348.2,5,23,35.025,34.0,34,37.878,36,3,25.449,24.783,15,25,7,11,0,0
5.6,2,18,355.45,5,25,42.549,38.0,42,46.95,44,2,29.358,28.083,16,27,7,17,0,0
4.0,0,6,214.03,0,11,15.745,16.0,15,16.961,16,1,11.585,11.331,6,12,5,4,0,0
5.9,4,17,316.39,5,23,43.465,31.0,43,48.571,44,1,27.682,26.643,13,24,6,20,0,0
8.3,4,22,406.48,7,30,52.669,44.0,52,58.568,55,0,34.693,33.686,18,33,8,22,0,0
5.6,9,27,500.67,7,37,69.072,52.0,69,78.388,73,2,45.091,42.922,18,41,10,32,0,0
5.6,0,8,218.27,0,15,21.687,24.5,21,23.91,23,0,15.682,15.316,8,17,7,6,0,0
5.6,7,23,419.56,7,31,57.061,45.0,57,64.98,60,0,37.591,35.801,16,34,8,26,0,0
5.6,0,14,234.28,1,18,28.058,31.0,28,31.239,31,0,20.307,19.666,14,21,4,10,0,0
5.6,3,18,405.26,2,27,42.338,41.0,41,46.001,44,3,29.671,29.046,15,30,9,14,0,0
6.1,0,20,439.36,3,27,42.342,42.0,42,46.455,45,1,32.046,30.174,20,30,7,15,0,0
5.6,3,21,347.45,6,26,46.912,38.0,47,52.651,49,1,31.779,30.235,18,28,5,21,0,0
4.0,2,15,241.28,1,18,30.243,27.0,30,33.539,32,1,20.966,20.28,13,20,3,12,0,0
5.9,2,22,388.53,3,28,47.88,43.0,48,53.444,51,1,34.216,32.202,20,31,6,20,0,0
5.6,5,23,402.49,5,30,52.342,45.0,52,58.358,56,0,35.239,33.971,18,34,7,22,0,0
5.8,5,17,281.39,3,21,39.702,31.0,40,45.026,42,0,26.563,24.993,12,23,4,19,0,0
5.6,1,15,333.3,2,24,35.909,35.5,34,39.381,36,1,23.341,24.079,14,26,9,10,0,0
5.6,4,20,410.42,4,30,47.592,46.5,46,52.579,50,0,31.387,31.485,16,34,10,16,0,0
4.2,1,9,175.21,1,13,22.284,20.0,22,24.95,23,1,14.756,14.359,8,14,4,9,0,0
7.4,2,22,416.48,5,31,51.778,47.0,51,57.524,54,2,34.728,33.96,20,34,9,20,0,0
7.2,2,27,532.52,4,39,60.2,59.0,58,65.959,63,1,40.301,40.637,25,44,12,19,0,0
5.6,1,19,288.37,4,22,37.716,34.0,38,42.112,40,1,26.796,25.445,18,24,3,16,0,0
6.6,2,20,358.41,4,27,42.542,43.0,42,47.406,45,0,29.779,29.146,17,30,7,15,1,1
5.6,4,20,360.46,6,27,47.123,41.5,47,53.106,50,1,31.819,30.531,16,30,7,20,0,0
5.6,0,11,338.12,0,17,24.571,26.0,24,26.754,26,1,19.659,18.171,11,19,6,7,0,0
4.6,0,11,245.28,2,17,24.804,27.5,24,26.664,26,1,18.097,17.735,11,19,6,7,0,0
5.6,5,27,470.57,8,35,61.436,52.0,61,68.398,64,3,41.216,39.74,22,38,8,26,0,0
5.6,1,13,275.33,2,19,29.756,29.5,29,32.625,31,1,21.102,20.457,12,21,6,10,0,0
5.6,1,18,277.34,3,21,35.942,32.0,36,39.824,38,3,25.245,24.139,17,23,3,15,0,0
4.2,1,14,237.28,2,18,29.167,29.0,29,32.365,31,1,20.517,19.886,13,20,4,11,0,0
5.6,7,23,415.55,4,31,55.992,46.5,56,63.434,60,1,37.347,35.606,16,35,8,25,0,0
6.6,3,20,460.54,8,32,54.578,46.0,53,60.409,55,3,35.529,34.772,17,34,12,21,0,0
7.4,9,31,525.78,10,38,72.167,55.0,73,81.849,76,1,49.552,45.911,20,41,7,35,2,1
5.6,1,15,327.2,1,20,31.171,33.0,31,34.496,34,0,23.421,22.218,14,23,5,11,0,0
5.6,0,14,333.22,2,19,28.371,30.0,28,30.628,30,1,22.512,21.077,14,21,5,9,0,0
5.6,6,22,424.5,6,31,53.916,45.0,53,60.615,56,0,35.216,34.351,16,34,9,22,0,0
5.6,6,34,616.81,8,45,77.149,68.5,77,86.308,83,1,53.739,51.109,28,51,11,32,0,0
5.6,8,29,515.67,10,38,71.189,54.0,71,80.142,74,2,46.506,44.341,21,41,9,33,0,0
5.6,3,26,411.9,4,30,48.033,47.0,48,52.598,51,3,35.625,34.02,22,33,4,18,1,1
5.8,5,16,331.43,4,23,40.549,34.5,40,44.95,43,3,27.358,26.083,11,26,7,17,0,0
5.7,1,16,352.21,1,22,32.389,37.0,32,35.579,35,0,24.665,23.713,14,25,6,10,1,1
5.6,4,19,353.48,5,25,44.105,36.5,44,49.155,46,1,30.665,28.895,15,27,6,19,0,0
5.6,1,21,340.41,3,26,42.036,42.0,42,46.694,46,1,30.046,28.961,20,30,5,16,0,0
6.3,2,22,406.45,4,30,49.971,45.0,49,55.283,52,1,33.415,32.828,20,33,8,19,0,0
5.6,2,17,362.34,3,26,40.902,37.5,39,44.922,41,1,26.313,26.826,15,28,9,13,0,0
5.6,2,17,347.32,5,25,38.8,36.0,37,42.424,39,3,25.307,25.805,15,27,8,12,0,0
5.6,2,14,378.19,1,20,31.338,30.5,31,34.584,33,1,24.182,22.224,11,22,6,11,1,1
5.6,3,23,354.49,5,27,48.36,42.0,49,54.73,52,1,33.875,31.827,20,30,4,22,0,0
7.3,2,23,449.55,5,32,52.822,48.0,52,58.492,55,2,36.614,35.321,21,35,9,20,0,0
5.6,1,18,387.24,5,26,39.127,40.0,38,42.376,41,3,28.455,27.804,17,29,8,12,0,0
8.1,4,26,455.63,3,33,57.749,50.0,58,64.773,61,1,40.745,38.277,20,36,7,25,2,1
7.8,5,22,434.98,5,31,54.207,46.0,54,61.252,58,0,36.995,35.213,17,35,9,23,0,0
5.6,3,20,345.44,4,26,45.022,40.5,45,50.607,48,1,30.813,29.509,17,29,6,19,0,0
5.6,7,28,484.66,7,36,67.752,52.0,68,76.806,71,2,44.841,42.406,21,39,8,32,0,0
5.6,5,27,466.59,6,35,61.101,53.0,61,68.561,64,2,41.557,39.826,21,38,8,26,1,1
7.9,4,26,455.63,4,33,57.749,50.0,58,64.773,61,1,40.745,38.277,20,36,7,25,2,1
5.6,3,15,317.33,4,23,37.28,34.0,36,41.456,38,1,24.165,24.222,12,25,8,13,0,0
5.6,2,17,400.31,2,28,41.112,39.5,38,44.732,40,1,25.671,27.261,15,30,11,10,0,0
5.6,1,21,418.52,4,30,48.643,46.0,48,53.82,51,2,34.159,32.906,20,33,9,18,0,0
5.6,1,21,327.41,5,25,41.818,39.5,42,46.611,45,0,29.801,28.467,20,28,4,17,0,0
5.7,2,24,490.59,7,35,58.065,54.0,57,64.069,60,4,39.591,38.389,22,38,11,22,0,0
5.8,1,16,293.36,4,22,37.254,33.0,37,41.777,39,0,25.29,24.456,15,24,6,15,0,0
8.5,2,25,488.59,6,35,56.923,53.5,56,62.99,60,1,39.62,38.343,23,39,10,21,0,0
5.9,0,19,302.35,2,23,37.16,36.5,37,40.907,40,2,26.489,25.633,19,26,4,14,0,0
4.8,1,14,224.28,1,17,28.949,27.0,29,32.282,31,0,20.273,19.392,13,19,3,12,0,0
6.1,2,18,356.81,2,25,39.873,37.5,39,43.978,42,1,27.841,27.172,16,28,7,14,0,0
6.2,3,27,436.55,7,33,56.898,50.5,57,63.564,61,2,39.546,37.783,24,37,6,24,0,0
5.6,1,16,313.76,5,22,34.702,33.0,34,37.934,36,3,24.591,23.955,15,24,6,12,0,0
5.6,1,16,366.75,2,25,37.014,36.5,35,40.242,37,1,24.955,25.412,15,27,9,10,0,0
5.6,0,11,227.25,0,17,26.604,26.0,26,29.531,28,1,18.006,17.875,11,19,6,9,0,0
5.6,2,19,345.46,3,25,40.003,41.5,40,44.488,44,0,29.483,27.928,17,29,6,15,0,0
6.3,8,20,385.94,5,27,50.996,38.0,51,57.797,54,0,33.955,31.917,12,30,7,24,0,0
6.8,4,16,391.8,0,27,42.887,38.0,41,46.559,43,1,27.966,28.143,11,29,11,14,1,1
7.6,1,20,473.8,4,28,42.665,43.0,42,46.399,45,1,32.904,31.001,19,31,8,14,0,0
8.5,1,21,429.41,3,31,48.072,46.0,46,52.966,49,1,31.563,32.043,20,34,10,15,0,0
8.1,9,28,466.58,2,35,61.109,55.0,61,68.189,68,1,41.762,40.025,19,42,7,26,0,0
5.6,10,35,611.75,11,45,82.618,63.0,82,92.019,87,1,54.142,52.023,25,50,10,37,0,0
6.8,9,26,474.62,6,35,65.196,49.5,65,73.6,69,2,42.534,40.594,17,39,9,30,0,0
5.6,0,15,331.76,3,23,35.207,34.5,34,38.645,36,1,24.324,24.14,15,25,8,11,0,0
5.6,3,25,394.51,6,30,51.687,47.5,52,57.939,56,0,36.33,34.542,22,34,5,22,0,0
5.6,2,17,398.32,3,28,41.927,39.5,39,45.602,41,1,26.188,27.593,15,30,11,11,0,0
5.6,4,22,455.49,4,33,54.647,47.0,53,61.038,56,2,35.398,35.229,18,36,11,20,0,0
4.1,1,9,191.21,2,14,23.611,21.0,23,26.159,24,1,15.21,15.074,8,15,5,9,0,0
5.6,0,14,265.3,2,20,31.487,31.5,31,34.947,33,1,21.767,21.402,14,22,6,11,0,0
7.5,6,36,612.77,8,46,79.141,70.0,79,88.933,85,1,54.336,52.118,30,52,10,33,0,0
5.6,1,16,366.75,2,25,37.014,36.5,35,40.242,37,1,24.955,25.412,15,27,9,10,0,0
5.6,1,15,335.21,3,22,34.8,33.0,34,38.167,36,1,25.0,24.089,14,24,7,12,0,0
5.6,1,16,368.29,2,26,37.716,37.5,35,40.977,37,1,23.972,25.351,15,28,10,9,0,0
5.6,3,21,361.5,6,26,44.778,40.0,45,49.946,48,0,32.211,30.181,18,29,5,19,0,0
5.6,3,22,401.53,2,29,48.098,45.0,48,53.527,52,1,34.461,32.697,19,33,7,19,0,0
5.6,1,16,297.31,5,22,34.891,33.0,34,38.329,36,3,23.671,23.511,15,24,6,12,0,0
5.6,7,23,435.56,8,32,58.389,46.0,58,66.189,61,0,38.046,36.516,16,35,9,26,0,0
5.6,8,17,304.85,3,21,41.691,28.5,42,47.302,44,0,27.938,25.853,9,23,4,21,0,0
8.1,6,28,497.67,4,36,62.96,54.0,63,70.398,67,1,43.961,41.518,20,40,8,27,2,1
8.1,2,25,454.6,4,33,55.083,51.5,55,61.441,59,1,39.228,37.245,23,37,8,22,0,0
8.801,1,22,451.97,4,31,49.749,47.0,49,54.681,52,2,35.773,34.239,21,34,9,18,0,0
5.8,2,13,258.25,2,19,30.047,28.5,29,32.495,31,2,19.875,20.009,11,21,6,10,0,0
5.6,7,23,420.54,7,31,56.287,45.0,56,63.691,59,0,37.04,35.494,16,34,8,25,0,0
5.6,0,12,371.57,1,18,25.676,27.5,25,27.615,27,2,21.273,19.504,12,20,6,7,0,0
5.6,2,17,362.34,3,26,40.902,37.5,39,44.922,41,1,26.313,26.826,15,28,9,13,0,0
5.6,11,21,374.53,9,27,56.883,34.0,57,64.647,58,3,35.489,33.277,10,28,6,30,0,0
5.7,0,14,271.72,2,19,29.491,30.0,29,32.309,31,1,21.375,20.714,14,21,5,10,0,0
5.6,6,18,359.9,5,25,47.112,34.0,47,53.382,49,1,31.194,29.391,12,27,7,22,0,0
5.6,3,16,314.8,5,22,37.36,32.5,37,41.638,39,0,25.904,24.789,13,24,6,15,0,0
5.6,4,22,403.52,4,29,47.283,46.5,47,52.658,52,0,33.944,32.365,18,34,7,18,0,0
5.6,1,21,343.41,4,26,43.145,41.0,43,47.82,46,1,30.256,29.181,20,29,5,17,0,0
6.4,0,20,313.38,3,24,38.934,39.0,39,43.196,42,1,28.04,26.94,20,27,4,15,0,0
5.6,0,12,277.75,2,18,26.684,28.0,26,28.814,28,0,20.261,19.374,12,20,6,8,0,0
5.6,1,14,347.74,4,24,35.793,35.0,34,38.519,35,2,23.989,24.374,12,25,10,10,1,1
7.5,6,28,483.69,5,35,63.516,52.0,64,71.603,67,1,44.267,41.33,20,38,7,29,2,1
5.6,3,21,345.43,4,26,45.029,40.0,45,50.235,48,0,31.017,29.708,18,29,5,19,0,0
7.2,11,23,474.54,6,34,60.523,46.0,59,67.995,63,2,38.131,37.503,12,38,11,25,0,0
7.4,11,31,560.71,7,41,75.545,58.0,75,85.316,80,1,49.239,47.227,20,46,10,34,0,0
5.6,6,22,386.5,7,29,51.007,45.0,51,57.521,54,1,34.58,33.058,15,32,7,22,1,1
5.6,0,20,346.39,3,26,41.549,41.0,41,46.034,44,1,28.983,28.345,20,29,6,15,0,0
5.6,3,18,307.38,3,23,40.145,34.0,40,44.82,42,3,27.256,26.181,15,25,5,17,0,0
5.6,1,19,317.44,4,23,37.683,37.0,38,41.906,41,0,28.233,26.412,18,26,4,15,0,0
5.2,0,14,236.3,2,18,29.942,29.0,30,33.654,32,1,21.068,20.193,14,20,4,12,0,0
7.5,0,14,413.08,3,21,32.836,30.0,32,35.673,33,2,24.438,23.178,14,22,7,11,0,0
4.2,1,13,210.25,1,16,26.065,25.0,26,28.867,28,1,18.512,17.865,12,18,3,10,0,0
8.3,6,28,499.59,4,37,63.723,55.0,63,71.027,67,1,42.705,41.429,20,41,9,26,2,1
7.6,8,22,437.63,6,31,57.952,43.5,58,65.77,61,1,38.756,36.32,14,34,9,27,0,0
6.9,6,21,375.53,5,28,52.665,40.5,53,60.225,56,1,34.893,32.891,15,31,7,25,0,0
5.6,1,16,373.23,3,23,36.709,34.5,36,40.33,38,1,26.091,25.174,15,25,7,13,0,0
5.6,2,23,383.49,6,29,49.905,45.0,50,56.023,53,2,34.574,33.036,21,32,6,21,0,0
8.699,1,20,359.42,3,27,44.465,42.0,44,49.402,47,1,30.506,29.697,19,30,7,17,0,0
5.8,4,28,542.68,6,38,60.822,58.5,60,66.408,65,2,43.989,42.06,24,43,10,22,0,0
5.6,4,29,545.66,7,39,66.949,58.0,66,73.654,70,3,45.529,43.862,25,43,10,27,0,0
6.3,6,20,352.48,8,26,49.898,37.0,50,56.564,52,1,32.546,30.783,14,28,6,24,0,0
7.2,11,29,527.69,8,39,72.181,57.0,72,81.514,77,0,47.302,45.143,18,44,10,33,0,0
5.6,0,13,291.15,2,19,27.705,29.5,27,30.127,29,0,21.023,20.321,13,21,6,8,0,0
5.8,3,15,297.35,5,22,37.582,32.0,37,41.986,38,1,24.745,24.171,11,23,7,15,1,1
5.6,2,15,363.31,4,21,36.014,31.0,36,40.246,38,0,26.591,24.459,13,23,6,15,0,0
5.6,2,22,374.45,4,28,47.316,43.0,47,52.864,50,1,32.506,31.398,20,31,6,19,0,0
5.6,3,21,376.52,5,27,46.88,41.5,47,52.444,50,1,33.216,31.202,18,30,6,20,0,0
4.1,2,13,243.29,2,18,31.378,26.0,31,34.99,32,4,20.733,20.128,11,19,5,13,0,0
5.6,3,18,303.4,3,23,39.811,36.5,40,44.983,43,0,27.597,26.268,15,26,5,17,0,0
5.6,1,20,359.42,3,27,44.465,42.0,44,49.402,47,1,30.506,29.697,19,30,7,17,0,0
5.6,3,18,339.45,5,24,41.222,35.5,41,45.74,43,1,28.904,27.369,15,26,6,17,0,0
5.6,0,13,301.16,2,18,27.287,28.5,27,30.08,29,0,20.659,19.691,13,20,5,9,0,0
5.6,7,23,454.53,7,33,58.127,47.0,57,65.24,60,0,37.432,36.593,16,36,10,24,0,0
7.6,9,22,425.54,8,31,58.538,42.5,58,65.896,61,0,37.222,35.761,13,34,9,27,0,0
6.0,6,19,391.44,7,28,49.327,39.0,48,55.457,50,1,31.148,30.713,13,30,9,20,0,0
6.4,5,19,372.86,3,26,44.64,38.0,44,49.808,47,1,30.364,29.226,14,29,7,18,0,0
5.6,9,25,464.6,9,34,63.381,48.0,63,71.731,66,0,41.017,39.263,16,37,9,29,0,0
5.6,4,17,444.23,5,27,42.24,37.5,40,45.89,42,3,27.875,28.071,13,29,10,13,0,0
5.6,3,13,278.78,1,18,29.349,26.5,29,32.146,31,1,21.779,20.406,10,20,5,11,0,0
5.6,0,21,377.85,4,27,43.469,41.5,43,47.764,46,0,31.114,30.009,21,30,6,16,0,0
5.6,1,23,439.54,4,32,49.534,53.0,49,54.694,54,1,35.949,34.686,22,37,9,17,0,0
5.6,3,18,306.41,2,22,35.909,35.0,36,39.617,39,0,26.682,25.106,13,25,4,14,2,1
8.3,1,21,391.44,4,29,47.862,44.0,47,53.156,50,1,32.205,31.608,20,32,8,18,0,0
5.6,2,17,276.37,3,21,36.709,32.0,37,41.484,39,0,25.591,24.246,15,23,4,16,0,0
5.6,3,17,315.35,4,23,38.843,34.0,38,43.29,40,1,25.676,25.233,14,25,6,15,0,0
8.699,2,22,389.47,3,29,49.418,44.0,49,55.362,52,1,33.512,32.42,20,32,7,20,0,0
5.6,8,34,560.7,8,42,74.087,62.0,74,82.644,79,1,50.5,48.32,25,47,8,32,1,1
5.6,2,25,394.51,6,30,51.687,46.5,52,57.939,55,2,36.33,34.542,23,33,5,22,0,0
6.9,5,18,305.36,1,23,38.262,35.0,38,42.405,41,1,26.495,25.655,12,26,5,15,1,1
8.6,2,21,426.44,3,31,49.661,46.0,48,55.125,51,1,32.631,32.681,19,34,10,17,0,0
5.6,0,12,261.75,2,17,25.356,27.0,25,27.605,27,0,19.807,18.659,12,19,5,8,0,0
5.6,3,21,332.43,6,25,44.811,37.0,45,50.152,47,1,30.773,29.214,18,27,4,20,0,0
5.6,2,18,430.98,6,28,43.833,42.5,43,48.059,46,1,32.449,30.679,16,31,10,15,0,0
5.6,6,15,273.37,3,20,39.029,27.0,39,44.235,40,3,25.017,23.708,9,21,5,19,0,0
6.4,4,17,342.46,5,24,42.323,34.0,42,47.238,44,2,28.909,27.39,13,26,7,18,0,0
5.6,6,19,399.82,6,27,45.782,36.0,44,50.242,46,1,29.654,29.411,13,29,8,17,0,0
5.6,2,19,348.39,3,26,42.691,40.5,42,47.113,45,1,28.955,28.391,17,29,7,16,0,0
5.6,1,22,384.45,4,29,46.425,46.5,46,51.821,50,0,32.54,31.673,21,33,7,17,0,0
8.699,3,22,386.5,3,29,51.007,44.0,51,57.521,54,1,34.58,33.058,19,32,7,22,0,0
5.6,9,24,448.55,4,33,58.614,47.0,58,65.9,62,4,38.495,37.209,15,37,9,25,0,0
4.6,2,8,195.27,1,13,22.36,19.5,22,24.87,23,1,15.404,14.547,6,14,5,9,0,0
6.2,0,17,260.31,1,20,31.949,33.0,32,35.282,35,2,23.273,22.392,17,23,3,12,0,0
6.0,4,25,505.6,6,36,60.174,55.0,59,66.195,63,4,40.801,39.609,21,40,11,23,0,0
5.6,4,21,451.56,7,32,53.956,47.5,53,59.943,56,2,36.381,35.169,17,35,11,21,0,0
5.4,5,12,232.32,2,17,33.036,24.0,33,37.694,34,1,21.046,19.961,7,18,5,16,0,0
5.6,3,18,360.37,3,26,42.458,37.5,41,47.128,43,1,27.62,27.638,15,28,8,15,0,0
5.6,6,22,420.49,4,31,52.847,46.5,52,59.07,56,1,34.972,34.156,16,35,9,21,0,0
5.6,1,17,367.49,3,25,38.524,39.5,38,42.202,41,1,28.824,27.303,16,28,8,13,0,0
7.0,2,19,292.38,4,22,38.785,33.0,39,43.658,41,0,27.04,25.641,17,24,3,17,0,0
6.7,6,17,343.85,3,24,42.345,35.0,42,47.551,45,0,28.671,27.337,11,27,7,18,0,0
5.6,5,21,390.49,7,29,51.334,43.5,51,57.73,54,1,34.034,32.772,16,32,8,22,0,0
8.801,1,21,393.43,3,29,47.047,44.0,46,52.287,49,1,31.688,31.276,20,32,8,17,0,0
5.6,6,18,340.49,3,24,43.88,35.5,44,49.444,47,1,30.216,28.202,12,27,6,20,0,0
5.6,2,20,363.47,5,26,43.222,40.5,43,47.74,46,1,30.904,29.369,18,29,6,17,0,0
5.6,1,18,475.36,7,29,45.316,44.0,44,49.456,46,2,32.205,31.119,16,31,11,15,1,1
7.0,10,28,548.1,8,39,69.621,57.0,69,78.043,74,0,46.398,44.443,18,44,11,30,0,0
4.6,0,12,210.26,1,16,26.058,26.0,26,29.239,28,0,18.307,17.666,12,18,4,10,0,0
5.6,8,20,355.48,9,26,51.007,35.5,51,57.69,53,2,32.756,31.003,12,28,6,25,0,0
5.6,4,19,374.4,4,27,45.341,38.5,44,50.543,46,1,29.381,29.165,15,29,8,17,0,0
5.6,1,15,285.75,3,20,32.374,31.0,32,35.724,34,1,23.137,22.241,14,22,5,12,0,0
5.6,5,19,352.5,4,25,44.88,37.5,45,50.444,48,2,31.216,29.202,14,28,6,20,0,0
5.6,6,22,406.51,6,30,53.403,44.0,53,60.276,56,0,35.279,33.968,16,33,8,23,0,0
5.6,3,23,400.47,6,30,50.458,46.0,50,55.943,54,1,34.478,33.444,20,34,7,20,0,0
5.6,3,20,446.4,8,27,47.218,40.5,47,52.412,49,3,33.779,31.447,17,29,7,20,0,0
4.0,0,11,244.3,2,17,25.578,27.5,25,27.953,27,1,18.648,18.041,11,19,6,8,0,0
6.7,1,21,428.47,3,30,46.534,45.0,45,51.048,48,1,32.267,31.825,20,33,9,15,0,0
5.6,5,18,331.82,6,23,41.36,32.0,41,45.807,43,1,28.08,26.735,13,25,5,18,0,0
8.0,1,26,469.58,4,34,54.494,53.0,54,60.282,58,1,39.159,37.607,25,38,8,20,0,0
6.9,1,29,502.64,6,37,59.083,59.5,59,65.441,64,1,43.228,41.245,28,42,8,22,0,0
6.6,6,14,277.36,3,20,39.356,26.0,39,44.445,40,2,24.472,23.423,8,21,6,19,0,0
5.6,2,17,377.37,3,26,37.993,39.5,36,40.929,39,0,26.193,26.465,15,29,9,10,0,0
5.6,0,18,365.45,4,26,41.658,42.0,41,45.906,44,2,29.392,28.358,18,29,8,15,0,0
5.6,2,22,425.97,5,29,49.313,42.0,49,54.515,51,2,35.284,33.25,20,31,7,20,0,0
7.3,0,22,383.51,3,28,44.887,46.0,45,49.903,49,1,33.245,31.455,22,32,6,17,0,0
6.0,10,28,453.64,7,34,64.323,50.0,65,73.099,70,0,43.381,40.67,18,39,6,31,0,0
7.9,2,25,506.58,5,36,57.436,54.5,56,63.33,60,1,39.557,38.726,23,40,11,20,0,0
7.1,1,22,386.51,5,28,45.996,44.0,46,51.029,49,2,33.455,31.675,21,31,6,18,0,0
5.6,1,19,368.86,2,25,38.56,38.0,38,41.771,41,1,28.994,27.648,18,28,6,13,0,0
6.9,4,12,233.3,2,17,32.262,23.0,32,36.405,33,5,20.495,19.655,8,18,5,15,0,0
5.6,0,20,404.49,4,29,45.76,45.0,45,50.405,48,2,32.398,31.379,20,32,9,16,0,0
5.6,2,20,375.42,4,28,45.793,43.0,45,50.611,48,4,30.96,30.412,18,31,8,17,0,0
4.0,0,14,221.28,2,17,27.84,28.0,28,31.156,30,1,20.063,19.171,14,19,3,11,0,0
6.1,3,15,268.35,3,20,36.036,30.0,36,40.694,38,3,24.046,22.961,12,22,5,16,0,0
8.2,2,24,492.51,4,36,56.865,54.5,55,63.121,59,1,37.642,37.723,22,40,12,19,0,0
8.5,1,21,393.43,3,29,47.047,44.0,46,52.287,49,1,31.688,31.276,20,32,8,17,0,0
5.6,0,11,241.3,1,17,24.469,28.5,24,26.827,26,0,18.438,17.821,10,19,6,7,1,1
6.5,2,19,428.52,8,30,51.182,44.0,50,56.654,52,3,33.83,32.862,17,32,11,20,0,0
5.6,3,15,269.33,3,20,35.262,29.5,35,39.405,37,2,23.495,22.655,12,22,5,15,0,0
5.6,5,21,462.44,5,30,51.513,42.5,51,57.246,54,1,36.699,34.405,16,33,9,21,0,0
5.6,7,17,363.45,2,25,43.945,34.0,43,48.704,46,3,29.057,27.993,10,28,8,18,0,0
7.1,6,31,568.76,9,41,73.156,61.0,73,81.936,77,3,49.944,47.308,25,45,10,32,0,0
4.2,1,10,156.2,0,12,19.854,19.5,20,22.242,22,0,14.296,13.623,9,14,2,8,0,0
6.1,4,16,252.34,1,19,34.716,29.0,35,39.112,37,0,23.796,22.445,12,21,3,16,0,0
5.6,1,14,254.29,2,19,30.454,29.5,30,33.994,32,0,21.006,20.576,13,21,5,11,0,0
5.6,2,14,241.32,5,18,32.934,26.0,33,37.196,34,1,22.04,20.94,12,19,4,15,0,0
5.6,2,17,304.39,3,23,39.029,36.5,39,44.066,42,0,26.841,25.762,15,26,6,16,0,0
7.5,4,27,498.66,6,36,62.178,54.5,62,69.481,66,1,43.205,41.013,23,40,9,26,0,0
5.6,1,18,380.41,3,27,40.327,42.0,39,43.412,42,5,28.534,28.239,16,30,9,12,1,1
4.4,0,13,210.25,1,16,26.065,26.0,26,28.867,28,0,18.512,17.865,13,18,3,10,0,0
5.6,1,14,251.26,1,19,28.611,31.5,28,31.159,30,1,20.21,20.074,12,21,5,9,1,1
5.6,6,19,380.29,6,25,44.567,34.0,44,49.167,46,1,30.699,29.089,13,27,6,19,0,0
5.6,2,20,317.42,5,24,42.702,36.0,43,48.026,45,1,29.563,27.993,18,26,4,19,0,0
5.6,2,23,399.46,5,30,48.534,47.5,48,53.947,52,0,33.75,32.893,21,34,7,18,0,0
5.9,0,13,288.16,1,17,27.069,27.0,27,29.997,29,0,20.415,19.197,13,19,4,10,0,0
5.6,0,16,289.32,2,22,33.487,36.5,33,36.947,36,1,23.767,23.402,16,25,6,11,0,0
5.6,0,13,238.27,2,18,28.385,29.0,28,31.448,30,1,19.762,19.381,13,20,5,10,0,0
5.6,4,29,461.61,7,35,61.556,53.5,62,69.268,66,3,42.858,40.617,25,39,6,27,0,0
5.6,0,20,405.43,4,30,47.298,46.0,46,52.323,49,2,31.693,31.597,20,33,10,16,0,0
5.6,1,19,335.81,2,24,38.258,38.0,38,42.14,41,0,27.898,26.767,18,27,5,14,0,0
5.6,7,28,427.58,7,32,60.454,47.0,61,67.939,64,1,41.029,38.541,21,35,4,29,0,0
6.4,2,22,390.45,4,29,48.643,44.0,48,54.073,51,1,32.961,32.113,20,32,7,19,0,0
8.6,8,22,398.53,7,29,56.178,39.5,56,63.734,58,3,36.006,34.22,14,31,7,27,0,0
5.6,4,20,360.43,5,27,44.425,42.0,44,49.821,48,0,30.54,29.673,16,31,7,17,0,0
5.6,2,16,265.34,4,20,34.934,30.5,35,39.196,37,0,24.04,22.94,14,22,4,15,0,0
4.2,0,13,209.27,1,16,26.84,26.0,27,30.156,29,0,19.063,18.171,13,18,3,11,0,0
5.6,4,22,427.36,6,29,49.334,43.0,49,54.827,52,0,35.046,33.197,18,32,7,20,0,0
5.8,3,25,454.53,7,34,56.662,52.5,56,62.94,60,1,38.489,37.487,22,38,9,22,0,0
5.6,10,28,453.64,7,34,64.323,50.0,65,73.099,70,0,43.381,40.67,18,39,6,31,0,0
5.6,3,15,388.39,6,28,45.985,40.0,44,50.694,46,2,28.364,28.852,12,30,13,16,0,0
5.6,4,22,380.45,6,28,49.534,40.0,49,55.117,51,1,32.926,31.839,18,30,6,21,0,0
6.0,7,20,429.9,6,30,51.211,42.0,50,56.595,52,2,33.796,33.008,12,32,10,20,1,1
5.6,1,18,290.34,2,22,36.16,34.5,36,39.907,39,1,25.489,24.633,17,25,4,14,0,0
5.6,5,21,392.48,6,29,50.52,43.0,50,56.861,53,0,33.517,32.441,16,32,8,21,0,0
5.6,0,19,384.79,3,27,39.502,42.0,38,42.902,41,1,28.017,28.029,19,30,8,11,0,0
5.6,4,33,585.74,8,43,70.28,67.5,70,77.979,76,2,50.211,48.034,29,49,10,27,0,0
5.6,2,18,388.23,4,24,38.825,35.0,38,42.084,40,3,27.506,26.593,16,26,6,14,0,0
5.6,8,17,299.41,3,22,42.912,30.0,43,48.651,45,3,27.779,26.235,9,24,5,21,0,0
5.6,4,20,399.45,4,28,44.247,41.0,43,48.42,47,3,30.779,30.135,16,32,8,15,0,0
6.7,6,17,343.85,3,24,42.345,35.0,42,47.551,45,0,28.671,27.337,11,27,7,18,0,0
5.6,6,22,424.5,6,31,53.916,45.0,53,60.615,56,0,35.216,34.351,16,34,9,22,0,0
5.6,6,29,479.63,9,36,64.767,54.5,65,72.893,69,1,44.074,41.858,23,40,7,29,0,0
5.6,10,32,747.02,17,54,104.945,71.0,104,120.613,105,10,64.444,61.76,22,55,22,50,0,0
5.9,2,20,301.42,1,23,41.374,35.0,42,46.817,45,0,29.108,27.279,18,26,3,19,0,0
4.3,1,12,215.29,1,15,24.04,23.5,24,26.289,26,1,18.154,17.031,11,17,3,9,0,0
5.6,9,25,446.58,8,33,60.17,48.0,60,68.106,64,0,39.802,38.021,16,37,8,27,0,0
5.6,3,21,331.45,7,25,45.585,37.0,46,51.441,48,1,31.324,29.52,18,27,4,21,0,0
4.2,0,4,174.63,0,10,13.807,15.5,13,14.857,14,0,10.528,10.1,4,11,6,3,0,0
5.6,4,29,434.54,3,33,55.763,51.5,56,62.113,61,2,39.779,37.936,25,38,4,23,0,0
5.8,10,18,373.53,5,26,49.192,39.0,49,55.567,53,2,32.438,30.465,8,30,8,23,0,0
5.7,7,22,407.52,6,30,55.327,42.0,55,62.272,58,0,36.006,34.519,15,33,8,25,0,0
7.2,2,22,373.51,3,27,45.778,42.0,46,50.946,49,1,33.211,31.181,20,30,5,19,0,0
5.6,0,10,220.62,0,15,20.949,24.0,20,22.19,22,2,15.301,15.354,10,17,5,5,0,0
5.6,3,16,330.45,5,23,41.323,35.0,41,46.238,43,2,27.909,26.39,13,25,7,18,0,0
5.6,0,15,280.31,2,21,33.596,32.5,33,37.073,35,1,22.977,22.622,15,23,6,12,0,0
5.6,2,19,348.39,4,26,42.691,40.0,42,47.113,45,3,28.955,28.391,17,29,7,16,0,0
5.8,2,20,370.45,5,26,42.702,38.0,42,47.127,44,1,30.08,28.926,18,28,6,16,0,0
4.1,2,7,179.21,0,13,22.604,18.0,22,25.531,23,1,14.006,13.875,5,14,6,9,0,0
5.6,0,13,273.14,1,16,24.967,26.0,25,27.499,27,0,19.409,18.175,13,18,3,9,0,0
5.6,2,27,567.66,10,39,62.771,59.0,61,68.083,64,5,43.591,42.378,25,42,12,22,0,0
4.7,0,9,220.63,0,15,20.942,23.5,20,22.562,22,1,15.097,15.155,9,17,6,5,0,0
4.1,0,13,194.25,1,15,24.738,25.0,25,27.657,27,0,18.057,17.15,13,17,2,10,0,0
5.6,6,18,411.48,7,30,52.2,43.0,51,58.604,54,2,32.983,32.498,12,33,12,21,0,0
5.6,9,21,429.53,7,31,56.901,43.0,56,64.529,59,1,35.983,34.899,12,34,10,25,0,0
5.6,2,24,399.9,3,29,47.025,45.0,47,51.97,51,3,34.421,32.821,22,33,5,18,0,0
5.6,3,15,284.35,5,21,37.363,31.0,37,41.903,39,0,24.5,23.676,12,23,6,16,0,0
6.1,1,13,269.29,3,20,31.814,32.0,31,35.156,33,2,21.222,21.117,12,22,7,11,0,0
5.6,11,33,776.07,18,56,109.93,73.0,109,126.526,110,10,67.211,64.308,22,57,23,53,0,0
7.5,2,18,353.43,3,25,40.665,38.0,40,44.534,43,2,28.597,27.557,16,28,7,15,0,0
6.2,1,15,345.19,1,21,31.683,34.0,31,34.835,34,0,23.358,22.601,14,24,6,10,0,0
6.3,5,12,297.85,5,19,35.211,25.5,35,39.847,36,0,24.103,22.282,7,20,7,16,0,0
5.6,0,19,348.81,3,25,38.476,40.0,38,42.223,41,1,28.142,27.262,19,28,6,13,0,0
5.6,1,19,379.48,5,27,44.542,43.0,44,49.322,47,2,31.154,29.885,18,30,8,17,0,0
5.6,3,15,289.79,5,20,36.142,28.0,36,40.555,37,1,24.659,23.294,12,21,5,16,0,0
5.6,3,23,371.47,7,28,48.912,43.0,49,54.651,52,1,33.779,32.235,20,31,5,21,0,0
6.8,4,20,479.99,9,32,55.498,45.0,54,61.139,56,2,36.659,35.437,16,34,12,22,0,0
6.0,0,21,405.42,4,30,47.305,46.0,46,51.951,49,2,31.898,31.796,21,33,9,16,0,0
5.6,4,22,361.48,9,27,49.796,39.0,50,56.066,52,1,33.54,31.762,18,29,5,23,0,0
5.9,5,13,226.31,1,17,30.825,26.0,31,35.069,33,0,20.83,19.72,6,19,4,14,2,1
6.1,0,21,401.48,4,29,44.658,47.0,44,48.906,48,1,32.392,31.358,21,33,8,15,0,0
8.5,3,26,486.62,6,35,58.48,53.5,58,65.196,62,1,40.926,39.155,23,39,9,23,0,0
8.9,1,21,393.43,3,29,47.047,44.0,46,52.287,49,1,31.688,31.276,20,32,8,17,0,0
5.6,8,24,450.54,7,33,57.8,48.0,57,65.031,61,0,37.978,36.878,16,37,9,24,0,0
5.9,0,13,273.14,1,16,24.967,26.0,25,27.499,27,0,19.409,18.175,13,18,3,9,0,0
4.2,1,14,237.28,2,18,29.167,29.0,29,32.365,31,1,20.517,19.886,13,20,4,11,0,0
5.7,1,17,370.22,3,23,35.607,36.0,35,38.831,37,1,26.085,25.153,15,25,6,12,1,1
8.0,3,25,505.67,5,35,58.596,54.0,58,64.697,61,3,41.54,39.367,20,38,10,23,2,1
5.6,3,29,480.58,8,36,61.294,55.0,61,68.319,65,1,42.245,40.693,26,40,7,25,0,0
5.6,8,14,247.38,3,18,38.585,23.0,39,44.441,40,1,24.324,22.52,6,19,4,21,0,0
5.6,1,15,333.3,2,24,35.909,35.5,34,39.381,36,1,23.341,24.079,14,26,9,10,0,0
5.6,3,16,265.34,3,20,34.934,31.0,35,39.196,37,1,24.04,22.94,13,22,4,15,0,0
8.801,1,21,375.44,3,28,46.534,43.0,46,51.947,49,1,31.75,30.893,20,31,7,18,0,0
5.6,2,21,387.5,2,28,45.214,44.0,45,50.112,49,1,32.699,31.17,19,32,7,17,0,0
5.6,3,19,338.46,5,24,42.003,35.5,42,46.657,44,1,29.659,27.874,16,26,5,18,0,0
5.6,0,15,344.8,3,23,33.113,36.5,32,35.522,35,0,24.722,24.11,15,26,8,9,0,0
5.6,2,17,293.35,3,22,37.262,33.0,37,41.405,39,3,25.495,24.655,15,24,5,15,0,0
7.3,3,22,482.44,7,30,50.211,45.5,50,55.784,53,2,36.574,34.248,19,33,8,20,0,0
5.6,8,29,499.67,9,37,69.861,53.0,70,78.933,73,2,46.052,43.627,21,40,8,33,0,0
4.5,1,10,235.09,0,13,20.084,20.5,20,22.084,22,0,15.648,14.648,9,15,3,7,0,0
5.6,4,16,266.38,3,20,37.592,30.0,38,42.9,40,0,25.353,23.773,12,22,4,18,0,0
6.2,1,29,537.08,7,38,59.407,60.5,59,65.385,64,1,44.085,42.072,28,43,9,21,0,0
6.8,1,18,367.82,1,26,40.905,39.0,40,44.93,43,1,28.602,27.998,17,29,8,14,0,0
5.6,1,20,377.38,3,28,44.244,43.0,43,48.033,46,3,29.858,29.799,19,31,8,15,0,0
4.8,0,8,176.2,1,13,21.502,19.0,21,24.033,22,2,14.0,13.854,8,14,5,8,0,0
5.6,1,23,430.45,5,32,49.265,50.5,48,54.37,52,1,33.932,33.771,22,36,9,16,0,0
5.6,6,17,308.43,3,23,42.796,34.0,43,48.896,46,0,28.364,26.816,11,26,6,20,0,0
5.6,6,22,440.5,7,32,55.243,46.0,54,61.825,57,0,35.671,35.066,16,35,10,22,0,0
4.0,1,11,201.25,2,15,26.167,22.5,26,29.365,27,1,17.517,16.886,10,16,4,11,0,0
6.1,3,18,308.42,5,23,42.803,34.0,43,48.524,45,1,28.569,27.015,15,25,5,20,0,0
6.4,0,17,317.4,2,23,34.236,38.5,34,37.657,37,0,25.96,24.875,16,26,6,11,1,1
5.6,3,19,346.43,4,26,44.24,40.5,44,49.69,47,1,30.057,29.004,16,29,7,18,0,0
6.35,0,13,210.25,1,16,26.065,25.5,26,28.867,28,2,18.512,17.865,13,18,3,10,0,0
5.6,5,26,421.54,3,32,54.789,50.5,55,61.438,60,0,38.336,36.563,21,37,6,23,0,0
8.9,1,21,393.43,3,29,47.047,44.0,46,52.287,49,1,31.688,31.276,20,32,8,17,0,0
5.6,4,15,295.4,1,21,34.12,33.5,34,38.072,37,0,24.722,23.401,10,24,6,13,1,1
5.6,0,14,255.31,2,18,27.367,29.0,27,29.498,29,1,20.608,19.745,14,20,4,9,0,0
5.6,5,21,410.47,5,30,51.032,44.0,50,57.2,53,0,33.455,32.824,16,33,9,20,0,0
5.6,4,24,424.5,3,32,52.451,50.5,52,58.315,57,3,36.273,35.246,20,37,8,20,0,0
5.6,3,22,361.45,6,27,47.098,41.0,47,52.781,50,0,32.262,30.904,19,30,5,20,0,0
5.6,9,24,443.51,3,32,57.101,45.0,56,63.915,60,1,36.875,35.965,15,36,8,24,0,0
5.6,7,21,410.47,4,30,51.032,44.5,50,57.2,54,0,33.455,32.824,14,34,9,20,0,0
6.5,9,23,426.99,7,30,56.989,41.5,57,64.338,60,0,37.926,35.664,14,33,7,27,0,0
8.6,7,28,534.72,10,38,69.341,54.0,69,78.066,72,2,46.427,43.977,21,41,10,31,0,0
5.6,6,26,460.58,7,34,62.32,48.0,62,69.813,65,2,40.978,39.266,20,37,8,28,0,0
5.6,3,24,400.46,5,30,50.465,45.0,50,55.571,53,3,34.682,33.643,21,33,6,20,0,0
5.6,6,11,359.2,1,18,32.323,25.0,32,36.498,34,0,22.949,20.773,5,20,7,14,0,0
6.5,4,16,267.36,5,20,36.818,30.0,37,41.611,39,0,24.801,23.467,12,22,4,17,0,0
5.6,6,18,279.36,1,21,37.825,31.5,38,42.239,41,2,26.006,24.665,12,24,3,17,0,0
4.2,2,8,210.29,1,14,24.462,20.5,24,27.368,25,1,16.409,15.568,6,15,6,10,0,0
5.6,3,21,366.87,6,26,45.134,38.0,45,50.096,47,1,31.631,30.041,18,28,5,19,0,0
6.5,0,20,349.36,3,26,39.96,41.0,39,43.875,42,1,27.915,27.706,20,29,6,13,0,0
5.6,5,18,323.44,6,24,44.905,35.0,45,51.023,47,1,29.574,28.036,13,26,6,21,0,0
5.6,2,11,265.32,3,18,29.898,26.0,29,32.704,30,2,20.074,19.503,9,19,7,11,0,0
6.1,5,19,338.42,3,25,44.316,37.0,44,49.864,47,1,29.506,28.398,14,28,6,19,0,0
5.5,1,13,227.26,1,17,27.353,27.0,27,30.495,29,0,19.0,18.555,12,19,4,10,0,0
5.9,4,32,611.73,9,44,72.189,66.5,71,80.074,76,1,49.847,48.328,28,49,12,27,0,0
6.2,2,20,315.4,3,24,40.818,37.5,41,45.611,44,2,28.801,27.467,18,27,4,17,0,0
6.4,1,17,387.27,2,23,34.582,35.5,34,37.253,36,3,26.727,25.319,15,25,6,11,1,1
5.6,2,17,339.46,6,24,41.214,35.5,41,46.112,43,1,28.699,27.17,15,26,7,17,0,0
5.6,1,18,290.34,2,22,36.16,35.0,36,39.907,39,2,25.489,24.633,17,25,4,14,0,0
5.6,3,20,334.4,4,25,43.254,37.5,43,47.946,46,1,29.466,28.402,17,28,5,18,0,0
5.6,5,16,312.36,2,23,39.691,34.5,39,44.113,42,1,25.955,25.391,11,26,7,16,0,0
5.6,8,23,441.95,7,31,55.658,43.5,55,61.844,58,1,37.068,35.546,15,34,8,24,0,0
5.6,5,23,405.56,5,29,51.872,43.5,52,57.986,55,1,36.188,33.949,18,32,6,23,0,0
5.6,2,15,316.42,4,22,38.44,34.0,38,42.823,40,2,26.148,24.863,13,24,7,16,0,0
7.8,11,29,482.69,5,36,69.309,52.0,70,79.012,75,0,46.148,43.218,18,41,7,34,0,0
6.9,1,21,411.42,3,30,47.56,45.0,46,52.626,49,1,31.625,31.659,20,33,9,16,0,0
5.7,1,21,343.41,4,26,43.145,41.0,43,47.82,46,1,30.256,29.181,20,29,5,17,0,0
7.4,2,23,433.59,3,30,49.182,49.0,49,54.075,53,2,36.313,34.082,21,34,7,19,0,0
5.8,6,17,327.85,3,23,41.018,34.0,41,46.342,44,0,28.216,26.622,11,26,6,18,0,0
5.6,4,18,307.38,2,23,40.145,35.0,40,44.82,43,1,27.256,26.181,14,26,5,17,0,0
5.6,2,19,440.81,3,30,45.622,42.0,43,49.621,45,4,29.87,30.564,17,32,11,13,0,0
7.1,2,30,516.67,7,38,61.967,60.5,62,68.856,67,1,44.989,42.771,28,43,8,24,0,0
7.4,4,19,362.5,6,26,43.989,40.5,44,49.401,48,0,31.25,29.476,15,30,7,18,0,0
5.6,4,19,353.48,5,25,44.105,36.5,44,49.155,46,1,30.665,28.895,15,27,6,19,0,0
5.6,2,21,389.45,6,29,48.676,44.0,48,54.026,51,1,32.722,31.939,19,32,8,19,0,0
5.6,3,17,363.27,5,24,40.567,35.0,40,44.997,42,1,28.523,27.143,14,26,7,16,0,0
5.6,5,22,427.47,6,31,52.327,45.0,51,58.457,54,0,34.148,33.713,17,34,9,20,0,0
5.6,6,18,356.48,9,26,50.218,35.0,50,57.145,51,2,31.796,30.299,12,27,8,24,0,0
5.6,3,16,314.8,4,22,37.36,33.0,37,41.638,39,1,25.904,24.789,13,24,6,15,0,0
5.6,3,21,332.43,6,25,44.811,37.0,45,50.152,47,1,30.773,29.214,18,27,4,20,0,0
7.7,1,20,447.45,3,31,46.265,46.0,44,50.471,47,1,31.449,31.703,19,34,11,13,0,0
5.7,0,9,305.59,1,15,21.811,22.0,21,23.157,22,1,17.608,16.378,9,16,6,6,0,0
5.6,7,29,514.63,10,38,68.531,55.0,68,76.438,71,3,45.193,43.508,22,41,9,30,0,0
5.6,0,20,347.82,3,25,39.258,40.0,39,43.14,42,1,28.898,27.767,20,28,5,14,0,0
5.6,5,17,278.39,2,21,38.592,32.0,39,43.9,42,0,26.353,24.773,12,24,4,18,0,0
5.6,3,20,409.45,5,29,45.32,44.0,44,48.953,47,5,31.506,30.986,16,32,9,15,1,1
5.0,3,9,193.23,1,14,25.494,19.5,25,28.575,26,2,15.972,15.601,6,15,5,11,0,0
5.6,2,23,385.45,8,29,48.356,44.0,48,53.445,51,3,33.472,32.423,21,32,6,19,0,0
8.6,8,29,530.76,10,38,71.712,54.0,72,81.141,75,2,48.25,45.12,21,41,9,34,0,0
5.6,2,20,302.4,4,23,40.6,35.0,41,45.528,43,1,28.557,26.972,18,25,3,18,0,0
7.2,6,19,381.56,5,27,49.858,38.5,50,56.73,53,0,33.779,31.551,13,30,8,23,0,0
5.6,5,23,342.47,4,26,47.367,39.0,48,53.358,51,1,33.08,31.026,18,29,3,22,0,0
5.6,0,14,254.33,2,18,28.142,29.0,28,30.787,30,1,21.159,20.052,14,20,4,10,0,0
5.6,1,19,344.41,5,26,42.356,41.0,42,47.275,45,1,29.296,28.477,18,29,7,16,0,0
5.6,1,14,224.28,0,17,28.949,26.0,29,32.282,31,1,20.273,19.392,13,19,3,12,0,0
5.6,1,17,357.32,2,26,37.909,39.5,36,41.381,38,1,25.341,26.079,15,28,9,10,1,1
5.6,8,34,544.7,9,41,72.76,61.5,73,81.434,79,0,50.046,47.605,26,47,7,32,0,0
5.6,6,15,336.81,3,23,40.898,31.5,40,45.472,42,1,26.574,25.745,9,25,8,17,0,0
5.6,0,14,329.37,3,23,35.218,35.0,34,38.285,36,2,24.324,24.019,14,25,9,11,0,0
5.6,0,14,369.2,2,21,29.396,32.0,28,31.308,30,1,22.387,21.844,14,23,7,7,0,0
5.6,1,23,394.47,5,30,48.24,48.5,48,53.69,52,1,34.057,33.004,22,34,7,18,0,0
5.8,2,23,380.49,4,29,48.796,46.5,49,54.896,53,0,34.364,32.816,21,33,6,20,0,0
5.7,3,15,268.35,5,20,36.036,30.0,36,40.694,38,0,24.046,22.961,12,22,5,16,0,0
5.9,7,35,631.82,10,46,79.258,69.5,79,88.434,85,1,54.949,52.33,28,52,11,33,0,0
5.6,2,16,346.46,4,23,37.64,36.0,37,40.956,39,3,27.239,25.722,14,25,7,14,0,0
5.6,4,10,238.35,5,16,30.229,22.0,30,34.199,31,0,19.932,18.622,6,17,6,14,0,0
5.6,5,23,372.51,7,28,51.571,42.0,52,58.355,55,0,35.091,33.068,18,31,5,24,0,0
6.9,2,21,389.52,3,28,47.098,43.0,47,52.527,50,1,33.461,31.697,19,31,7,19,0,0
5.9,2,18,384.25,3,24,38.491,37.0,38,42.247,40,1,27.847,26.68,15,26,6,14,1,1
5.6,1,17,326.4,3,23,37.564,34.0,37,41.036,39,3,26.591,25.535,16,25,6,14,0,0
5.6,3,21,420.41,2,31,46.709,48.0,45,51.164,50,1,31.625,31.959,18,36,10,14,0,0
5.6,7,23,438.53,6,32,56.8,46.0,56,64.031,59,0,36.978,35.878,16,35,9,24,0,0
5.6,8,24,468.56,8,34,61.01,48.0,60,68.655,63,0,39.194,38.119,16,37,10,26,0,0
5.6,2,23,463.56,7,33,54.963,50.0,54,60.571,57,5,37.585,36.368,21,36,10,21,0,0
5.6,0,16,295.36,2,21,31.429,34.5,31,34.415,34,0,23.648,22.742,16,24,5,10,0,0
5.6,1,15,236.29,2,18,29.949,29.0,30,33.282,32,1,21.273,20.392,14,20,3,12,0,0
8.699,0,20,395.85,3,28,43.974,43.0,43,48.476,46,1,30.847,30.193,20,31,8,15,0,0
5.6,4,32,708.9,12,52,93.207,73.0,92,105.955,94,10,59.387,57.61,28,54,20,40,0,0
5.6,1,20,326.38,2,25,39.153,41.0,39,43.279,42,0,28.284,27.434,18,28,5,14,1,1
6.5,1,21,431.44,3,30,44.945,45.0,43,48.89,46,1,31.199,31.187,20,33,9,13,0,0
5.6,2,28,483.53,5,36,58.963,54.0,58,64.824,62,2,40.387,39.575,26,40,8,22,0,0
4.3,4,13,198.29,1,15,28.505,22.5,29,32.488,31,0,19.58,18.204,9,17,2,14,0,0
5.6,1,22,386.44,3,29,47.574,44.0,47,52.528,50,3,32.716,31.918,21,32,7,18,0,0
5.6,3,19,372.43,5,28,44.676,45.0,44,49.857,48,0,30.546,29.993,16,32,9,16,0,0
5.6,6,18,371.86,4,26,44.673,37.0,44,49.761,46,1,30.125,29.052,11,28,8,18,1,1
5.6,4,32,626.16,7,44,70.116,67.5,69,77.263,75,1,50.006,48.245,28,50,12,25,0,0
5.6,2,18,438.83,5,30,46.429,42.0,44,50.863,46,1,30.182,30.696,16,32,12,14,0,0
7.6,6,28,483.69,6,35,63.516,52.0,64,71.603,67,1,44.267,41.33,20,38,7,29,2,1
5.6,5,10,393.17,2,20,33.422,27.0,32,36.711,34,0,22.551,21.39,5,22,10,12,0,0
7.0,5,29,539.72,6,39,68.163,58.5,68,76.394,72,2,46.972,44.561,24,43,10,29,0,0
4.4,2,9,176.26,0,12,19.931,19.0,20,22.162,22,0,14.943,13.81,7,14,3,8,0,0
5.6,6,22,424.5,6,31,53.916,45.0,53,60.615,56,0,35.216,34.351,16,34,9,22,0,0
5.6,10,34,595.76,8,44,81.283,62.0,81,91.182,85,5,53.483,51.11,24,48,10,37,0,0
4.4,0,7,213.04,0,11,16.527,17.0,16,17.878,17,0,12.341,11.836,7,12,4,5,0,0
4.4,3,12,243.3,2,18,31.371,27.5,31,35.362,33,0,20.529,19.929,9,20,6,13,0,0
5.6,3,29,476.57,7,36,60.225,56.5,60,66.773,65,2,42.0,40.498,26,41,7,24,0,0
5.6,0,11,341.22,0,18,24.007,27.0,23,24.927,25,4,20.091,18.925,11,20,7,5,0,0
5.6,7,39,675.76,8,50,83.283,75.0,82,92.367,89,1,56.625,55.303,32,57,11,32,0,0
5.6,7,23,490.51,8,35,59.152,49.0,57,65.919,60,0,37.307,37.359,16,38,12,22,0,0
5.6,1,16,368.29,2,26,37.716,37.5,35,40.977,37,1,23.972,25.351,15,28,10,9,0,0
6.4,9,25,457.59,6,34,61.203,49.5,61,69.059,65,1,40.563,38.847,15,38,9,27,1,1
5.6,7,17,306.41,4,23,40.912,35.5,41,46.481,44,0,27.603,26.289,9,26,6,18,1,1
4.5,0,6,213.05,0,11,16.52,17.0,16,18.25,17,0,12.137,11.638,6,12,5,5,0,0
8.5,3,26,502.62,6,36,59.807,54.5,59,66.405,63,1,41.381,39.87,23,40,10,23,0,0
5.6,2,16,390.33,2,26,36.985,37.0,34,39.655,36,1,24.307,25.405,14,28,10,8,0,0
5.6,1,13,242.28,1,18,29.454,28.0,29,32.994,31,0,20.006,19.576,12,20,5,11,0,0
6.7,1,18,301.38,4,23,37.927,37.0,38,42.568,41,0,26.836,25.741,17,26,5,15,0,0
5.6,3,17,279.37,5,21,37.818,31.5,38,42.611,40,0,25.801,24.467,14,23,4,17,0,0
5.6,1,14,281.3,3,21,32.814,32.5,32,36.156,33,1,22.222,22.117,11,22,7,11,2,2
6.2,3,16,311.45,5,22,38.887,32.5,39,43.903,41,0,27.245,25.455,13,24,6,17,0,0
8.5,12,27,458.68,6,33,62.298,48.0,63,70.52,68,0,43.023,39.836,13,38,6,30,2,1
4.0,1,14,240.28,2,18,30.276,28.0,30,33.491,32,0,20.727,20.106,13,20,4,12,0,0
5.6,4,24,448.94,7,32,53.665,48.0,53,59.302,57,1,37.097,35.799,20,36,8,21,0,0
4.0,0,11,211.25,1,16,25.276,26.0,25,28.322,27,0,17.551,17.161,11,18,5,9,0,0
5.6,7,19,401.96,5,27,47.305,39.0,47,52.887,51,0,33.08,31.051,12,31,8,20,0,0
5.6,6,20,376.46,3,28,48.451,41.5,48,54.315,52,1,32.273,31.246,14,32,8,20,0,0
5.6,1,13,241.27,2,18,29.494,27.5,29,32.575,31,2,19.972,19.601,12,20,5,11,0,0
5.6,0,20,361.45,3,26,41.338,41.0,41,45.325,44,1,30.142,28.842,20,29,6,15,0,0
7.7,2,15,238.31,1,18,31.833,27.5,32,35.697,34,2,22.034,20.918,13,20,3,14,0,0
5.7,1,13,268.31,2,20,32.589,31.0,32,36.445,34,1,21.773,21.424,12,22,7,12,0,0
5.6,4,22,358.48,6,27,48.687,41.0,49,54.939,52,0,33.33,31.542,18,30,5,22,0,0
5.6,8,16,286.42,3,21,42.687,29.0,43,48.939,45,1,27.33,25.542,8,23,5,22,0,0
5.6,0,16,399.69,3,24,34.324,36.0,33,36.243,35,2,26.949,25.776,16,26,8,9,0,0
5.6,1,11,251.28,2,17,27.022,24.0,26,28.917,27,3,18.517,18.175,10,18,6,9,0,0
5.6,2,20,387.28,5,26,42.574,38.0,42,46.625,44,1,30.727,29.342,18,28,6,16,0,0
5.6,8,20,384.54,11,28,55.985,37.0,56,63.976,57,2,35.319,33.353,12,29,8,28,0,0
5.6,0,12,211.24,1,16,25.284,25.0,25,27.95,27,1,17.756,17.359,12,18,4,9,0,0
5.6,4,14,275.76,3,19,33.258,27.5,33,37.14,35,1,22.898,21.767,10,21,5,14,0,0
5.6,3,19,334.41,5,25,43.247,37.0,43,48.318,45,1,29.262,28.203,16,27,6,18,0,0
5.7,4,15,286.31,3,21,35.814,30.5,35,39.325,37,2,23.398,23.063,11,23,6,14,0,0
5.6,1,23,412.46,5,31,48.752,49.5,48,54.03,52,1,33.995,33.387,22,35,8,17,0,0
5.6,3,21,455.58,4,31,50.014,49.5,49,54.996,53,2,35.5,33.982,18,35,10,18,0,0
4.5,1,12,243.27,3,18,28.673,28.0,28,32.077,30,0,19.25,19.071,11,20,6,10,0,0
5.6,1,15,333.3,2,24,35.909,35.5,34,39.381,36,1,23.341,24.079,14,26,9,10,0,0
6.2,6,19,425.5,11,29,53.516,39.0,52,58.661,53,3,33.665,32.722,13,30,10,23,0,0
5.8,6,18,357.88,4,25,45.229,36.0,45,50.967,48,0,30.432,28.864,12,28,7,20,0,0
5.6,2,18,320.38,5,24,40.363,36.0,40,44.903,42,1,27.5,26.676,16,26,6,16,0,0
8.2,5,28,528.69,7,38,66.389,56.5,66,74.105,70,1,45.421,43.255,23,42,10,28,0,0
6.2,4,24,385.5,3,29,51.796,43.0,52,58.066,55,2,35.54,33.762,20,32,5,23,0,0
6.7,3,16,375.45,6,26,44.196,38.0,43,48.74,44,3,29.063,28.314,12,27,10,17,1,1
5.6,4,22,423.53,4,30,49.68,46.5,49,55.413,53,0,34.642,33.275,18,34,8,19,0,0
7.6,1,22,423.43,3,31,48.56,46.5,47,53.626,50,1,32.625,32.659,21,34,9,16,0,0
5.6,5,17,312.38,2,23,40.432,33.5,40,45.449,42,1,26.745,25.871,11,25,6,17,1,1
5.9,1,21,344.39,3,26,42.371,40.0,42,46.531,45,2,29.705,28.875,20,29,5,16,0,0
4.9,1,13,239.25,1,18,27.611,29.0,27,30.159,30,0,19.21,19.074,12,21,5,9,0,0
5.6,8,29,498.69,8,37,70.636,53.0,71,80.221,74,2,46.603,43.933,21,40,8,34,0,0
5.6,0,16,380.43,5,27,40.313,42.5,39,44.156,42,2,28.125,27.842,16,30,11,12,0,0
7.8,7,30,542.77,10,39,72.712,56.0,73,82.141,76,3,49.25,46.12,23,42,9,34,0,0
5.6,1,21,341.39,3,26,41.262,42.0,41,45.405,45,1,29.495,28.655,20,30,5,15,0,0
5.6,3,17,297.36,5,22,38.331,32.5,38,42.95,40,0,25.739,24.85,14,24,5,16,0,0
5.6,3,20,333.42,5,25,44.029,37.0,44,49.235,46,1,30.017,28.708,17,27,5,19,0,0
5.6,1,14,302.39,3,21,35.556,33.0,35,39.408,37,2,24.387,23.336,13,23,7,14,0,0
5.6,3,21,350.42,5,26,45.323,38.0,45,50.492,47,1,30.711,29.597,18,28,5,19,0,0
5.6,4,26,452.56,7,34,58.218,52.5,58,65.145,62,1,39.796,38.299,22,38,8,24,0,0
5.6,16,28,506.72,7,37,74.73,49.0,75,85.261,79,2,47.58,44.702,12,41,9,38,0,0
5.9,2,15,314.81,5,22,37.353,32.5,37,42.01,39,0,25.699,24.59,13,24,7,15,0,0
5.6,7,19,339.5,4,24,44.662,35.5,45,50.361,48,1,30.972,28.707,12,27,5,21,0,0
5.8,2,16,357.23,2,22,35.382,35.0,35,39.12,38,0,25.637,24.46,14,25,6,13,0,0
6.8,5,33,622.2,8,44,72.487,67.5,72,80.338,78,1,51.83,49.389,28,50,11,28,0,0
5.6,4,14,258.3,3,19,33.487,28.0,33,37.116,35,2,21.943,21.348,10,21,5,14,0,0
5.6,5,23,487.37,7,33,54.316,48.0,53,59.456,56,4,37.409,36.341,18,36,10,20,0,0
8.5,2,23,449.55,4,32,52.822,48.0,52,58.492,55,2,36.614,35.321,21,35,9,20,0,0
5.6,5,27,471.55,8,35,60.662,52.0,60,67.109,63,3,40.665,39.433,22,38,8,25,0,0
5.6,6,22,422.51,7,31,54.731,45.0,54,61.485,57,0,35.733,34.682,16,34,9,23,0,0
6.3,1,20,359.42,3,27,44.465,42.0,44,49.402,47,1,30.506,29.697,19,30,7,17,0,0
7.6,7,25,480.01,6,34,60.534,49.0,60,67.631,64,3,40.625,38.874,18,38,9,26,0,0
5.6,7,17,315.41,4,23,44.24,31.0,44,49.86,45,4,28.233,26.95,10,24,6,21,0,0
5.6,4,26,436.56,7,33,56.891,51.5,57,63.936,61,1,39.341,37.584,22,37,7,24,0,0
5.6,1,16,401.19,2,26,37.338,37.5,35,40.186,37,1,25.813,26.239,15,28,10,9,0,0
5.6,6,24,404.56,9,30,57.665,42.0,58,65.394,60,1,38.069,35.837,18,32,6,28,0,0
5.6,8,21,393.55,7,29,55.876,41.0,56,63.85,59,1,36.108,34.133,13,32,8,27,0,0
5.6,2,16,328.43,3,23,39.44,35.5,39,43.823,41,2,27.148,25.863,14,25,7,16,0,0
5.6,1,19,332.39,3,25,41.363,38.0,41,45.903,44,1,28.5,27.676,18,28,6,16,0,0
5.6,2,20,318.4,5,24,41.927,36.0,42,46.737,44,1,29.012,27.687,18,26,4,18,0,0
5.8,6,17,327.85,3,23,41.018,34.0,41,46.342,44,0,28.216,26.622,11,26,6,18,0,0
5.6,4,17,328.83,5,23,40.243,34.0,40,45.053,42,1,27.665,26.316,13,25,6,17,0,0
5.6,4,14,282.23,0,20,30.822,28.0,29,33.139,31,3,19.744,20.455,10,22,6,9,0,0
6.9,6,18,351.46,6,26,47.225,38.0,47,53.604,50,1,30.824,29.552,12,29,8,21,0,0
5.6,1,12,258.33,2,18,28.462,27.5,28,31.368,29,1,20.409,19.568,10,19,6,10,1,1
5.6,3,15,384.88,6,25,43.302,35.0,42,47.601,43,3,28.676,27.647,12,26,10,17,0,0
5.6,10,21,396.55,7,29,56.985,41.0,57,64.976,60,1,36.319,34.353,11,32,8,28,0,0
6.1,3,32,607.69,7,44,68.421,68.5,67,75.243,73,2,48.324,47.274,29,50,12,23,0,0
5.6,5,18,392.43,7,28,48.545,39.0,47,54.54,49,1,30.392,30.208,13,30,10,19,0,0
8.4,2,20,380.48,3,27,44.509,42.0,44,49.369,47,2,31.392,30.058,18,30,7,17,0,0
5.6,1,17,361.26,2,23,33.673,36.0,33,36.09,35,1,26.636,25.234,15,25,6,10,1,1
5.6,1,13,242.32,1,17,27.142,27.0,27,29.787,29,0,20.159,19.052,12,19,4,10,0,0
5.6,1,21,359.41,4,27,44.473,42.0,44,49.03,47,1,30.71,29.896,20,30,6,17,0,0
5.6,6,23,367.49,4,28,48.578,43.5,49,54.813,52,0,34.12,32.321,14,31,5,21,3,2
7.0,4,18,310.38,4,23,41.254,33.5,41,45.946,43,3,27.466,26.402,14,25,5,18,0,0
4.4,0,6,167.21,0,11,16.593,16.5,16,18.04,17,2,11.881,11.493,6,12,5,5,0,0
5.6,1,18,374.35,3,27,41.902,39.0,40,45.922,42,4,27.313,27.826,17,29,9,13,0,0
6.3,12,30,481.7,6,36,70.09,52.0,71,79.929,76,0,46.904,43.724,18,41,6,35,0,0
7.8,4,28,498.61,8,37,64.498,55.5,64,72.316,68,1,43.256,41.736,24,41,9,27,0,0
5.6,5,23,360.49,7,27,50.578,39.0,51,56.983,53,1,34.296,32.267,18,29,4,24,0,0
5.6,6,22,421.53,7,31,55.505,45.0,55,62.774,58,0,36.284,34.989,16,34,9,24,0,0
5.6,2,19,370.36,2,27,41.574,40.5,40,45.713,42,1,27.858,28.111,15,29,8,13,2,1
5.6,5,17,391.88,7,27,47.062,37.5,46,52.888,48,0,30.62,29.763,12,29,10,19,0,0
5.6,4,14,275.41,6,19,35.894,26.5,36,40.531,37,1,24.449,22.654,10,20,5,17,0,0
5.6,5,18,409.48,7,28,47.52,39.0,46,52.962,48,1,31.034,30.373,13,30,10,18,0,0
5.6,0,11,245.69,1,17,25.6,27.0,25,28.266,27,0,18.409,17.988,11,19,6,8,0,0
5.6,4,17,322.42,1,23,37.229,36.0,37,41.199,41,1,26.932,25.622,13,27,6,14,0,0
7.108,8,28,477.62,4,36,62.876,56.0,63,70.85,69,1,43.108,41.133,20,42,8,27,0,0
8.5,3,26,502.62,6,36,59.807,54.5,59,66.405,63,1,41.381,39.87,23,40,10,23,0,0
6.301,6,24,463.54,9,34,59.982,49.0,59,66.691,62,1,38.915,37.949,18,37,10,25,0,0
6.0,6,24,463.54,9,34,59.982,49.0,59,66.691,62,1,38.915,37.949,18,37,10,25,0,0
8.523,6,25,462.55,9,34,60.763,49.0,60,67.607,63,1,39.671,38.454,19,37,9,26,0,0
8.301,5,24,432.52,8,32,56.552,47.0,56,62.983,59,1,37.455,36.213,19,35,8,24,0,0
6.699,5,24,432.52,8,32,56.552,47.0,56,62.983,59,1,37.455,36.213,19,35,8,24,0,0
6.301,4,23,420.48,7,31,52.854,46.0,52,58.698,55,1,35.176,34.355,19,34,8,21,0,0
6.155,4,23,420.48,7,31,52.854,46.0,52,58.698,55,1,35.176,34.355,19,34,8,21,0,0
8.0,4,23,435.54,7,31,52.643,46.0,52,57.989,55,1,36.335,34.852,19,34,8,21,0,0
7.699,6,25,463.53,8,34,59.989,49.0,59,66.319,62,1,39.119,38.148,19,37,9,25,0,0
7.523,5,24,433.5,7,32,55.778,47.0,55,61.694,58,1,36.904,35.906,19,35,8,23,0,0
6.222,5,24,433.5,7,32,55.778,47.0,55,61.694,58,1,36.904,35.906,19,35,8,23,0,0
6.046,4,23,421.46,6,31,52.08,46.0,51,57.409,54,1,34.625,34.048,19,34,8,20,0,0
6.0,4,23,421.46,6,31,52.08,46.0,51,57.409,54,1,34.625,34.048,19,34,8,20,0,0
8.398,5,24,433.5,8,32,55.778,47.0,55,61.694,58,1,36.904,35.906,19,35,8,23,0,0
7.0,5,24,432.52,7,32,56.552,47.0,56,62.983,59,1,37.455,36.213,19,35,8,24,0,0
7.0,5,24,432.52,8,32,56.552,47.0,56,62.983,59,1,37.455,36.213,19,35,8,24,0,0
9.523,6,25,462.55,9,34,60.763,49.0,60,67.607,63,1,39.671,38.454,19,37,9,26,0,0
8.301,5,24,432.52,8,32,56.552,47.0,56,62.983,59,1,37.455,36.213,19,35,8,24,0,0
6.0,6,24,463.54,8,34,59.982,49.0,59,66.691,62,1,38.915,37.949,18,37,10,25,0,0
7.301,6,25,462.55,8,34,60.763,49.0,60,67.607,63,1,39.671,38.454,19,37,9,26,0,0
6.699,5,24,432.52,7,32,56.552,47.0,56,62.983,59,1,37.455,36.213,19,35,8,24,0,0
6.523,5,24,432.52,7,32,56.552,47.0,56,62.983,59,1,37.455,36.213,19,35,8,24,0,0
6.301,5,24,432.52,7,32,56.552,47.0,56,62.983,59,1,37.455,36.213,19,35,8,24,0,0
7.0,4,23,418.49,7,31,53.669,46.0,53,59.568,56,1,35.693,34.686,19,34,8,22,0,0
7.0,5,24,432.52,7,32,56.552,47.0,56,62.983,59,1,37.455,36.213,19,35,8,24,0,0
8.046,7,29,485.63,9,36,66.985,51.5,67,75.145,70,1,44.495,42.299,22,39,7,31,0,0
7.699,5,23,433.51,8,32,55.771,47.0,55,62.066,58,1,36.699,35.707,18,35,9,23,0,0
7.097,5,23,433.51,7,32,55.771,47.0,55,62.066,58,1,36.699,35.707,18,35,9,23,0,0
6.523,5,23,433.51,8,32,55.771,47.0,55,62.066,58,1,36.699,35.707,18,35,9,23,0,0
6.222,7,25,477.57,9,35,62.865,50.0,62,70.106,65,1,40.676,39.476,18,38,10,27,0,0
6.699,8,26,491.6,10,36,65.749,51.0,65,73.521,68,1,42.438,41.003,18,39,10,29,0,0
5.6,8,29,513.65,10,38,69.305,54.5,69,77.727,73,1,45.745,43.815,21,42,9,31,0,0
8.046,6,24,517.51,7,37,61.52,52.0,59,67.71,62,1,38.727,39.099,18,40,13,22,0,0
7.161,10,26,462.6,4,34,64.203,47.5,64,72.228,68,1,41.739,39.793,16,38,8,30,0,0
5.553,8,25,537.73,9,37,64.683,53.0,64,72.108,68,1,44.313,41.936,17,41,12,27,0,0
6.2,5,15,305.79,3,21,37.469,29.5,37,41.764,39,1,25.114,24.009,10,23,6,16,0,0
5.6,2,12,317.67,0,21,30.356,29.5,28,32.538,30,1,19.642,20.578,10,23,9,7,0,0
5.6,1,14,331.74,4,23,34.465,34.0,33,37.309,34,2,23.534,23.659,12,24,9,10,1,1
5.601,3,10,220.26,3,16,28.596,22.0,28,32.073,28,1,17.977,17.622,6,16,6,12,1,1
5.9,3,15,297.35,5,22,37.582,32.0,37,41.986,38,1,24.745,24.171,11,23,7,15,1,1
5.602,1,14,252.3,2,19,31.269,29.0,31,34.863,32,1,21.523,20.908,12,20,5,12,1,1
5.601,5,18,356.42,7,26,46.785,36.0,46,52.152,47,1,29.932,29.159,12,27,8,20,1,1
5.601,6,18,443.95,8,29,52.505,39.0,51,57.767,52,3,33.864,32.636,12,30,11,22,0,0
5.601,6,19,434.52,8,30,53.4,42.0,52,58.906,53,3,34.25,33.303,12,31,11,22,1,1
7.8,1,19,360.41,3,27,43.683,42.0,43,48.485,46,1,29.75,29.192,18,30,8,16,0,0
5.6,4,18,309.37,1,23,39.331,35.5,39,43.95,42,2,26.739,25.85,14,26,5,16,0,0
5.6,1,19,414.38,3,30,45.222,45.0,43,49.504,46,1,29.563,30.342,18,33,11,13,0,0
5.727,8,26,507.63,13,37,67.81,52.0,67,76.438,70,1,43.478,41.999,18,40,11,30,0,0
8.959,9,22,375.52,4,28,52.672,40.5,53,59.853,56,2,35.097,33.09,12,31,6,25,1,1
7.658,9,27,452.61,5,34,61.658,50.5,62,69.766,66,2,41.864,39.638,17,38,7,28,1,1
8.745,11,25,428.59,6,32,59.658,46.5,60,67.766,63,2,39.864,37.638,12,35,7,28,2,2
8.62,10,28,466.64,6,35,64.541,51.5,65,73.182,69,2,43.625,41.165,17,39,7,30,1,1
8.959,11,24,419.58,6,31,59.767,43.5,60,67.893,63,2,39.074,36.858,12,34,7,29,1,1
8.796,12,25,449.61,7,33,63.978,45.5,64,72.517,67,2,41.29,39.1,12,36,8,31,1,1
8.824,12,25,481.68,7,34,65.054,48.5,65,73.437,68,4,42.938,40.287,12,37,9,31,1,1
8.854,10,24,432.58,6,32,59.985,45.5,60,67.976,63,3,39.319,37.353,13,35,8,28,1,1
8.886,10,24,433.56,6,32,59.211,45.5,59,66.687,62,3,38.767,37.046,13,35,8,27,1,1
8.959,15,28,488.7,7,36,71.519,49.5,72,81.637,76,2,46.364,43.46,12,40,8,36,1,1
8.569,9,28,480.62,5,36,63.985,53.5,64,71.976,68,3,43.319,41.353,18,40,8,28,1,1
8.921,11,25,463.59,6,34,63.421,47.5,63,71.312,66,3,40.983,39.288,13,37,9,29,1,1
9.081,12,26,476.64,8,35,67.08,48.5,67,76.016,70,3,43.296,41.121,13,38,9,32,1,1
9.0,13,27,490.67,8,36,69.963,49.5,70,79.431,73,3,45.057,42.648,13,39,9,34,1,1
8.585,11,25,495.66,6,35,64.498,50.5,64,72.232,67,5,42.631,40.475,13,38,10,29,1,1
8.854,9,28,496.62,5,37,65.312,55.5,65,73.185,69,4,43.773,42.068,18,41,9,28,1,1
8.886,9,28,496.62,5,37,65.312,55.5,65,73.185,69,4,43.773,42.068,18,41,9,28,1,1
8.959,10,27,483.63,6,36,65.087,53.0,65,73.474,69,3,43.324,41.374,16,40,9,29,1,1
8.796,11,28,497.66,6,37,67.97,54.0,68,76.889,72,3,45.086,42.901,16,41,9,31,1,1
8.602,10,29,494.65,6,37,66.869,54.5,67,75.391,71,3,45.08,42.88,18,41,8,30,1,1
8.77,10,29,494.65,6,37,66.869,54.5,67,75.391,71,3,45.08,42.88,18,41,8,30,1,1
8.886,10,29,494.65,6,37,66.869,54.5,67,75.391,71,3,45.08,42.88,18,41,8,30,1,1
8.77,15,29,516.71,7,38,73.847,52.5,74,83.846,78,3,47.819,45.175,13,42,9,36,1,1
8.42,14,28,502.68,6,37,70.963,51.5,71,80.431,75,3,46.057,43.648,13,41,9,34,1,1
9.208,13,27,474.67,6,35,68.636,48.5,69,78.221,72,3,44.603,41.933,13,38,8,34,1,1
8.886,12,26,460.64,5,34,65.752,47.5,66,74.806,69,3,42.841,40.406,13,37,8,32,1,1
9.155,11,25,462.61,6,34,64.196,47.5,64,72.6,67,3,41.534,39.594,13,37,9,30,1,1
8.481,9,23,418.55,4,31,57.101,44.5,57,64.561,60,3,37.557,35.826,13,34,8,26,1,1
8.0,6,23,445.53,6,33,56.763,49.5,56,63.438,60,2,37.495,36.509,17,37,10,23,0,0
8.2,0,20,343.42,3,26,43.138,41.0,43,48.192,46,1,30.051,28.983,20,29,6,17,0,0
8.4,1,21,357.45,3,27,46.022,42.0,46,51.607,49,1,31.813,30.509,20,30,6,19,0,0
5.6,8,29,570.67,10,42,73.171,61.5,72,81.601,77,1,47.693,46.54,21,47,13,30,0,0
8.509,11,27,490.67,7,36,69.963,49.5,70,79.431,73,2,45.057,42.648,16,39,9,34,0,0
9.0,12,28,504.7,8,37,72.847,50.5,73,82.846,76,2,46.819,44.175,16,40,9,36,0,0
8.31,10,26,491.66,7,36,69.181,49.5,69,78.514,72,2,44.302,42.143,16,39,10,33,0,0
8.699,5,21,393.49,5,29,52.443,41.5,52,58.857,54,2,34.245,32.993,16,31,8,23,0,0
8.796,5,21,393.49,5,29,52.443,41.5,52,58.857,54,2,34.245,32.993,16,31,8,23,0,0
8.745,9,25,478.61,7,35,65.523,48.5,65,73.81,68,2,41.989,40.309,16,38,10,30,0,0
8.523,11,27,506.67,8,37,71.29,50.5,71,80.64,74,2,45.512,43.363,16,40,10,34,0,0
9.222,9,25,478.61,7,35,65.523,48.5,65,73.81,68,2,41.989,40.309,16,38,10,30,0,0
8.161,11,27,506.67,8,37,71.29,50.5,71,80.64,74,2,45.512,43.363,16,40,10,34,0,0
8.921,12,28,520.7,8,38,74.174,51.5,74,84.055,77,2,47.273,44.89,16,41,10,36,0,0
8.469,11,27,560.64,8,40,72.829,53.5,71,81.659,74,2,45.324,44.513,16,43,13,31,0,0
8.951,13,29,534.73,8,39,77.058,52.5,77,87.471,80,2,49.035,46.416,16,42,10,38,0,0
8.893,12,28,518.68,8,38,72.29,52.5,72,81.64,76,2,46.512,44.363,16,42,10,34,0,0
5.678,4,23,414.51,5,31,53.334,46.0,53,59.73,56,3,36.034,34.772,19,34,8,22,0,0
7.824,14,30,548.76,7,40,79.941,53.5,80,90.886,83,2,50.796,47.943,16,43,10,40,0,0
7.979,15,31,562.79,8,41,82.825,54.5,83,94.301,86,2,52.557,49.47,16,44,10,42,0,0
8.745,13,29,534.73,7,39,77.058,52.5,77,87.471,80,2,49.035,46.416,16,42,10,38,0,0
5.0,8,16,312.42,3,23,43.123,33.0,43,49.106,45,1,27.819,26.531,7,25,7,20,1,1
7.0,8,20,463.92,4,32,55.749,43.0,54,61.429,56,1,35.466,34.964,11,34,12,22,1,1
8.469,1,21,375.44,3,28,46.534,43.0,46,51.947,49,1,31.75,30.893,20,31,7,18,0,0
7.7,8,20,431.92,3,30,53.094,41.0,52,59.01,54,1,34.557,33.535,11,32,10,22,1,1
7.8,6,18,466.95,2,31,51.833,44.0,50,56.807,52,3,34.142,33.405,11,33,13,19,1,1
8.046,6,23,431.56,7,31,52.309,47.5,52,58.152,56,0,36.676,34.938,15,35,8,21,2,1
5.6,2,12,213.26,1,16,27.167,24.5,27,30.365,29,1,18.517,17.886,10,18,4,11,0,0
5.6,2,21,340.41,2,26,42.036,42.0,42,46.694,46,1,30.046,28.961,19,30,5,16,0,0
5.6,2,18,307.35,2,23,37.447,35.5,37,41.535,40,1,25.978,25.323,16,26,5,14,0,0
5.0,0,18,346.38,2,26,40.8,40.5,40,45.069,43,0,27.989,27.665,18,29,8,14,0,0
6.959,7,26,439.5,1,33,54.567,53.0,54,60.069,61,1,37.688,36.665,19,40,7,21,0,0
6.665,9,35,570.69,3,43,73.203,68.0,73,81.228,81,2,50.739,48.793,26,51,8,30,0,0
5.6,0,20,378.46,3,27,42.625,42.0,42,46.954,45,1,30.631,29.532,20,30,7,15,0,0
7.097,7,26,508.02,8,36,62.862,52.0,62,69.84,66,1,42.08,40.588,19,40,10,26,0,0
5.0,6,23,401.52,3,29,48.105,45.0,48,53.155,52,2,34.665,32.895,16,33,6,19,1,1
5.0,4,20,332.45,2,24,39.793,38.0,40,44.032,43,1,29.443,27.632,15,27,4,16,1,1
7.658,7,16,315.42,4,23,44.232,31.5,44,50.232,46,1,28.029,26.751,9,25,7,21,0,0
7.921,4,19,384.5,5,27,47.534,40.5,47,52.863,49,3,32.125,30.632,15,29,8,20,0,0
7.77,6,21,410.54,6,29,51.418,43.5,51,57.278,54,3,34.887,33.158,15,32,8,22,0,0
7.398,5,20,396.51,5,28,48.534,42.5,48,53.863,51,3,33.125,31.632,15,31,8,20,0,0
5.6,8,16,312.42,3,23,43.123,33.0,43,49.106,45,1,27.819,26.531,7,25,7,20,1,1
5.569,10,20,383.5,4,28,53.327,38.0,53,60.272,56,1,34.006,32.519,10,31,8,25,0,0
5.6,3,19,334.41,2,25,43.247,38.5,43,48.318,46,0,29.262,28.203,16,28,6,18,0,0
6.26,4,28,467.63,5,34,58.756,53.0,59,65.401,63,1,41.949,39.476,24,38,6,25,0,0
5.6,0,17,351.35,6,26,40.353,40.0,39,43.99,41,3,26.892,27.073,17,28,9,13,0,0
6.5,0,17,322.35,5,24,38.807,36.0,38,42.697,40,1,26.193,25.864,17,26,7,14,0,0
6.5,0,18,346.38,5,26,40.8,41.0,40,45.069,43,1,27.989,27.665,18,29,8,14,0,0
7.347,8,30,523.71,6,38,66.843,57.0,67,74.813,72,1,46.722,44.045,20,43,8,29,2,1
6.947,4,26,455.57,6,33,54.316,51.0,54,59.78,58,1,38.881,37.137,20,37,7,21,2,1
5.896,6,28,499.63,9,36,61.411,54.0,61,67.82,65,1,42.858,40.905,20,40,8,25,2,1
6.721,3,26,469.55,6,34,53.76,53.0,53,58.574,57,2,38.574,37.325,21,38,8,19,2,1
5.6,9,19,404.95,8,28,53.425,38.0,53,60.505,55,2,34.415,32.654,10,30,9,25,0,0
5.796,8,22,475.4,6,30,54.523,41.5,54,61.161,57,0,36.597,34.718,14,33,8,24,0,0
7.398,1,22,388.43,5,29,46.76,44.5,46,51.658,49,1,32.199,31.586,21,32,7,17,0,0
8.9,5,20,471.97,3,32,51.396,46.5,50,56.472,53,1,35.477,34.47,14,35,12,18,1,1
6.796,1,22,388.88,4,28,45.243,43.5,45,50.053,48,1,32.665,31.316,21,31,6,17,0,0
7.398,2,24,382.5,5,29,50.687,44.5,51,56.939,54,1,35.33,33.542,22,32,5,22,0,0
7.495,1,22,404.88,5,29,46.571,44.5,46,51.262,49,1,33.12,32.03,21,32,7,17,0,0
5.0,6,17,331.41,8,24,45.567,33.5,45,51.069,46,3,28.688,27.665,11,25,7,21,0,0
5.0,0,17,323.33,5,24,38.033,37.5,37,41.409,39,3,25.642,25.557,17,26,7,13,0,0
6.643,5,16,331.36,4,24,42.127,34.5,41,46.448,43,3,26.619,26.326,11,26,8,17,0,0
7.0,3,26,407.5,6,31,51.912,48.5,52,57.651,56,2,36.779,35.235,23,35,5,21,0,0
7.495,5,28,435.56,6,33,57.68,50.5,58,64.481,62,2,40.301,38.289,23,37,5,25,0,0
7.602,2,24,431.55,6,31,52.316,48.5,52,57.78,55,3,36.881,35.137,22,34,7,21,0,0
5.0,3,14,287.3,4,21,35.033,31.5,34,38.409,36,3,22.642,22.557,11,23,7,13,0,0
7.301,0,23,364.43,4,28,44.036,45.5,44,48.694,47,1,32.046,30.961,22,31,5,16,1,1
7.796,0,21,340.41,4,26,42.036,41.5,42,46.694,45,1,30.046,28.961,21,29,5,16,0,0
7.201,1,22,370.44,5,28,46.247,43.5,46,51.318,49,1,32.262,31.203,21,31,6,18,0,0
5.6,7,22,387.48,5,29,50.232,43.5,50,56.232,54,0,34.029,32.751,14,33,7,21,1,1
5.854,6,17,345.39,5,25,45.011,35.5,44,49.864,46,3,28.381,27.853,11,27,8,19,0,0
5.0,5,17,314.37,4,23,41.582,32.5,41,46.156,43,2,26.921,26.116,12,25,6,18,0,0
6.495,0,23,364.43,4,28,44.036,45.5,44,48.694,47,1,32.046,30.961,22,31,5,16,1,1
6.886,1,22,386.51,5,28,45.996,43.5,46,51.029,49,1,33.455,31.675,21,31,6,18,0,0
5.0,6,17,338.36,3,24,42.349,32.5,41,47.171,43,1,26.586,26.364,11,26,7,17,0,0
6.432,5,17,295.37,3,22,39.145,32.5,39,43.82,41,1,26.256,25.181,11,24,5,17,1,1
7.0,2,23,402.46,6,30,49.643,45.5,49,55.073,52,1,33.961,33.113,21,33,7,19,0,0
6.0,3,24,416.49,6,31,52.527,46.5,52,58.489,55,1,35.722,34.64,21,34,7,21,0,0
7.201,2,23,383.49,5,29,49.905,44.5,50,56.023,53,1,34.574,33.036,21,32,6,21,0,0
6.201,3,24,398.5,6,30,52.014,45.5,52,58.149,55,1,35.784,34.256,21,33,6,22,0,0
5.0,4,14,255.36,3,19,35.811,28.5,36,40.983,38,0,23.597,22.268,10,21,5,17,0,0
5.569,5,17,311.37,3,23,40.473,33.5,40,45.03,42,1,26.71,25.896,11,25,6,17,1,1
6.018,6,18,325.4,4,24,43.356,34.5,43,48.445,45,1,28.472,27.423,11,26,6,19,1,1
5.509,6,18,324.42,4,24,44.131,34.5,44,49.734,46,1,29.023,27.73,11,26,6,20,1,1
6.796,0,22,380.44,4,29,45.356,47.5,45,50.275,49,1,32.296,31.477,22,33,7,16,0,0
6.602,0,22,339.42,4,26,42.818,41.5,43,47.611,46,1,30.801,29.467,22,29,4,17,0,0
7.495,0,21,376.39,4,28,43.062,43.5,42,47.373,45,1,29.921,29.728,21,31,7,14,0,0
7.301,1,22,372.43,4,28,45.432,43.5,45,50.449,48,1,31.745,30.871,21,31,6,17,0,0
6.481,5,18,323.38,4,24,41.473,35.5,41,46.03,43,2,27.71,26.896,12,26,6,17,1,1
5.699,5,18,339.38,4,25,42.8,36.5,42,47.239,44,2,28.165,27.611,12,27,7,17,1,1
7.445,10,22,378.52,4,28,53.781,39.5,54,60.979,57,1,35.307,33.31,11,31,6,26,1,1
7.301,2,24,431.55,6,31,52.316,48.5,52,57.78,55,3,36.881,35.137,22,34,7,21,0,0
5.721,4,15,301.33,4,22,37.916,32.5,37,41.824,39,3,24.404,24.084,11,24,7,15,0,0
5.996,11,23,407.57,5,30,58.767,41.5,59,66.893,62,1,38.074,35.858,11,33,7,29,1,1
6.509,7,19,402.52,6,28,50.745,40.5,50,56.488,52,3,33.341,31.873,11,30,9,22,1,1
6.699,2,24,431.55,6,31,52.316,48.5,52,57.78,55,3,36.881,35.137,22,34,7,21,0,0
7.796,5,28,450.58,5,34,59.781,51.5,60,66.979,64,2,41.307,39.31,23,38,6,26,0,0
5.699,0,17,323.33,4,24,38.033,37.5,37,41.409,39,6,25.642,25.557,17,26,7,13,0,0
6.143,6,17,329.39,4,24,43.683,34.5,43,48.654,45,3,27.926,27.138,11,26,7,19,0,0
7.097,4,27,452.55,5,34,58.225,51.5,58,64.773,62,2,40.0,38.498,23,38,7,24,0,0
7.796,1,23,417.52,5,30,49.433,47.5,49,54.365,52,3,35.12,33.61,22,33,7,19,0,0
8.097,3,25,445.58,5,32,55.2,49.5,55,61.195,58,3,38.642,36.664,22,35,7,23,0,0
7.201,2,24,449.54,5,32,52.829,49.5,52,58.12,55,3,36.818,35.52,22,35,8,20,0,0
5.0,5,16,270.36,3,20,37.927,28.5,38,42.737,40,1,25.012,23.687,11,22,4,18,0,0
6.796,1,23,435.51,5,31,49.945,48.5,49,54.704,52,3,35.057,33.993,22,34,8,18,0,0
7.0,2,24,465.54,6,33,54.156,50.5,53,59.329,56,3,37.273,36.235,22,36,9,20,0,0
5.0,5,22,361.48,5,27,49.796,39.5,50,56.066,53,1,33.54,31.762,17,30,5,23,0,0
5.0,5,22,346.46,4,26,47.694,38.5,48,53.567,51,1,32.534,30.74,17,29,4,22,0,0
5.357,5,16,349.25,3,21,38.156,29.5,38,42.579,40,1,26.364,24.712,11,23,5,17,0,0
5.721,5,16,304.8,3,21,38.251,29.5,38,42.681,40,1,25.87,24.514,11,23,5,17,0,0
7.301,1,23,353.45,4,27,45.702,42.5,46,51.026,49,1,32.563,30.993,22,30,4,19,0,0
7.602,1,23,369.45,5,28,47.029,43.5,47,52.235,50,1,33.017,31.708,22,31,5,19,0,0
6.638,7,18,359.42,6,26,47.894,36.5,47,53.279,49,3,30.142,29.379,11,28,8,21,0,0
7.495,0,22,357.41,4,27,43.331,42.5,43,47.95,46,1,30.739,29.85,22,30,5,16,0,0
5.959,4,15,317.33,4,23,39.244,33.5,38,43.033,40,3,24.858,24.799,11,25,8,15,0,0
5.0,4,15,316.35,4,23,40.018,33.5,39,44.322,41,3,25.409,25.106,11,25,8,16,0,0
5.0,5,16,317.38,7,23,42.683,32.5,42,47.654,43,3,26.926,26.138,11,24,7,19,0,0
6.523,6,17,329.39,4,24,43.683,34.5,43,48.654,45,3,27.926,27.138,11,26,7,19,0,0
5.854,5,16,330.38,4,24,42.902,34.5,42,47.737,44,3,27.171,26.632,11,26,8,18,0,0
6.143,11,22,408.56,4,30,57.985,41.5,58,65.976,61,1,37.319,35.353,10,33,8,28,1,1
9.0,11,23,407.57,4,30,58.767,41.5,59,66.893,62,1,38.074,35.858,11,33,7,29,1,1
8.201,10,22,411.53,4,30,56.396,41.5,56,63.817,59,1,36.25,34.715,11,33,8,26,1,1
7.222,9,22,407.52,4,30,55.327,42.5,55,62.272,58,2,36.006,34.519,12,33,8,25,1,1
9.155,9,21,428.56,4,30,54.629,43.5,54,60.903,57,3,36.103,34.4,11,33,9,24,1,1
7.097,9,21,395.51,4,29,54.327,40.5,54,61.272,57,1,35.006,33.519,11,32,8,25,1,1
8.0,11,22,408.56,4,30,57.985,41.5,58,65.976,61,1,37.319,35.353,10,33,8,28,1,1
7.194,6,21,375.47,4,28,49.232,42.0,49,55.232,52,1,33.029,31.751,14,31,7,21,1,1
8.523,5,20,361.44,4,27,46.349,41.0,46,51.817,49,1,31.267,30.224,14,30,7,19,1,1
6.398,5,15,271.35,3,20,37.145,28.5,37,41.82,39,1,24.256,23.181,10,22,5,17,0,0
7.678,7,19,339.43,5,25,46.24,35.5,46,51.86,48,1,30.233,28.95,11,27,6,21,1,1
7.444,9,27,537.63,11,39,69.323,55.0,68,77.778,72,1,44.415,43.382,18,43,12,29,0,0
5.7,9,20,532.46,10,32,57.541,41.5,56,64.128,58,2,37.642,36.025,11,34,12,24,0,0
7.959,10,22,394.52,4,29,55.109,40.5,55,62.189,58,1,35.762,34.025,11,32,7,26,1,1
7.081,11,24,450.6,4,33,63.196,45.5,63,71.6,66,2,40.534,38.594,12,36,9,30,1,1
9.108,11,23,406.59,4,30,59.541,41.5,60,68.182,63,1,38.625,36.165,11,33,7,30,1,1
9.0,10,22,392.56,4,29,56.658,40.5,57,64.766,60,1,36.864,34.638,11,32,7,28,1,1
9.155,11,24,434.6,4,32,61.869,44.5,62,70.391,65,2,40.08,37.88,12,35,8,30,1,1
9.046,11,23,471.64,5,33,62.498,46.5,62,70.232,65,3,40.631,38.475,11,36,10,29,1,1
7.167,10,30,523.7,6,39,71.854,56.0,72,81.305,77,3,47.847,45.428,20,44,9,33,0,0
7.509,9,29,509.67,5,38,68.97,55.0,69,77.889,74,3,46.086,43.901,20,43,9,31,0,0
7.046,3,21,364.85,3,26,43.251,39.5,43,47.681,46,2,30.87,29.514,18,29,5,17,0,0
6.959,2,20,350.82,2,25,40.367,38.5,40,44.266,43,2,29.108,27.988,18,28,5,15,0,0
9.097,9,23,390.53,4,29,54.781,41.5,55,61.979,58,2,36.307,34.31,13,32,6,26,1,1
7.824,9,23,390.53,4,29,54.781,41.5,55,61.979,57,1,36.307,34.31,11,31,6,26,3,2
8.097,8,28,495.64,5,37,66.087,54.0,66,74.474,71,3,44.324,42.374,20,42,9,29,0,0
6.77,1,19,352.79,2,25,38.811,38.5,38,42.06,41,2,27.801,27.176,18,28,6,13,0,0
8.155,9,29,509.67,5,38,68.97,55.0,69,77.889,74,3,46.086,43.901,20,43,9,31,0,0
6.169,3,28,529.57,6,39,62.53,58.5,61,69.453,65,1,42.159,41.756,25,43,11,22,0,0
8.523,1,20,412.41,3,30,46.778,45.0,45,51.71,48,1,30.87,31.154,19,33,10,15,0,0
7.678,6,26,454.58,6,34,60.101,50.0,60,67.561,64,3,40.557,38.826,20,38,8,26,0,0
7.658,8,28,496.62,6,37,65.312,54.0,65,73.185,70,3,43.773,42.068,20,42,9,28,0,0
8.523,7,27,468.61,7,35,62.985,51.0,63,70.976,67,3,42.319,40.353,20,39,8,28,0,0
8.66,10,24,417.56,4,31,57.883,44.5,58,65.478,61,3,38.313,36.331,13,34,7,27,1,1
5.6,7,20,368.45,4,27,48.527,38.5,48,54.489,51,0,31.722,30.64,13,30,7,21,0,0
6.469,1,19,347.35,3,26,40.033,41.5,39,43.409,42,4,27.642,27.557,18,29,7,13,0,0
7.854,9,29,509.67,6,38,68.97,55.0,69,77.889,74,3,46.086,43.901,20,43,9,31,0,0
8.097,8,21,361.49,4,27,49.789,39.5,50,56.438,53,2,33.336,31.563,12,30,6,23,1,1
7.222,8,21,425.56,4,30,53.52,44.5,53,59.777,56,4,35.892,34.18,12,33,9,23,1,1
9.0,9,22,375.52,4,28,52.672,40.5,53,59.853,56,2,35.097,33.09,12,31,6,25,1,1
5.638,6,23,429.53,7,32,55.436,47.5,55,62.229,59,3,37.04,35.794,17,36,9,23,0,0
5.959,8,28,496.62,5,37,65.312,54.0,65,73.185,70,3,43.773,42.068,20,42,9,28,0,0
6.0,2,18,327.78,4,23,37.593,34.0,37,40.977,39,3,26.557,25.681,16,25,5,14,0,0
6.444,0,19,320.79,2,23,36.156,36.5,36,39.641,39,2,26.892,25.746,19,26,4,13,0,0
8.097,8,28,480.62,5,36,63.985,53.0,64,71.976,69,3,43.319,41.353,20,41,8,28,0,0
9.097,12,25,434.59,4,32,61.876,44.5,62,70.019,65,2,40.284,38.078,12,35,7,30,1,1
6.377,7,27,483.63,6,36,65.087,52.0,65,73.474,69,3,43.324,41.374,20,40,9,29,0,0
7.092,12,26,473.64,5,35,65.97,49.0,66,74.889,71,3,43.086,40.901,14,40,9,31,0,0
6.854,1,19,336.79,2,24,37.484,37.5,37,40.851,40,2,27.347,26.461,18,27,5,13,0,0
6.137,5,25,455.57,5,34,59.32,50.0,59,66.644,63,3,39.801,38.321,20,38,9,25,0,0
6.745,0,18,321.78,2,23,35.374,36.5,35,38.724,38,2,26.137,25.241,18,26,5,12,0,0
6.824,9,23,418.55,4,31,57.101,44.5,57,64.561,60,3,37.557,35.826,13,34,8,26,1,1
6.745,2,21,387.43,6,29,46.793,44.0,46,51.611,49,3,31.96,31.412,19,32,8,17,0,0
6.328,6,22,406.55,4,29,51.091,43.0,51,57.069,54,1,35.432,33.444,15,32,7,22,1,1
6.201,6,24,400.52,4,30,53.898,44.5,54,60.564,57,1,36.546,34.783,17,33,6,24,1,1
6.051,5,23,404.48,4,30,51.527,44.5,51,57.489,54,1,34.722,33.64,17,33,7,21,1,1
8.0,6,23,386.49,4,29,51.014,43.5,51,57.149,54,1,34.784,33.256,16,32,6,22,1,1
5.3,1,25,476.89,4,34,50.596,52.0,49,54.942,53,2,35.995,35.797,24,38,9,15,0,0
5.6,2,12,308.35,5,21,34.327,30.5,33,37.412,34,3,22.534,22.239,10,22,9,12,0,0
7.6,1,22,411.46,5,31,48.785,49.5,48,53.983,52,1,33.756,33.213,21,35,9,17,0,0
6.7,3,21,441.46,3,32,51.763,46.0,50,57.623,53,2,33.637,33.702,18,35,11,18,0,0
5.6,0,17,287.35,2,22,35.043,36.0,35,39.152,38,0,25.074,24.214,17,25,5,13,0,0
8.699,6,21,379.45,5,28,49.567,40.5,49,55.069,51,3,32.688,31.665,14,30,7,21,1,1
7.462,4,20,366.46,7,27,49.342,38.0,49,55.358,51,0,32.239,30.971,16,29,7,22,0,0
5.9,1,19,394.47,3,28,43.945,43.0,43,48.535,46,1,30.881,30.048,18,31,9,15,0,0
4.0,2,13,239.31,1,18,31.043,27.0,31,35.152,33,1,21.074,20.214,11,20,5,13,0,0
7.745,9,23,390.53,4,29,54.781,41.5,55,61.979,58,2,36.307,34.31,13,32,6,26,1,1
6.027,6,22,406.55,4,29,51.091,43.0,51,57.069,54,1,35.432,33.444,15,32,7,22,1,1
7.398,1,21,408.87,4,29,46.898,44.0,46,51.472,49,1,32.574,31.745,20,32,8,17,0,0
7.569,2,22,406.45,4,30,49.971,45.0,49,55.283,52,1,33.415,32.828,20,33,8,19,0,0
6.658,5,19,340.83,2,24,41.251,35.5,41,45.681,44,3,28.87,27.514,14,27,5,17,0,0
6.854,2,20,366.82,3,26,41.694,39.5,41,45.475,44,2,29.563,28.702,18,29,6,15,0,0
5.678,1,18,337.78,2,24,36.702,37.5,36,39.934,39,2,26.591,25.955,17,27,6,12,0,0
6.469,7,19,342.85,2,24,43.134,34.5,43,48.096,46,2,29.631,28.041,12,27,5,19,0,0
6.143,1,18,337.78,2,24,36.702,37.5,36,39.934,39,2,26.591,25.955,17,27,6,12,0,0
7.1,1,21,453.32,4,29,46.803,44.0,46,51.369,49,1,33.068,31.943,20,32,8,17,0,0
9.1,1,20,376.43,3,28,45.752,43.0,45,51.03,48,1,30.995,30.387,19,31,8,17,0,0
6.553,3,23,397.47,4,30,49.349,46.0,49,54.817,53,3,34.267,33.224,20,34,7,19,0,0
8.301,7,27,481.61,5,36,63.203,53.0,63,71.059,68,3,42.563,40.847,20,41,9,27,0,0
6.523,3,21,364.85,3,26,43.251,39.5,43,47.681,46,2,30.87,29.514,18,29,5,17,0,0
5.301,1,19,317.37,2,24,39.262,37.5,39,43.405,42,2,27.495,26.655,18,27,5,15,0,0
7.252,10,24,447.6,5,33,62.087,46.0,62,70.474,66,3,40.324,38.374,14,37,9,29,0,0
7.046,1,20,327.36,2,25,38.378,40.5,38,41.99,41,2,27.733,27.128,18,28,5,13,1,1
7.456,11,25,461.63,5,34,64.97,47.0,65,73.889,69,3,42.086,39.901,14,38,9,31,0,0
6.8,1,21,408.87,4,29,46.898,44.0,46,51.472,49,1,32.574,31.745,20,32,8,17,0,0
5.745,11,25,461.63,7,34,64.97,47.0,65,73.889,69,3,42.086,39.901,14,38,9,31,0,0
7.252,8,29,494.65,5,37,66.869,54.0,67,75.391,72,3,45.08,42.88,21,42,8,30,0,0
5.481,9,23,434.55,6,32,58.429,45.0,58,65.77,62,3,38.012,36.541,14,36,9,26,0,0
7.398,7,31,589.68,7,43,74.392,61.0,73,83.324,77,2,48.66,47.578,24,47,12,30,0,0
9.2,1,20,358.44,3,27,45.24,42.0,45,50.69,48,1,31.057,30.004,19,30,7,18,0,0
6.26,1,20,326.38,2,25,39.153,40.5,39,43.279,42,2,28.284,27.434,18,28,5,14,1,1
9.5,1,20,376.43,3,28,45.752,43.0,45,51.03,48,1,30.995,30.387,19,31,8,17,0,0
7.921,6,27,496.57,6,37,61.872,55.0,61,68.564,66,4,41.705,40.729,21,42,10,24,0,0
6.602,10,30,524.68,7,39,71.08,56.0,71,80.016,76,3,47.296,45.121,20,44,9,32,0,0
8.602,3,22,354.44,3,27,44.92,42.5,45,50.109,48,2,31.807,30.488,18,30,5,18,1,1
5.6,5,18,338.43,3,25,44.309,36.5,44,50.236,47,0,29.302,28.199,13,28,7,19,0,0
7.076,2,15,238.31,1,18,31.833,27.5,32,35.697,34,2,22.034,20.918,13,20,3,14,0,0
5.35,0,20,331.37,3,25,39.447,39.5,39,43.535,42,0,27.978,27.323,20,28,5,14,0,0
6.42,10,26,530.5,9,36,65.625,49.5,65,73.405,68,0,44.006,41.755,15,39,10,29,1,1
4.2,0,14,221.28,2,17,27.84,27.5,28,31.156,30,0,20.063,19.171,14,19,3,11,0,0
5.4,10,17,380.59,6,25,49.051,33.0,49,55.404,51,1,32.841,30.157,7,27,8,24,0,0
5.7,1,16,327.19,0,20,31.178,32.0,31,34.124,34,1,23.625,22.417,15,23,4,11,0,0
5.0,7,32,515.66,5,39,67.767,61.0,68,75.893,74,3,47.074,44.858,25,45,7,29,0,0
5.8,4,24,378.46,2,29,46.92,49.0,47,52.109,52,1,33.807,32.488,19,34,5,18,1,1
6.2,5,16,281.4,2,21,39.694,31.0,40,45.398,42,0,26.358,24.795,11,23,5,19,0,0
5.6,0,20,333.36,3,25,38.632,39.5,38,42.666,41,0,27.461,26.992,20,28,5,13,0,0
5.0,7,24,485.99,9,34,60.047,47.5,59,66.971,62,2,39.563,38.257,17,37,10,25,0,0
4.523,7,22,423.59,5,30,55.076,42.5,55,61.982,58,1,37.199,34.992,15,33,8,25,0,0
4.523,6,21,472.38,4,30,52.672,42.5,52,58.698,55,1,35.597,34.018,15,33,9,22,0,0
4.699,1,15,235.31,2,18,30.723,28.5,31,34.571,33,0,21.824,20.698,14,20,3,13,0,0
5.6,3,19,392.67,1,25,37.913,37.5,37,40.656,40,1,28.818,27.621,16,28,6,12,0,0
5.398,1,12,225.28,2,17,28.16,27.0,28,31.737,30,0,19.313,18.687,11,19,5,11,0,0
5.6,1,15,328.18,0,20,30.396,32.0,30,33.207,33,1,22.87,21.911,14,23,5,10,0,0
6.4,0,21,391.83,3,28,42.913,43.0,42,46.558,45,3,30.807,30.197,21,31,7,14,0,0
6.0,1,22,371.42,3,28,45.473,43.0,45,50.03,48,3,31.71,30.896,21,31,6,17,0,0
7.004,1,28,430.54,6,33,54.687,52.5,55,60.939,59,1,39.33,37.542,27,37,5,22,0,0
4.2,0,13,212.27,2,16,27.949,24.0,28,31.282,29,1,19.273,18.392,13,17,3,12,0,0
7.284,2,18,392.26,5,26,42.12,37.5,41,45.918,43,1,29.426,28.551,16,28,8,15,0,0
5.6,8,28,468.6,2,35,62.992,53.0,63,70.604,68,3,42.523,40.552,20,40,7,28,0,0
5.6,3,24,399.55,5,29,49.662,44.5,50,55.361,53,1,35.972,33.707,21,32,5,21,0,0
5.9,3,19,387.85,5,27,46.007,38.5,45,50.598,47,1,30.784,29.965,16,29,8,18,0,0
6.8,3,22,403.55,3,29,49.982,44.0,50,55.943,53,1,35.222,33.223,19,32,7,21,0,0
7.4,8,20,447.92,4,31,54.422,42.0,53,60.219,55,1,35.012,34.25,11,33,11,22,1,1
9.2,0,20,361.41,3,27,43.651,42.0,43,48.532,46,1,29.989,29.366,20,30,7,16,0,0
4.602,8,29,598.67,11,43,75.007,59.0,73,84.162,76,1,47.603,46.982,21,46,14,30,0,0
9.0,1,21,375.44,3,28,46.534,43.0,46,51.947,49,1,31.75,30.893,20,31,7,18,0,0
8.6,1,21,342.43,3,26,43.92,41.0,44,49.109,47,1,30.807,29.488,20,29,5,18,0,0
5.721,5,19,370.42,5,27,46.971,40.0,46,52.283,49,0,30.415,29.828,14,30,8,19,0,0
5.601,4,16,383.89,6,25,44.084,35.0,43,48.518,44,3,29.432,28.152,12,26,9,18,0,0
6.2,3,16,375.45,6,26,44.196,38.0,43,48.74,44,3,29.063,28.314,12,27,10,17,1,1
5.601,7,20,448.55,8,31,56.283,43.0,55,62.322,56,3,36.012,34.83,12,32,11,24,1,1
5.0,4,22,358.48,6,27,48.687,41.0,49,54.939,52,0,33.33,31.542,18,30,5,22,0,0
5.6,1,17,325.77,1,23,35.702,35.5,35,38.934,38,1,25.591,24.955,16,26,6,12,0,0
5.6,0,20,362.78,1,26,37.927,42.5,37,40.645,41,2,28.04,27.649,20,30,6,11,0,0
7.244,2,21,461.48,3,32,49.149,47.0,47,53.886,50,1,33.211,33.23,19,35,11,15,0,0
5.6,5,14,291.41,2,20,37.222,29.5,37,41.74,39,2,24.904,23.369,9,22,6,17,0,0
5.0,7,18,441.51,6,30,52.872,41.0,51,58.665,53,3,33.222,32.661,11,32,12,21,0,0
7.0,6,17,293.41,3,22,40.694,33.0,41,46.398,44,0,27.358,25.795,11,25,5,19,0,0
9.174,2,21,443.38,4,29,45.644,43.0,45,49.917,48,2,34.171,32.33,19,32,8,16,0,0
7.8,10,26,476.65,7,34,62.069,49.0,62,69.524,66,1,42.171,39.739,14,38,8,28,2,1
5.0,8,34,577.74,6,43,78.072,62.0,78,87.557,83,2,52.267,49.868,26,48,9,35,0,0
8.097,8,29,480.68,5,35,62.414,53.0,63,70.105,68,0,44.262,41.309,19,40,6,28,2,1
5.6,10,20,416.61,9,29,57.061,39.0,57,64.896,59,2,36.966,34.54,10,31,9,28,0,0
8.2,1,21,374.5,3,27,44.996,42.0,45,50.029,48,1,32.455,30.675,20,30,6,18,0,0
6.0,0,20,394.91,3,27,42.436,42.0,42,46.558,45,1,31.551,29.976,20,30,7,15,0,0
5.527,5,28,497.61,8,36,59.527,55.0,59,65.405,63,2,42.097,40.378,21,40,8,23,2,1
6.3,0,18,346.38,5,26,40.8,41.0,40,45.069,43,1,27.989,27.665,18,29,8,14,0,0
9.222,12,24,437.6,6,32,62.978,43.5,63,71.517,66,1,40.29,38.1,11,35,8,31,1,1
7.77,10,22,378.52,4,28,53.781,39.5,54,60.979,57,1,35.307,33.31,11,31,6,26,1,1
6.77,9,21,399.49,8,29,54.662,39.5,54,61.109,56,1,34.665,33.433,11,31,8,25,1,1
7.097,0,22,418.51,5,30,48.651,47.5,48,53.448,51,3,34.364,33.105,22,33,8,18,0,0
7.284,11,23,394.57,8,29,58.549,39.5,59,66.81,61,1,37.83,35.364,11,31,6,30,1,1
9.097,10,22,393.54,4,29,55.883,40.5,56,63.478,59,1,36.313,34.331,11,32,7,27,1,1
6.745,5,16,314.38,4,23,41.574,33.5,41,46.528,43,3,26.716,25.918,11,25,7,18,0,0
7.0,0,21,358.4,4,27,42.549,42.5,42,47.034,45,1,29.983,29.345,21,30,6,15,0,0
6.824,5,17,294.39,3,22,39.92,32.5,40,45.109,42,1,26.807,25.488,11,24,5,18,1,1
5.6,9,24,415.54,7,31,56.0,45.5,56,63.062,60,0,37.551,35.805,14,35,7,25,1,1
7.097,2,23,368.47,4,28,47.803,43.5,48,53.524,51,1,33.569,32.015,21,31,5,20,0,0
7.097,1,22,372.43,4,28,45.432,43.5,45,50.449,48,1,31.745,30.871,21,31,6,17,0,0
5.0,5,16,331.36,5,24,42.127,34.5,41,46.448,43,3,26.619,26.326,11,26,8,17,0,0
5.959,5,17,298.37,4,22,40.254,31.5,40,44.946,42,2,26.466,25.402,12,24,5,18,0,0
7.796,0,22,418.31,4,27,43.047,42.5,43,47.452,46,1,32.154,30.492,22,30,5,16,0,0
5.0,4,15,317.33,4,23,39.244,33.5,38,43.033,40,3,24.858,24.799,11,25,8,15,0,0
6.721,6,18,325.4,4,24,43.356,34.5,43,48.445,45,1,28.472,27.423,11,26,6,19,1,1
6.523,5,18,320.38,3,24,40.363,36.5,40,44.903,42,1,27.5,26.676,11,26,6,16,2,2
6.796,0,22,354.44,4,27,44.92,42.5,45,50.109,48,1,31.807,30.488,22,30,5,18,0,0
6.699,1,23,453.5,5,32,50.458,49.5,49,55.044,52,3,34.995,34.377,22,35,9,17,0,0
7.398,1,22,388.88,4,28,45.243,43.5,45,50.053,48,1,32.665,31.316,21,31,6,17,0,0
8.735,10,22,392.56,4,29,56.658,40.5,57,64.766,60,1,36.864,34.638,11,32,7,28,1,1
7.495,1,22,458.85,5,32,48.109,47.5,46,52.282,49,1,32.932,33.18,21,35,10,14,0,0
5.0,4,21,392.45,5,29,49.785,43.5,49,55.152,52,3,32.932,32.159,17,32,8,20,0,0
5.0,5,17,313.39,4,23,42.356,32.5,42,47.445,44,2,27.472,26.423,12,25,6,19,0,0
7.602,7,19,402.52,5,28,50.745,40.5,50,56.488,52,3,33.341,31.873,11,30,9,22,1,1
5.495,0,18,331.36,4,25,38.698,40.0,38,42.571,41,1,26.983,26.644,18,28,7,13,0,0
6.495,0,22,380.44,4,29,45.356,47.5,45,50.275,49,1,32.296,31.477,22,33,7,16,0,0
5.585,6,19,366.47,6,27,49.334,38.5,49,55.73,51,2,32.034,30.772,12,29,8,22,1,1
6.602,7,19,339.43,4,25,46.24,35.5,46,51.86,48,1,30.233,28.95,11,27,6,21,1,1
5.0,5,16,285.38,3,21,40.029,29.5,40,45.235,42,1,26.017,24.708,11,23,5,19,0,0
5.276,7,18,343.42,4,25,46.567,35.5,46,52.069,48,3,29.688,28.665,11,27,7,21,0,0
6.886,1,23,407.42,4,30,47.24,45.5,46,52.045,49,1,32.375,32.143,22,33,7,16,0,0
6.0,1,18,337.78,2,24,36.702,37.5,36,39.934,39,2,26.591,25.955,17,27,6,12,0,0
6.602,1,19,320.34,2,24,37.673,37.5,37,41.246,40,2,26.426,26.017,18,27,5,13,0,0
6.553,0,19,312.35,2,24,36.269,39.5,36,39.863,39,2,26.523,25.908,18,27,5,12,1,1
6.081,1,19,335.81,2,24,38.258,37.5,38,42.14,41,2,27.898,26.767,18,27,5,14,0,0
9.398,10,23,389.55,4,29,55.556,41.5,56,63.268,59,2,36.858,34.617,12,32,6,27,1,1
6.699,4,22,378.88,3,27,46.134,40.5,46,51.096,49,2,32.631,31.041,18,30,5,19,0,0
5.301,1,19,302.35,2,23,37.16,36.5,37,40.907,40,2,26.489,25.633,18,26,4,14,0,0
9.0,2,21,390.46,3,29,48.636,44.0,48,54.445,51,1,32.756,31.914,19,32,8,19,0,0
8.398,8,29,508.63,5,38,66.312,56.0,66,74.185,71,4,44.773,43.068,21,43,9,28,0,0
8.301,11,25,432.57,4,32,59.992,45.5,60,67.604,63,1,39.523,37.552,11,35,7,28,3,2
6.495,0,18,337.78,2,24,36.702,37.5,36,39.934,39,2,26.591,25.955,18,27,6,12,0,0
4.699,1,18,303.34,2,23,36.378,36.5,36,39.99,39,2,25.733,25.128,17,26,5,13,0,0
8.801,1,20,430.4,3,31,47.291,46.0,45,52.049,48,1,30.807,31.537,19,34,11,14,0,0
6.62,2,20,350.82,2,25,40.367,38.5,40,44.266,43,2,29.108,27.988,18,28,5,15,0,0
8.678,3,21,363.87,3,26,44.025,39.5,44,48.97,47,2,31.421,29.821,18,29,5,18,0,0
8.097,10,30,523.7,7,39,71.854,56.0,72,81.305,77,3,47.847,45.428,20,44,9,33,0,0
8.097,9,29,510.65,7,38,68.196,55.0,68,76.6,73,3,45.534,43.594,20,43,9,30,0,0
9.5,1,20,392.88,3,28,45.563,43.0,45,50.634,48,1,31.915,30.832,19,31,8,17,0,0
7.6,2,21,372.47,3,28,48.123,43.0,48,54.106,51,1,32.819,31.531,19,31,7,20,0,0
7.032,8,28,511.64,5,38,67.414,55.0,67,75.684,72,3,44.779,43.089,20,43,10,29,0,0
6.523,0,15,234.27,1,18,28.065,31.0,28,30.867,31,0,20.512,19.865,15,21,3,10,0,0
5.7,4,15,301.81,2,21,37.134,31.0,37,41.927,39,0,25.455,24.095,11,23,6,16,0,0
7.268,10,24,404.56,4,30,57.665,42.5,58,65.394,61,2,38.069,35.837,13,33,6,28,1,1
8.4,2,22,372.46,3,28,48.131,43.0,48,53.734,51,1,33.023,31.73,20,31,6,20,0,0
7.42,10,25,435.57,7,32,61.101,44.5,61,68.73,63,3,39.733,37.772,14,34,7,29,1,1
6.2,3,21,459.45,3,33,52.276,47.0,50,57.963,53,2,33.574,34.085,18,36,12,17,0,0
5.6,3,22,465.38,7,32,50.763,48.5,50,56.366,53,0,36.33,34.987,18,35,10,18,1,1
7.6,7,19,433.89,3,30,51.538,41.0,50,56.804,52,1,33.25,32.723,11,32,11,20,1,1
7.886,8,28,495.64,5,37,66.087,54.0,66,74.474,71,3,44.324,42.374,20,42,9,29,0,0
5.6,8,26,587.61,15,41,73.651,57.0,72,82.206,75,2,47.284,45.594,18,44,15,31,0,0
5.6,5,17,360.41,6,26,45.149,37.0,44,50.785,46,1,28.694,28.297,12,28,9,18,0,0
5.6,6,21,401.87,2,28,48.898,39.0,48,53.641,51,2,32.75,31.691,15,31,7,20,0,0
6.2,4,17,374.46,6,26,44.978,38.0,44,49.657,45,3,29.818,28.82,12,27,9,18,1,1
7.222,8,22,392.5,4,29,53.225,41.5,53,59.773,56,2,35.0,33.498,13,32,7,24,1,1
7.302,5,16,315.36,4,23,40.8,33.5,40,45.239,42,3,26.165,25.611,11,25,7,17,0,0
7.201,1,23,432.54,6,31,51.534,48.5,51,56.863,54,3,36.125,34.632,22,34,8,20,0,0
5.553,6,21,401.87,2,28,48.898,39.0,48,53.641,51,2,32.75,31.691,15,31,7,20,0,0
7.149,6,18,388.49,5,27,47.862,39.5,47,53.072,49,3,31.58,30.346,11,29,9,20,1,1
7.699,2,28,484.96,6,35,56.673,54.0,56,61.93,60,1,40.301,38.997,26,39,7,21,0,0
7.201,5,17,313.36,3,23,39.658,33.5,39,44.16,41,1,26.193,25.565,11,25,6,16,1,1
7.222,9,23,467.6,4,33,58.731,48.5,58,65.401,61,5,39.108,37.421,13,36,10,25,1,1
7.523,2,22,442.43,4,32,50.996,47.0,49,55.962,52,1,33.29,33.594,20,35,10,17,0,0
7.796,9,23,454.6,5,32,58.512,46.5,58,65.318,60,3,38.864,36.927,11,34,9,26,3,2
7.046,6,20,354.86,2,25,44.134,36.5,44,49.096,47,3,30.631,29.041,14,28,5,19,0,0
5.6,14,27,513.57,7,35,68.512,47.5,69,78.106,73,0,46.171,42.685,13,39,8,34,0,0
9.523,11,23,392.55,4,29,56.665,40.5,57,64.394,60,1,37.069,34.837,11,32,6,28,1,1
5.658,6,17,329.39,4,24,43.683,34.5,43,48.654,45,3,27.926,27.138,11,26,7,19,0,0
5.3,1,22,384.42,4,29,45.691,45.5,45,50.113,49,1,31.955,31.391,21,33,7,16,0,0
8.046,2,18,341.37,5,25,41.985,36.5,41,46.369,43,1,27.648,27.28,16,27,7,16,0,0
7.097,1,24,396.48,5,30,50.131,46.5,50,55.734,53,2,35.023,33.73,23,33,6,20,0,0
5.6,1,13,304.16,2,18,28.396,28.0,28,31.207,30,0,20.87,19.911,12,20,5,10,0,0
5.465,15,30,548.76,9,40,79.941,53.5,80,90.886,84,1,50.796,47.943,15,44,10,40,0,0
8.62,7,28,576.69,9,41,70.371,60.0,69,77.733,73,6,46.784,45.399,21,45,13,28,0,0
8.398,4,21,379.52,4,27,47.989,39.5,48,53.571,50,2,33.426,31.422,17,29,6,21,0,0
9.155,10,30,560.66,6,41,72.105,58.0,71,80.695,76,3,47.171,45.888,20,46,11,30,0,0
5.0,5,16,382.28,4,25,42.996,34.5,42,47.705,44,2,28.983,27.879,11,27,9,17,0,0
9.097,9,30,553.68,8,41,72.625,59.0,72,81.308,77,4,47.995,46.331,21,46,11,31,0,0
9.097,11,31,554.71,7,41,75.29,58.0,75,84.64,80,3,49.512,47.363,20,46,10,34,0,0
7.658,2,18,357.82,5,25,41.796,36.5,41,45.974,43,1,28.568,27.724,16,27,7,16,0,0
6.155,12,32,641.67,7,43,77.578,61.5,77,86.282,82,5,53.387,50.216,20,48,11,34,0,0
8.155,11,30,555.7,7,41,74.509,58.0,74,83.723,79,3,48.756,46.857,19,46,11,33,0,0
4.8,0,8,161.18,1,12,19.4,19.0,19,21.535,20,1,12.994,12.833,8,13,4,7,0,0
9.301,12,32,567.76,9,42,78.949,59.0,79,89.344,84,3,51.824,49.196,20,47,10,37,0,0
9.155,12,32,567.76,9,42,78.949,59.0,79,89.344,84,3,51.824,49.196,20,47,10,37,0,0
8.886,11,31,554.71,8,41,75.29,58.0,75,84.64,80,3,49.512,47.363,20,46,10,34,0,0
5.6,4,15,319.32,3,23,36.465,34.0,35,40.587,38,0,23.648,23.891,11,26,8,12,0,0
9.0,5,21,448.39,8,30,53.647,41.5,53,59.95,55,1,36.267,34.46,16,32,9,23,0,0
8.658,10,31,568.69,8,42,74.734,60.0,74,83.434,79,4,49.205,47.551,21,47,11,32,0,0
8.398,2,25,437.55,4,33,56.109,51.5,56,63.019,60,1,38.586,37.079,23,37,8,23,0,0
7.432,2,21,399.4,4,29,46.567,42.0,45,51.254,47,2,30.83,30.858,19,31,8,16,0,0
7.495,2,21,399.4,4,29,46.567,42.0,45,51.254,47,2,30.83,30.858,19,31,8,16,0,0
7.051,3,26,488.61,6,35,59.629,53.5,59,65.903,62,4,41.102,39.4,23,38,9,24,0,0
8.0,1,20,365.84,4,26,42.469,39.0,42,46.764,44,2,30.114,29.009,19,28,6,16,0,0
8.77,11,31,574.69,8,42,74.989,59.0,74,84.11,79,3,48.932,47.415,20,47,11,32,0,0
5.301,3,18,339.86,6,24,42.018,35.0,42,47.342,44,0,29.216,27.622,15,26,6,18,0,0
5.301,2,17,389.9,6,26,42.865,39.0,42,47.266,44,2,30.012,28.712,15,28,9,16,0,0
7.824,3,19,367.87,5,26,44.345,38.0,44,49.551,46,1,30.671,29.337,16,28,7,18,0,0
6.301,3,17,295.37,4,22,39.145,32.5,39,43.82,41,0,26.256,25.181,14,24,5,17,0,0
5.301,2,12,248.74,3,17,30.149,24.0,30,34.013,31,0,20.688,19.547,10,18,5,13,0,0
5.301,3,19,367.87,5,26,44.345,38.0,44,49.551,46,1,30.671,29.337,16,28,7,18,0,0
6.067,2,18,353.84,5,25,41.462,37.0,41,46.136,43,1,28.909,27.81,16,27,7,16,0,0
5.8,6,23,468.99,7,33,58.752,46.0,58,65.714,61,1,38.87,37.368,17,36,10,25,0,0
8.097,2,21,379.87,4,27,45.353,40.0,45,50.179,47,2,31.875,30.536,19,29,6,18,0,0
8.301,2,21,379.87,4,27,45.353,40.0,45,50.179,47,2,31.875,30.536,19,29,6,18,0,0
8.523,0,19,420.69,4,27,40.233,40.0,39,43.237,41,2,30.068,29.137,19,29,8,12,0,0
8.155,2,19,457.86,4,30,44.596,42.5,42,48.043,44,2,30.512,30.729,17,32,11,12,0,0
6.623,6,30,539.64,8,40,69.749,58.5,69,77.521,73,3,46.438,45.003,24,44,10,29,0,0
8.523,0,19,420.69,4,27,40.233,40.0,39,43.237,41,2,30.068,29.137,19,29,8,12,0,0
4.301,2,22,398.41,4,29,47.349,42.0,46,52.171,48,2,31.586,31.364,20,31,7,17,0,0
8.301,0,17,392.28,4,25,37.102,37.5,36,39.798,38,2,28.097,26.97,17,27,8,11,0,0
8.523,2,19,385.9,4,26,42.545,38.5,42,46.684,44,2,30.762,29.196,17,28,7,16,0,0
8.0,3,20,419.46,4,29,46.643,41.5,45,51.174,47,2,31.478,31.045,17,31,9,16,0,0
5.6,6,26,518.61,8,38,66.145,55.0,65,74.106,69,2,42.961,41.967,20,42,12,27,0,0
8.0,0,19,386.25,4,26,39.909,39.0,39,43.293,41,2,29.21,28.31,19,28,7,13,0,0
7.854,0,19,430.7,4,26,39.814,39.0,39,43.191,41,2,29.705,28.507,19,28,7,13,0,0
8.046,1,20,381.84,5,27,43.796,40.0,43,47.974,45,2,30.568,29.724,19,29,7,16,0,0
6.7,0,15,270.73,1,19,30.273,29.0,30,33.226,32,2,22.131,21.219,15,21,4,11,0,0
8.222,3,20,399.93,4,27,45.429,39.5,45,50.099,47,2,32.523,30.723,17,29,7,18,0,0
8.155,2,19,385.9,4,26,42.545,38.5,42,46.684,44,2,30.762,29.196,17,28,7,16,0,0
8.155,2,19,439.87,4,29,44.083,41.5,42,47.703,44,2,30.574,30.346,17,31,10,13,0,0
8.398,1,18,406.31,4,26,39.985,38.5,39,43.213,41,2,29.858,28.497,17,28,8,13,0,0
5.0,7,27,532.64,8,39,69.029,56.0,68,77.522,72,2,44.722,43.494,20,43,12,29,0,0
5.6,2,12,282.67,1,19,28.556,27.5,27,30.569,29,1,19.216,19.505,10,21,7,8,0,0
5.161,2,21,399.4,4,29,46.567,42.0,45,51.254,47,2,30.83,30.858,19,31,8,16,0,0
7.886,4,21,467.93,5,31,49.851,43.5,48,54.534,50,2,34.097,33.4,17,33,10,17,0,0
7.509,5,22,427.99,5,29,51.196,41.5,51,56.93,53,2,36.046,33.776,17,31,7,22,0,0
8.854,10,30,524.68,7,39,71.08,56.0,71,80.016,76,3,47.296,45.121,20,44,9,32,0,0
6.854,4,21,465.91,5,31,47.967,44.5,46,52.118,49,2,33.335,32.873,17,34,10,15,0,0
8.301,3,19,367.87,5,26,44.345,38.0,44,49.551,46,1,30.671,29.337,16,28,7,18,0,0
8.046,3,20,366.88,5,26,45.127,38.0,45,50.468,47,1,31.426,29.842,17,28,6,19,0,0
8.0,3,20,420.85,5,29,46.665,41.0,45,51.487,47,1,31.239,30.992,17,31,9,16,0,0
5.301,3,20,411.33,5,26,45.032,38.0,45,50.366,47,1,31.921,30.04,17,28,6,19,0,0
7.658,3,25,441.53,7,33,56.443,49.0,56,62.857,59,1,38.245,36.993,22,36,8,23,0,0
6.381,3,25,441.53,7,33,56.443,49.0,56,62.857,59,1,38.245,36.993,22,36,8,23,0,0
6.2,4,22,478.48,7,33,52.407,47.5,50,56.72,53,1,34.597,34.695,18,36,11,17,0,0
8.046,2,19,405.28,5,27,43.08,39.0,42,47.337,44,1,30.46,29.526,17,29,8,15,0,0
8.699,3,20,384.87,5,27,45.64,39.0,45,50.808,47,1,31.364,30.226,17,29,7,18,0,0
5.301,8,19,373.93,5,26,49.996,35.0,50,56.797,52,1,32.955,30.917,11,28,7,24,0,0
5.9,6,22,470.51,7,34,58.712,47.0,57,65.113,60,1,37.097,36.827,16,37,12,23,0,0
8.301,1,20,469.27,4,31,46.433,44.0,44,50.226,46,2,31.79,32.008,19,33,11,13,0,0
6.836,4,21,437.58,5,31,54.512,47.0,54,61.149,57,2,36.688,34.981,17,34,10,23,0,0
4.699,8,22,348.48,6,26,49.578,37.0,50,55.983,53,2,33.296,31.267,14,29,4,24,0,0
7.658,2,18,392.26,5,26,42.12,37.5,41,45.918,43,1,29.426,28.551,16,28,8,15,0,0
8.155,5,21,415.49,8,30,54.025,41.5,53,60.742,55,1,34.427,33.571,16,32,9,23,0,0
8.155,7,23,457.53,8,33,59.236,45.5,58,66.366,61,1,37.642,36.813,16,36,10,25,0,0
7.638,5,21,415.49,8,30,54.025,41.5,53,60.742,55,1,34.427,33.571,16,32,9,23,0,0
7.337,3,19,353.41,6,26,45.683,37.5,45,50.654,47,1,29.926,29.138,16,28,7,19,0,0
7.745,2,18,375.81,5,26,42.309,37.5,41,46.313,43,1,28.506,28.107,16,28,8,15,0,0
7.553,2,18,359.36,5,26,42.498,37.5,41,46.709,43,1,27.585,27.663,16,28,8,15,0,0
7.602,2,18,359.36,5,26,42.498,37.5,41,46.709,43,1,27.585,27.663,16,28,8,15,0,0
7.444,2,18,402.27,5,25,41.702,36.5,41,45.871,43,1,29.063,27.921,16,27,7,16,0,0
7.284,3,19,337.41,5,25,44.356,36.5,44,49.445,46,1,29.472,28.423,16,27,6,19,0,0
7.481,2,18,341.37,5,25,41.985,36.5,41,46.369,43,1,27.648,27.28,16,27,7,16,0,0
8.523,6,22,460.4,5,31,54.647,43.5,54,60.95,57,1,37.267,35.46,16,34,9,23,0,0
7.42,3,19,337.41,5,25,44.356,36.5,44,49.445,46,1,29.472,28.423,16,27,6,19,0,0
8.222,6,22,427.5,5,31,55.025,43.5,54,61.742,57,1,35.427,34.571,16,34,9,23,0,0
7.097,8,24,488.99,8,34,61.156,46.5,60,68.097,63,1,39.773,38.477,16,37,10,26,0,0
7.229,5,21,430.37,4,29,50.436,41.5,50,56.326,53,1,35.051,33.218,16,32,8,21,0,0
8.097,5,21,430.37,4,29,50.436,41.5,50,56.326,53,1,35.051,33.218,16,32,8,21,0,0
7.638,6,22,460.4,5,31,54.647,43.5,54,60.95,57,1,37.267,35.46,16,34,9,23,0,0
7.959,6,22,427.5,5,31,55.025,43.5,54,61.742,57,1,35.427,34.571,16,34,9,23,0,0
8.046,2,18,392.26,5,26,42.12,37.5,41,45.918,43,1,29.426,28.551,16,28,8,15,0,0
7.886,7,23,458.96,8,32,56.945,44.5,56,63.472,59,1,37.557,36.236,16,35,9,24,0,0
7.824,8,24,488.46,8,33,60.414,45.5,60,67.781,63,1,40.79,38.513,16,36,9,27,0,0
8.523,6,22,462.42,9,31,56.531,42.5,56,63.366,58,1,38.029,35.986,16,33,9,25,0,0
8.222,9,25,502.49,9,34,63.298,46.5,63,71.196,66,1,42.551,40.04,16,37,9,29,0,0
7.824,2,18,359.36,5,26,42.498,37.5,41,46.709,43,1,27.585,27.663,16,28,8,15,0,0
7.0,2,18,359.36,5,26,42.498,37.5,41,46.709,43,1,27.585,27.663,16,28,8,15,0,0
8.523,7,23,474.43,6,32,57.531,44.5,57,64.366,60,1,39.029,36.986,16,35,9,25,0,0
7.745,7,23,476.98,11,33,60.156,44.5,59,67.097,61,1,38.773,37.477,16,35,10,26,0,0
8.523,6,22,460.4,5,31,54.647,43.5,54,60.95,57,1,37.267,35.46,16,34,9,23,0,0
8.0,6,22,462.95,10,32,57.272,43.5,56,63.682,58,1,37.012,35.95,16,34,10,24,0,0
8.155,9,25,502.04,9,35,64.814,47.5,64,72.801,67,1,42.086,40.311,16,38,10,29,0,0
6.959,5,21,397.47,4,29,50.814,41.5,50,57.117,53,1,33.211,32.33,16,32,8,21,0,0
8.523,5,21,448.36,4,30,50.949,42.5,50,56.665,53,1,34.989,33.601,16,33,9,20,0,0
8.0,9,25,502.04,9,35,64.814,47.5,64,72.801,67,1,42.086,40.311,16,38,10,29,0,0
7.509,4,20,351.44,5,26,47.24,37.5,47,52.86,49,1,31.233,29.95,16,28,6,21,0,0
7.538,3,19,371.85,5,26,44.68,37.5,44,49.389,46,1,30.33,29.251,16,28,7,18,0,0
8.699,6,22,460.4,5,31,54.647,43.5,54,60.95,57,1,37.267,35.46,16,34,9,23,0,0
5.7,2,20,417.44,5,29,44.76,43.5,43,48.759,46,1,30.716,30.518,18,32,9,14,0,0
8.155,8,24,488.46,8,33,60.414,45.5,60,67.781,63,1,40.79,38.513,16,36,9,27,0,0
7.268,5,21,415.46,4,30,51.327,42.5,50,57.457,53,1,33.148,32.713,16,33,9,20,0,0
8.222,7,23,441.53,6,32,57.909,44.5,57,65.157,60,1,37.188,36.098,16,35,9,25,0,0
6.699,2,18,375.81,5,26,42.309,37.5,41,46.313,43,1,28.506,28.107,16,28,8,15,0,0
7.796,2,18,375.81,5,26,42.309,37.5,41,46.313,43,1,28.506,28.107,16,28,8,15,0,0
7.585,2,18,359.36,5,26,42.498,37.5,41,46.709,43,1,27.585,27.663,16,28,8,15,0,0
5.0,0,13,194.25,1,15,24.738,25.0,25,27.657,27,0,18.057,17.15,13,17,2,10,0,0
6.0,2,18,430.98,6,28,43.833,42.5,43,48.059,46,1,32.449,30.679,16,31,10,15,0,0
6.2,5,18,368.51,4,26,46.2,37.5,46,52.026,49,0,31.466,29.718,13,29,8,20,0,0
5.7,3,27,518.96,6,37,58.505,55.0,57,63.851,61,2,40.489,39.897,24,41,10,20,0,0
5.0,5,27,469.59,9,35,62.211,51.5,62,69.687,65,2,41.767,40.046,22,38,8,27,0,0
5.6,11,27,457.63,7,34,64.65,49.0,65,73.308,68,2,42.836,40.385,15,37,7,31,1,1
4.699,10,30,496.66,5,37,68.76,54.0,69,77.434,74,1,46.046,43.605,20,42,7,32,0,0
5.155,10,29,481.65,5,36,66.65,53.0,67,75.308,72,1,44.836,42.385,19,41,7,31,0,0
5.6,9,26,472.6,7,35,63.312,51.0,63,71.185,66,3,41.773,40.068,16,38,9,28,1,1
5.0,0,18,289.33,2,22,34.236,36.0,34,37.911,37,0,24.762,24.082,18,25,4,12,0,0
8.523,4,23,417.49,5,30,53.647,46.0,54,60.577,57,2,37.779,35.013,19,33,7,24,0,0
9.301,9,29,510.65,6,38,68.196,55.0,68,76.6,73,3,45.534,43.594,20,43,9,30,0,0
9.523,9,29,512.67,7,38,70.08,54.0,70,79.016,74,3,46.296,44.121,20,42,9,32,0,0
9.398,9,29,512.67,7,38,70.08,54.0,70,79.016,74,3,46.296,44.121,20,42,9,32,0,0
8.301,13,27,490.67,6,36,69.963,49.0,70,79.431,74,3,45.057,42.648,14,40,9,34,0,0
8.387,13,27,490.67,8,36,69.963,49.0,70,79.431,74,3,45.057,42.648,14,40,9,34,0,0
8.284,5,24,458.52,6,34,56.989,50.0,56,63.149,60,3,37.943,37.202,19,38,10,22,0,0
9.2,7,26,512.48,9,35,62.414,49.0,62,69.781,65,2,42.79,40.513,19,38,9,27,0,0
7.149,1,19,433.8,4,30,43.443,45.0,41,46.949,44,1,29.415,30.148,18,33,11,11,0,0
7.493,9,25,450.56,8,33,60.505,47.5,60,67.944,64,0,39.461,37.935,16,37,8,27,0,0
7.1,0,16,280.33,4,21,34.338,32.0,34,38.409,36,0,23.767,23.103,16,23,5,13,0,0
9.398,10,30,524.68,6,39,71.08,56.0,71,80.016,76,3,47.296,45.121,20,44,9,32,0,0
5.0,11,21,425.55,5,31,58.531,43.5,58,66.268,61,0,37.017,35.562,8,34,10,27,2,1
4.699,7,27,453.59,5,34,60.883,50.5,61,68.478,65,1,41.313,39.331,20,38,7,27,0,0
7.046,7,29,497.72,6,36,66.4,52.5,67,75.019,71,1,46.029,42.857,22,40,7,31,0,0
5.6,0,15,437.23,3,23,32.084,36.5,31,34.009,34,0,25.972,24.293,15,26,8,8,0,0
7.0,9,30,495.68,6,37,69.534,53.5,70,78.723,74,1,46.597,43.912,21,41,7,33,0,0
7.046,7,27,455.61,5,34,62.767,50.0,63,70.893,67,1,42.074,39.858,20,38,7,29,0,0
4.699,9,23,375.51,4,28,52.68,41.0,53,59.481,57,1,35.302,33.289,14,32,5,25,0,0
7.398,2,19,352.85,5,25,42.243,37.0,42,47.053,44,1,29.665,28.316,17,27,6,17,0,0
7.0,4,20,366.46,6,27,49.342,38.5,49,55.358,51,1,32.239,30.971,16,29,7,22,0,0
8.71,3,20,366.88,5,26,45.127,38.0,45,50.468,47,1,31.426,29.842,17,28,6,19,0,0
5.6,2,11,230.32,0,16,26.134,25.5,26,29.159,28,0,18.955,17.853,9,18,5,10,0,0
9.155,11,31,553.73,8,41,76.065,58.0,76,85.929,81,3,50.063,47.669,20,46,10,35,0,0
7.432,10,35,610.74,11,45,80.694,64.5,80,90.023,85,3,53.415,51.472,25,50,10,35,0,0
8.495,12,32,551.76,8,41,77.621,58.0,78,88.135,83,3,51.37,48.481,20,46,9,37,0,0
7.959,2,21,399.4,4,29,46.567,42.0,45,51.254,47,2,30.83,30.858,19,31,8,16,0,0
8.2,1,22,369.46,3,28,47.022,43.5,47,52.607,50,1,32.813,31.509,21,31,6,19,0,0
7.5,2,24,438.54,4,33,55.327,51.5,55,62.102,59,1,37.83,36.574,22,37,9,22,0,0
9.097,10,31,567.71,8,42,75.509,60.0,75,84.723,80,4,49.756,47.857,21,47,11,33,0,0
6.0,1,16,293.3,1,22,33.822,36.0,33,36.784,36,3,23.426,23.316,15,25,6,11,0,0
6.4,14,30,614.29,9,42,82.116,57.0,82,93.039,86,2,53.853,50.264,16,46,12,40,0,0
9.301,13,33,581.79,9,43,81.832,60.0,82,92.76,87,3,53.586,50.723,20,48,10,39,0,0
7.398,3,19,367.87,5,26,44.345,38.0,44,49.551,46,1,30.671,29.337,16,28,7,18,0,0
7.796,1,20,419.81,4,29,44.007,42.0,42,47.783,44,2,29.926,30.159,19,31,9,13,0,0
8.921,11,31,537.73,7,40,74.738,57.0,75,84.72,80,3,49.608,46.955,20,45,9,35,0,0
7.602,0,19,369.8,4,26,40.098,39.0,39,43.689,41,2,28.29,27.865,19,28,7,13,0,0
7.959,1,18,424.3,4,27,40.498,39.5,39,43.553,41,2,29.796,28.88,17,29,9,12,0,0
5.0,16,28,521.74,7,38,76.832,50.0,77,87.76,81,2,48.586,45.723,12,42,10,39,0,0
7.125,5,25,441.53,6,33,56.443,49.0,56,62.857,60,3,38.245,36.993,20,37,8,23,0,0
5.699,2,16,359.87,5,24,38.654,35.5,38,42.641,40,1,27.796,26.47,14,26,8,14,0,0
6.254,4,22,477.5,7,33,53.182,47.5,51,58.008,54,1,35.148,35.002,18,36,11,18,0,0
8.301,3,20,411.33,5,26,45.032,38.0,45,50.366,47,1,31.921,30.04,17,28,6,19,0,0
8.398,2,18,432.73,5,26,41.691,38.0,41,45.978,43,1,30.262,28.835,16,28,8,15,0,0
7.959,3,25,441.53,7,33,56.443,49.0,56,62.857,59,1,38.245,36.993,22,36,8,23,0,0
8.0,3,19,355.4,5,26,44.869,37.5,44,49.784,46,1,29.409,28.806,16,28,7,18,0,0
7.796,2,21,394.89,5,28,47.454,41.0,47,52.678,49,2,32.881,31.557,19,30,7,19,0,0
7.921,5,21,432.92,8,30,53.062,41.5,52,59.057,54,1,34.796,33.709,16,32,9,22,0,0
8.523,1,18,425.84,4,28,41.2,40.5,39,44.288,41,2,28.813,28.819,17,30,10,11,0,0
7.509,2,18,357.82,5,25,41.796,36.5,41,45.974,43,1,28.568,27.724,16,27,7,16,0,0
7.745,2,18,357.82,5,25,41.796,36.5,41,45.974,43,1,28.568,27.724,16,27,7,16,0,0
7.824,2,18,430.98,6,28,43.833,42.5,43,48.059,46,1,32.449,30.679,16,31,10,15,0,0
7.658,8,24,455.56,8,33,60.792,45.5,60,68.572,63,1,38.949,37.625,16,36,9,27,0,0
5.6,8,24,415.54,4,31,56.0,46.0,56,63.062,59,2,37.551,35.805,15,34,7,25,1,1
8.222,2,18,392.26,5,26,42.12,37.5,41,45.918,43,1,29.426,28.551,16,28,8,15,0,0
7.62,6,22,460.4,5,31,54.647,43.5,54,60.95,57,1,37.267,35.46,16,34,9,23,0,0
7.523,2,18,341.37,5,25,41.985,36.5,41,46.369,43,1,27.648,27.28,16,27,7,16,0,0
7.886,2,18,375.81,5,26,42.309,37.5,41,46.313,43,1,28.506,28.107,16,28,8,15,0,0
7.886,3,19,355.4,5,26,44.869,37.5,44,49.784,46,1,29.409,28.806,16,28,7,18,0,0
7.77,6,22,444.93,9,31,54.062,43.5,53,60.057,56,1,35.796,34.709,16,34,9,22,0,0
8.523,5,21,448.39,8,30,53.647,41.5,53,59.95,55,1,36.267,34.46,16,32,9,23,0,0
6.889,5,21,430.37,4,29,50.436,41.5,50,56.326,53,1,35.051,33.218,16,32,8,21,0,0
7.77,7,23,458.96,8,32,56.945,44.5,56,63.472,59,1,37.557,36.236,16,35,9,24,0,0
9.398,15,29,518.73,6,38,75.73,51.0,76,86.261,80,3,48.58,45.702,14,42,9,38,0,0
4.699,8,22,374.48,5,28,50.014,41.0,50,56.149,54,3,33.784,32.256,14,32,6,22,0,0
5.0,10,23,513.71,5,35,62.683,52.0,62,70.108,67,2,42.313,39.936,13,40,12,27,0,0
8.398,7,29,450.63,5,34,63.221,50.5,64,71.6,68,1,43.375,40.649,22,38,5,30,0,0
4.699,6,21,347.45,4,26,46.912,38.5,47,52.651,50,1,31.779,30.235,15,29,5,21,0,0
8.886,10,30,540.68,8,40,72.407,57.0,72,81.225,77,3,47.75,45.836,20,45,10,32,0,0
7.311,5,21,392.48,2,29,50.52,43.0,50,56.861,54,2,33.517,32.441,16,33,8,21,0,0
6.155,7,28,468.6,5,35,62.992,51.5,63,70.604,67,1,42.523,40.552,21,39,7,28,0,0
7.824,8,22,407.52,7,30,55.327,42.0,55,62.272,58,3,36.006,34.519,14,33,8,25,0,0
5.6,2,12,280.68,1,19,29.371,27.5,28,31.439,30,1,19.733,19.837,10,21,7,9,0,0
5.6,8,19,354.51,8,26,51.774,36.0,52,59.351,54,0,33.103,31.111,11,28,7,26,0,0
5.0,4,19,334.41,4,25,43.247,37.5,43,48.318,46,1,29.262,28.203,15,28,6,18,0,0
5.6,0,17,288.33,2,22,34.269,36.0,34,37.863,37,3,24.523,23.908,17,25,5,12,0,0
6.222,4,20,302.4,3,23,40.6,35.5,41,45.528,44,1,28.557,26.972,16,26,3,18,0,0
8.651,8,22,398.53,7,29,56.178,39.5,56,63.734,58,3,36.006,34.22,14,31,7,27,0,0
5.7,4,16,281.34,2,21,36.262,31.5,36,40.405,39,2,24.495,23.655,12,24,5,15,0,0
6.301,4,18,363.37,4,26,43.567,36.5,42,48.254,44,0,27.83,27.858,14,28,8,16,0,0
6.222,1,12,225.28,2,17,28.16,27.0,28,31.737,30,0,19.313,18.687,11,19,5,11,0,0
4.301,2,16,281.34,4,21,36.262,31.5,36,40.405,38,0,24.495,23.655,14,23,5,15,0,0
4.699,2,16,265.34,3,20,34.934,30.5,35,39.196,37,0,24.04,22.94,14,22,4,15,0,0
5.678,3,17,329.81,4,23,39.469,33.5,39,43.764,41,0,27.114,26.009,14,25,6,16,0,0
6.301,3,17,295.37,4,22,39.145,32.5,39,43.82,41,0,26.256,25.181,14,24,5,17,0,0
4.0,5,19,371.43,7,27,48.894,37.5,48,54.279,50,0,31.142,30.379,14,29,8,21,0,0
4.699,4,18,325.4,5,24,43.356,34.5,43,48.445,45,0,28.472,27.423,14,26,6,19,0,0
5.699,4,18,309.4,4,23,42.029,33.5,42,47.235,44,0,28.017,26.708,14,25,5,19,0,0
5.301,4,18,307.38,3,23,40.145,34.5,40,44.82,43,0,27.256,26.181,14,26,5,17,0,0
5.9,0,15,277.31,2,21,32.487,35.0,32,35.947,35,1,22.767,22.402,15,24,6,11,0,0
5.6,1,20,348.38,2,26,42.698,39.0,42,46.741,45,1,29.159,28.59,19,29,6,16,0,0
5.3,6,22,393.48,10,29,52.451,41.5,52,58.485,54,0,34.449,33.191,14,31,7,23,2,1
6.745,4,18,309.4,4,23,42.029,33.5,42,47.235,44,0,28.017,26.708,14,25,5,19,0,0
5.824,3,17,329.81,4,23,39.469,33.5,39,43.764,41,0,27.114,26.009,14,25,6,16,0,0
5.3,5,29,581.11,11,40,67.232,60.0,66,74.017,70,2,46.421,44.664,24,44,11,26,0,0
5.398,4,18,309.4,5,23,42.029,33.5,42,47.235,44,0,28.017,26.708,14,25,5,19,0,0
5.796,4,18,277.4,2,21,39.374,31.5,40,44.817,42,0,27.108,25.279,14,23,3,19,0,0
6.301,9,32,607.76,8,43,76.032,60.5,75,85.077,79,2,50.819,48.776,23,47,11,32,0,0
6.602,3,24,518.46,5,37,56.083,54.5,53,61.559,57,0,36.205,37.357,21,41,13,16,0,0
5.6,0,17,333.33,3,25,37.142,39.5,36,40.365,38,2,25.676,25.832,16,27,8,11,1,1
4.6,0,8,225.05,0,12,17.527,18.0,17,18.878,18,2,13.341,12.836,8,13,4,5,0,0
5.6,5,25,438.53,3,33,55.334,51.5,55,61.73,60,3,38.034,36.772,20,38,8,22,0,0
5.673,9,23,464.66,7,33,61.054,46.5,61,69.268,65,1,40.762,38.341,14,37,10,28,0,0
8.252,5,22,373.5,5,28,50.789,41.0,51,57.438,54,1,34.336,32.563,17,31,6,23,0,0
5.0,4,19,348.39,2,26,42.691,40.5,42,47.113,46,0,28.955,28.391,15,30,7,16,0,0
7.3,9,26,529.63,8,38,69.392,51.0,68,78.324,71,1,43.66,42.578,17,41,12,30,0,0
8.0,4,24,474.59,5,34,56.738,52.5,56,62.86,60,2,39.137,37.674,20,38,10,22,0,0
8.398,10,29,560.74,8,40,72.483,58.5,72,81.145,77,1,48.398,46.023,19,45,11,32,0,0
5.6,0,10,271.13,0,16,21.022,25.0,20,21.844,22,2,17.352,16.653,10,18,6,4,0,0
5.318,2,23,425.56,4,31,50.091,51.0,50,55.899,55,0,36.256,34.498,21,36,8,19,0,0
5.6,3,24,439.59,5,32,52.974,52.0,53,59.315,58,0,38.017,36.024,21,37,8,21,0,0
5.0,7,21,450.38,5,30,52.832,41.5,52,59.081,55,0,35.75,34.128,14,33,9,22,0,0
5.367,5,24,467.97,8,33,56.836,47.5,56,63.346,58,2,38.347,37.015,18,35,9,23,1,1
5.0,2,19,366.83,3,26,41.687,40.5,41,45.847,44,1,29.358,28.504,17,29,7,15,0,0
6.9,0,14,220.24,0,17,25.182,29.0,25,27.452,28,1,18.75,18.338,14,20,3,8,0,0
5.907,1,20,346.84,4,25,40.033,39.5,40,44.428,43,0,29.449,28.074,19,28,5,15,0,0
5.0,8,28,468.6,2,35,62.992,53.0,63,70.604,68,3,42.523,40.552,20,40,7,28,0,0
5.6,8,22,446.95,8,31,55.945,42.5,55,62.472,58,0,36.557,35.236,14,34,9,24,0,0
6.536,7,29,493.67,7,37,67.643,54.0,68,76.68,72,1,45.631,43.186,22,41,8,31,0,0
5.6,6,19,353.44,4,26,46.418,37.5,46,52.362,49,0,30.512,29.42,13,29,7,20,0,0
4.523,6,21,438.49,5,32,55.316,46.5,54,61.358,57,3,35.398,34.917,15,35,11,22,0,0
