pXC50,Si,nBT,Sv,Se,nAT,MW,nH,nSK,nBO,Sp,nC,nCsp3,SCBO,nBM,nO,nAB,N.
6.717,101.427,94,55.69,89.934,90,637.85,43,47,51,58.768,37,13,66.0,24,5,18,5.6
7.31,57.69,56,33.058,51.032,52,355.51,25,27,31,35.597,25,8,40.5,18,1,17,1.9
7.1,41.109,37,21.488,35.92,36,246.35,18,18,19,22.807,13,5,24.0,8,1,6,11.1
5.3,50.066,45,25.762,43.796,44,289.42,23,21,22,27.54,16,8,27.0,8,2,6,6.8
7.328,74.557,69,38.923,65.098,66,421.64,35,31,34,42.108,26,13,41.0,13,2,12,4.5
7.276,57.69,56,33.058,51.032,52,355.51,25,27,31,35.597,25,7,40.5,18,1,17,1.9
5.55,64.943,61,36.444,58.225,58,421.53,27,31,34,38.176,25,7,43.0,18,5,18,1.7
5.699,60.82,57,33.905,54.411,54,415.56,25,29,32,35.858,21,9,41.0,15,4,12,5.6
7.276,76.148,73,43.98,68.28,68,530.7,30,38,43,46.387,29,9,57.0,25,4,22,5.9
7.62,78.275,75,45.2,70.389,70,545.71,31,39,44,47.597,30,10,58.0,25,5,22,4.3
7.26,60.105,58,33.585,52.916,54,357.53,27,27,31,36.358,25,9,39.5,17,1,17,1.9
7.319,58.9,57,33.773,52.36,53,371.51,25,28,32,36.052,25,8,41.5,18,2,17,1.9
5.644,58.607,56,31.509,51.789,52,354.49,26,26,30,33.512,21,12,36.0,11,3,10,3.8
7.23,63.734,60,35.729,56.898,57,405.53,27,30,33,37.722,25,7,42.0,18,4,18,1.8
6.0,69.939,67,40.541,62.454,63,451.6,29,34,38,43.029,30,6,50.0,24,3,24,1.6
6.0,69.939,67,40.541,62.454,63,451.6,29,34,38,43.029,30,6,50.0,24,3,24,1.6
6.0,69.939,67,40.541,62.454,63,451.6,29,34,38,43.029,30,6,50.0,24,3,24,1.6
7.7,70.564,66,38.783,62.665,63,433.59,31,32,35,41.245,27,9,44.0,18,4,18,1.6
7.27,67.149,63,37.256,59.781,60,419.56,29,31,34,39.483,26,8,43.0,18,4,18,1.7
6.35,68.358,64,37.971,61.109,61,435.56,29,32,35,39.938,26,8,44.0,18,5,18,1.6
6.86,68.358,64,37.971,61.109,61,435.56,29,32,35,39.938,26,8,44.0,18,5,18,1.6
6.76,68.358,64,37.971,61.109,61,435.56,29,32,35,39.938,26,8,44.0,18,5,18,1.6
7.33,63.734,60,35.729,56.898,57,405.53,27,30,33,37.722,25,7,42.0,18,4,18,1.8
7.2,59.109,56,33.487,52.687,53,375.5,25,28,31,35.506,24,6,40.0,18,3,18,1.9
7.0,63.444,60,36.201,56.647,57,421.6,27,30,33,38.915,25,7,42.0,18,3,18,1.8
6.6,46.647,43,23.332,40.141,41,245.41,23,18,20,25.631,15,9,23.0,6,0,6,7.3
6.62,62.524,59,35.014,55.571,56,389.53,27,29,32,37.267,25,7,41.0,18,3,18,1.8
6.5,45.385,42,24.348,39.909,40,293.83,20,20,22,26.182,15,8,26.0,7,1,6,7.5
6.93,63.155,60,36.674,56.396,57,437.67,27,30,33,40.108,25,7,42.0,18,2,18,1.8
7.12,68.358,64,37.971,61.109,61,435.56,29,32,35,39.938,26,8,44.0,18,5,18,1.6
7.38,65.939,62,36.541,58.454,59,403.56,29,30,33,39.029,26,8,42.0,18,3,18,1.7
5.3,34.78,33,20.413,31.051,31,239.3,13,18,20,21.279,14,1,28.0,16,1,16,9.7
7.06,46.219,42,24.359,40.472,41,279.84,22,19,20,26.694,16,8,24.0,7,1,6,2.4
7.72,72.196,68,40.154,64.247,64,483.66,30,34,38,42.625,26,11,49.0,19,3,16,4.7
5.3,37.196,35,20.94,32.934,33,241.32,15,18,20,22.04,14,3,26.5,12,1,11,9.1
7.36,74.437,71,41.287,66.054,66,493.69,31,35,40,43.938,26,11,52.0,22,3,20,7.6
4.0,32.575,31,19.601,29.494,29,241.27,11,18,20,19.972,13,1,28.0,16,2,16,10.3
7.03,71.8,68,40.598,64.058,64,500.11,30,34,38,43.546,26,11,49.0,19,3,16,4.7
4.0,36.697,35,21.918,32.833,33,250.32,14,19,21,23.034,16,1,29.5,17,1,17,6.1
4.0,33.91,31,19.315,30.454,30,251.34,13,17,18,20.381,11,2,25.5,13,2,11,10.0
6.027,70.72,66,40.007,63.611,63,505.08,29,34,37,42.449,25,11,47.0,16,5,12,3.2
4.0,36.325,33,19.842,32.338,32,253.36,15,17,18,21.142,11,4,24.0,9,2,6,9.4
8.7,33.906,31,18.412,29.683,30,221.36,15,15,16,20.233,11,4,20.0,7,0,6,10.0
5.3,36.279,34,20.434,32.153,32,242.31,14,18,20,21.284,13,3,26.5,12,1,11,12.5
5.3,45.524,41,24.015,39.803,40,272.39,20,20,21,25.569,15,5,27.5,12,1,11,10.0
5.3,46.73,43,23.827,40.36,41,258.41,22,19,21,25.875,15,8,25.0,7,0,6,9.8
4.0,46.651,42,24.235,40.912,41,275.39,21,20,21,25.779,15,7,26.0,8,2,6,7.3
7.6,31.491,29,17.885,27.8,28,219.34,13,15,16,19.472,11,2,21.5,11,0,11,10.7
8.24,54.113,50,29.39,48.458,48,345.43,23,25,27,30.654,19,7,33.0,12,5,12,2.1
5.0,73.976,67,37.352,64.752,65,417.61,35,30,32,40.017,23,15,37.0,8,4,6,4.6
5.0,75.265,68,37.659,65.527,66,416.63,36,30,32,40.569,23,15,37.0,8,3,6,6.1
6.0,55.405,52,31.145,49.309,49,367.46,22,27,30,32.478,21,6,38.5,17,2,17,6.1
5.274,70.351,64,36.111,61.541,62,399.59,33,29,31,38.802,23,13,37.0,9,3,6,4.8
5.649,70.561,64,35.825,61.869,62,403.58,33,29,31,38.256,22,14,36.0,8,4,6,4.8
8.5,42.9,41,23.773,37.592,38,266.38,18,20,23,25.353,16,5,29.5,12,0,11,10.5
4.8,60.148,54,30.035,52.305,53,338.57,30,23,24,33.228,18,12,29.0,8,2,6,3.8
6.39,90.972,85,51.395,80.956,81,591.77,37,44,48,54.029,35,10,64.0,28,4,24,6.2
7.432,91.81,84,50.254,82.265,81,607.73,37,44,47,51.847,31,13,60.0,19,8,12,6.2
6.631,93.099,87,52.615,83.065,83,606.78,38,45,49,55.239,36,11,65.0,28,5,24,4.8
6.106,29.985,29,18.75,27.284,27,300.59,11,16,18,20.239,12,4,23.0,10,1,10,3.7
6.314,30.349,28,16.537,26.611,27,195.71,14,13,14,18.193,11,5,17.0,6,0,6,3.7
7.824,36.684,35,21.25,32.571,33,265.83,16,17,19,23.603,14,6,24.0,10,0,10,3.0
5.0,69.793,62,36.138,61.81,60,460.53,28,32,34,36.796,21,13,39.0,8,3,6,6.7
7.071,91.81,86,52.309,82.29,82,607.76,37,45,49,54.688,36,11,65.0,28,6,24,3.7
6.12,26.741,24,14.59,23.931,23,195.21,9,14,15,14.46,7,2,19.0,4,2,0,21.7
8.0,88.016,83,47.121,77.847,78,533.73,39,39,44,49.995,31,17,52.0,14,5,12,3.8
8.17,69.438,66,38.562,61.556,62,430.59,30,32,36,41.034,27,9,45.0,18,3,18,3.2
6.76,74.561,70,39.825,65.869,66,451.62,33,33,37,42.256,26,13,44.0,13,4,12,4.5
7.15,74.561,70,39.825,65.869,66,451.62,33,33,37,42.256,26,13,44.0,13,4,12,4.5
6.89,77.976,73,41.352,68.752,69,465.65,35,34,38,44.017,27,14,45.0,13,4,12,4.3
7.29,77.976,73,41.352,68.752,69,465.65,35,34,38,44.017,27,14,45.0,13,4,12,4.3
7.14,81.391,76,42.879,71.636,72,479.68,37,35,39,45.779,28,15,46.0,13,4,12,4.2
7.74,81.391,76,42.879,71.636,72,479.68,37,35,39,45.779,28,15,46.0,13,4,12,4.2
7.07,73.355,69,40.013,65.312,65,465.6,31,34,38,41.949,26,12,46.0,14,5,12,4.6
6.65,73.355,69,40.013,65.312,65,465.6,31,34,38,41.949,26,12,46.0,14,5,12,4.6
7.33,76.77,72,41.54,68.196,68,479.63,33,35,39,43.711,27,13,47.0,14,5,12,4.4
6.88,76.77,72,41.54,68.196,68,479.63,33,35,39,43.711,27,13,47.0,14,5,12,4.4
8.03,88.016,83,47.121,77.847,78,533.73,39,39,44,49.995,31,17,52.0,14,5,12,3.8
6.041,66.521,62,36.057,58.774,59,407.56,29,30,33,38.279,24,10,41.0,14,3,12,5.1
7.187,59.936,54,29.638,51.683,53,301.52,31,22,23,32.881,20,13,27.0,7,1,6,1.9
5.0,68.434,62,34.605,59.76,60,388.57,32,28,30,37.046,21,13,35.0,8,3,6,6.7
4.58,78.683,71,40.088,69.181,69,460.64,36,33,35,42.478,24,15,41.0,9,5,6,5.8
6.381,94.388,88,52.922,83.839,84,605.8,39,45,49,55.79,36,11,65.0,28,4,24,6.0
7.799,91.268,86,52.507,82.272,81,638.74,34,47,52,53.875,34,9,68.5,28,7,23,7.4
9.3,67.069,62,37.443,59.858,60,439.62,29,31,33,40.131,25,7,42.0,18,4,18,1.7
8.16,69.564,64,37.783,61.665,62,421.58,31,31,33,40.245,26,8,42.0,18,4,18,1.6
7.8,68.278,63,38.158,61.185,61,455.62,29,32,34,40.585,25,7,44.0,19,5,18,1.6
9.1,74.189,68,40.024,65.876,66,451.61,33,33,35,42.461,27,9,44.0,18,5,18,1.5
8.3,65.235,60,36.653,58.771,58,438.52,26,32,34,37.875,24,6,45.0,20,6,18,3.4
8.1,62.678,58,35.556,56.222,56,427.96,26,30,32,37.58,24,6,41.0,18,4,18,1.8
8.3,66.149,61,36.256,58.781,59,407.55,29,30,32,38.483,25,7,41.0,18,4,18,1.7
7.9,66.149,61,36.256,58.781,59,407.55,29,30,32,38.483,25,7,41.0,18,4,18,1.7
7.7,62.734,58,34.729,55.898,56,393.52,27,29,31,36.722,24,6,40.0,18,4,18,1.8
7.1,57.997,54,34.142,52.334,52,432.37,23,29,31,36.222,23,5,40.0,18,3,18,1.9
7.0,64.939,60,35.541,57.454,58,391.55,29,29,31,38.029,25,7,40.0,18,3,18,1.7
7.0,60.528,56,33.917,54.342,54,395.49,25,29,31,35.415,23,5,40.0,18,5,18,1.9
7.0,58.109,54,32.487,51.687,52,363.49,25,27,29,34.506,23,5,38.0,18,3,18,1.9
5.68,36.243,34,20.114,31.902,32,230.31,15,17,19,21.279,14,5,24.5,11,0,11,6.3
8.05,40.318,39,22.257,35.272,36,238.36,18,18,21,24.103,16,7,26.5,11,0,11,5.6
7.74,34.488,35,20.204,30.505,31,222.31,14,17,21,21.58,15,6,26.5,11,0,11,6.5
7.78,36.903,36,20.73,32.389,33,224.33,16,17,20,22.341,15,6,25.5,11,0,11,6.1
8.45,40.318,39,22.257,35.272,36,238.36,18,18,21,24.103,16,7,26.5,11,0,11,5.6
6.75,36.903,36,20.73,32.389,33,224.33,16,17,20,22.341,15,6,25.5,11,0,11,6.1
7.4,33.488,33,19.204,29.505,30,210.3,14,16,19,20.58,14,5,24.5,11,0,11,6.7
4.523,66.394,61,36.837,58.665,59,416.57,28,31,33,39.069,25,5,44.0,20,2,18,6.8
5.96,94.723,88,51.857,84.276,84,600.78,40,44,48,54.455,34,13,60.0,21,6,18,4.8
7.48,33.488,33,19.204,29.505,30,210.3,14,16,19,20.58,14,5,24.5,11,0,11,6.7
8.879,30.073,30,17.677,26.622,27,196.27,12,15,18,18.818,13,4,23.5,11,0,11,7.4
6.04,34.697,34,19.918,30.833,31,226.3,14,17,20,21.034,14,5,25.5,11,1,11,6.5
5.75,34.697,34,19.918,30.833,31,226.3,14,17,20,21.034,14,5,25.5,11,1,11,6.5
7.4,38.112,37,21.445,33.716,34,240.33,16,18,21,22.796,15,6,26.5,11,1,11,5.9
7.94,41.528,40,22.972,36.6,37,254.36,18,19,22,24.557,16,7,27.5,11,1,11,5.4
6.5,41.528,40,22.972,36.6,37,254.36,18,19,22,24.557,16,7,27.5,11,1,11,5.4
8.21,33.488,33,19.204,29.505,30,210.3,14,16,19,20.58,14,5,24.5,11,0,11,6.7
7.39,36.903,36,20.73,32.389,33,224.33,16,17,20,22.341,15,6,25.5,11,0,11,6.1
7.3,66.936,62,34.584,58.658,59,385.56,31,28,31,37.04,22,14,36.0,8,3,6,5.1
6.022,68.023,62,37.527,59.952,60,433.58,28,32,34,39.557,25,5,45.0,20,1,18,8.3
5.74,76.774,72,42.988,68.272,68,502.64,31,37,41,44.983,29,9,52.0,20,3,18,5.9
5.0,63.591,58,33.105,56.207,56,396.96,29,27,29,35.347,20,13,33.0,7,4,6,3.6
5.44,83.268,78,46.562,74.298,74,542.69,34,40,44,48.716,31,10,56.0,21,5,18,5.4
6.34,73.019,69,41.078,64.876,65,470.62,30,35,39,43.284,28,8,50.0,20,3,18,6.2
7.27,77.644,73,43.32,69.087,69,500.65,32,37,41,45.5,29,9,52.0,20,4,18,5.8
5.374,58.022,52,29.036,50.672,51,320.48,28,23,24,31.273,18,11,28.0,7,3,6,3.9
7.34,81.059,76,44.847,71.97,72,514.68,34,38,42,47.262,30,10,53.0,20,4,18,5.6
5.042,60.572,55,31.134,53.512,53,366.48,27,26,28,32.665,19,12,32.0,7,4,6,3.8
5.0,66.81,61,35.364,58.549,59,394.57,30,29,31,37.83,23,10,40.0,17,2,16,6.8
8.187,87.644,83,51.266,79.061,78,620.72,32,46,51,52.659,34,9,68.5,28,6,23,7.7
5.451,75.265,68,37.659,65.527,66,416.63,36,30,32,40.569,23,15,37.0,8,3,6,6.1
5.5,61.148,56,31.035,53.305,54,350.58,30,24,26,34.228,19,13,31.0,8,2,6,3.7
6.0,53.903,51,29.675,48.131,48,341.44,23,25,28,31.199,20,8,34.0,12,4,12,2.1
5.62,26.044,24,15.826,23.487,23,230.11,9,14,15,16.779,9,2,19.0,7,0,6,13.0
7.03,53.903,51,29.675,48.131,48,341.44,23,25,28,31.199,20,8,34.0,12,4,12,2.1
5.807,62.449,57,35.362,55.48,55,422.52,24,31,33,36.728,24,4,44.0,20,1,18,7.3
7.33,53.903,51,29.675,48.131,48,341.44,23,25,28,31.199,20,8,34.0,12,4,12,2.1
5.74,53.903,51,29.675,48.131,48,341.44,23,25,28,31.199,20,8,34.0,12,4,12,2.1
4.523,62.373,57,36.452,56.327,55,472.56,22,33,35,37.523,23,3,48.0,22,3,18,7.3
4.523,62.705,57,34.484,55.992,55,437.56,25,30,32,36.04,21,8,41.0,15,3,12,5.5
7.833,81.767,75,43.583,72.4,72,509.67,35,37,40,45.722,27,12,49.5,18,5,17,6.9
6.2,66.936,62,34.584,58.658,59,385.56,31,28,31,37.04,22,14,36.0,8,3,6,5.1
4.523,67.702,60,36.527,60.196,59,467.6,27,32,33,38.051,21,7,43.0,16,3,12,8.5
4.523,60.373,55,34.452,54.327,53,448.54,22,31,33,35.523,21,5,44.5,20,3,17,7.5
8.914,55.278,52,31.158,49.418,49,386.52,22,27,30,32.887,19,7,37.5,13,3,11,8.2
5.022,77.225,72,43.89,68.432,69,492.67,32,37,40,46.591,31,5,54.0,26,2,24,5.8
4.57,62.373,57,36.452,56.327,55,472.56,22,33,35,37.523,23,3,48.0,22,3,18,7.3
5.0,72.023,67,41.527,63.952,64,481.62,28,36,39,43.557,29,3,53.0,26,1,24,7.8
8.432,69.524,66,39.739,62.069,62,476.65,28,34,38,42.171,26,8,48.5,19,3,17,6.5
9.337,53.441,50,29.466,47.56,47,355.44,21,26,29,30.483,18,6,37.0,16,3,16,10.6
4.0,39.112,37,22.445,34.716,35,252.34,16,19,21,23.796,16,3,28.0,13,1,12,5.7
8.804,76.517,72,43.1,67.978,68,497.65,31,37,41,45.29,29,8,53.5,24,3,23,7.4
6.569,54.983,51,30.267,48.578,49,336.47,24,25,27,32.296,21,6,35.5,17,2,17,4.1
5.167,73.81,69,42.364,65.549,66,478.64,30,36,39,44.83,30,4,53.0,26,2,24,6.1
7.2,36.112,34,19.445,31.716,32,216.31,16,16,18,20.796,13,6,22.0,7,1,6,6.3
8.041,69.524,66,39.739,62.069,62,476.65,28,34,38,42.171,26,8,48.5,19,3,17,6.5
8.73,66.109,63,38.212,59.185,59,462.62,26,33,37,40.409,25,7,47.5,19,3,17,6.8
8.376,60.687,57,33.101,53.236,54,361.53,27,27,30,35.608,23,8,38.5,17,1,17,5.6
7.565,57.398,53,30.794,50.461,51,338.49,26,25,27,33.057,21,8,34.0,13,2,12,3.9
6.319,90.901,83,48.699,80.428,80,567.74,39,41,44,51.177,32,15,54.0,16,4,12,3.8
7.056,86.572,79,47.57,77.534,76,584.68,34,42,45,48.807,30,12,56.0,17,6,12,5.3
6.398,89.774,82,48.479,79.319,79,564.74,38,41,44,50.966,32,15,55.0,16,3,12,5.1
7.796,80.031,73,43.823,71.541,70,543.63,31,39,42,44.836,27,10,52.0,16,5,12,7.1
4.0,41.611,39,23.467,36.818,37,267.36,17,20,22,24.801,16,4,29.0,13,1,12,8.1
7.801,69.524,66,39.739,62.069,62,476.65,28,34,38,42.171,26,8,48.5,19,3,17,6.5
8.35,69.524,66,39.739,62.069,62,476.65,28,34,38,42.171,26,8,48.5,19,3,17,6.5
7.0,88.154,80,48.086,78.854,77,600.69,34,43,46,49.057,29,11,57.0,17,6,12,7.8
6.357,87.778,80,47.382,78.09,77,570.7,36,41,44,49.114,30,13,54.0,16,5,12,5.2
8.056,86.861,79,46.876,77.309,76,571.69,35,41,44,48.358,29,12,54.0,16,5,12,6.6
7.77,78.765,72,43.935,70.538,69,562.07,30,39,42,45.239,27,10,52.0,16,4,12,7.2
4.0,37.279,35,21.434,33.153,33,254.32,14,19,21,22.284,14,3,28.0,13,1,12,12.1
7.553,88.395,81,48.727,79.381,78,593.7,35,43,46,50.085,30,12,59.0,19,8,12,6.4
7.9,34.7,33,20.6,31.127,31,259.36,13,18,20,21.926,13,3,26.5,12,1,11,9.7
7.824,78.765,72,43.935,70.538,69,562.07,30,39,42,45.239,27,10,52.0,16,4,12,7.2
6.301,88.501,80,47.419,78.312,77,577.7,36,41,44,49.08,31,15,53.0,15,2,12,3.9
6.143,84.818,77,46.151,75.418,74,569.68,33,41,44,47.392,28,10,55.0,17,4,12,9.5
6.06,92.19,84,49.006,81.203,81,566.76,40,41,44,51.728,32,15,54.0,16,3,12,4.9
7.569,87.268,81,48.507,78.272,77,590.7,34,43,47,49.875,30,12,60.0,21,7,16,7.8
8.3,35.907,34,20.633,32.16,32,242.3,14,18,20,21.489,14,3,26.5,12,2,11,6.3
4.0,36.279,34,20.434,32.153,32,242.31,14,18,20,21.284,13,3,26.5,12,1,11,12.5
7.7,34.7,33,20.6,31.127,31,259.36,13,18,20,21.926,13,3,26.5,12,1,11,9.7
6.886,85.446,78,47.35,76.425,75,581.68,33,42,45,48.597,30,12,57.0,17,5,12,6.7
7.824,91.81,84,50.254,82.265,81,607.73,37,44,47,51.847,31,13,60.0,19,8,12,6.2
4.0,39.032,37,22.632,34.793,35,272.4,16,19,21,24.443,15,4,27.5,12,1,11,5.7
4.0,39.694,37,21.961,35.036,35,256.34,16,19,21,23.046,14,4,27.5,12,1,11,11.4
6.854,88.695,81,47.887,78.872,78,569.71,37,41,44,49.87,31,14,54.0,16,5,12,3.8
8.05,65.125,60,36.68,58.429,57,459.51,24,33,36,37.33,24,8,45.5,18,3,17,5.3
7.301,85.837,79,47.631,76.832,76,583.14,35,41,44,49.79,30,12,55.0,17,6,12,5.3
7.4,75.77,70,40.54,67.196,67,467.62,33,34,37,42.711,26,11,45.5,17,5,17,4.5
4.0,39.322,37,22.16,35.043,35,256.33,16,19,21,23.25,15,4,27.5,12,2,11,5.7
4.69,26.203,23,13.8,23.502,23,169.2,11,12,12,14.176,8,2,15.0,6,3,6,4.3
4.0,38.116,36,22.127,34.011,34,273.39,15,19,21,23.688,14,4,27.5,12,1,11,8.8
8.4,35.617,34,21.106,31.909,32,258.37,14,18,20,22.682,14,3,26.5,12,1,11,6.3
7.569,92.391,86,51.825,82.61,82,611.76,37,45,49,53.938,34,11,64.0,24,6,18,6.1
6.2,37.279,35,21.434,33.153,33,254.32,14,19,21,22.284,14,3,28.0,13,1,12,12.1
7.91,57.485,54,32.191,51.451,51,381.47,23,28,31,33.449,21,7,40.0,17,4,16,5.9
6.509,89.774,82,48.479,79.319,79,564.74,38,41,44,50.966,32,15,55.0,16,3,12,5.1
6.495,91.486,85,51.172,81.545,81,601.75,37,44,48,53.415,35,12,61.0,22,4,18,3.7
6.66,74.481,69,40.234,66.421,66,468.6,32,34,37,42.159,26,11,45.5,17,6,17,3.0
6.564,87.861,80,47.876,78.309,77,583.7,35,42,45,49.358,30,12,56.0,17,5,12,6.5
7.523,85.786,78,47.733,76.938,75,599.67,32,43,46,48.534,30,12,58.0,17,5,12,6.7
5.979,86.572,79,47.57,77.534,76,584.68,34,42,45,48.807,30,12,56.0,17,6,12,5.3
4.0,38.196,36,21.94,33.934,34,253.33,15,19,21,23.04,15,3,28.0,13,1,12,8.8
6.602,84.363,77,45.855,75.207,74,556.67,34,40,43,47.353,29,12,53.0,16,5,12,5.4
7.444,90.569,84,50.667,80.763,80,602.74,36,44,48,52.66,34,11,61.0,22,4,18,5.0
6.31,85.15,78,46.237,75.108,75,534.71,36,39,42,48.751,31,14,53.0,16,2,12,5.3
6.886,88.493,80,48.469,79.367,77,618.68,33,44,47,48.995,29,11,58.0,17,6,12,7.8
5.886,84.446,77,46.35,75.425,74,569.67,33,41,44,47.597,29,11,55.0,17,5,12,6.8
6.137,85.786,78,47.733,76.938,75,599.67,32,43,46,48.534,30,12,58.0,17,5,12,6.7
6.398,81.948,76,45.328,73.323,72,554.65,32,40,44,46.591,29,12,54.0,16,5,12,5.6
6.319,88.565,81,47.764,77.992,78,548.74,38,40,43,50.512,32,15,54.0,16,2,12,5.1
7.824,79.904,73,44.603,71.432,70,552.64,30,40,43,45.625,28,10,55.0,17,4,12,8.6
5.796,84.98,78,47.201,76.498,75,579.67,33,42,45,48.324,29,11,58.0,19,8,12,6.7
6.357,87.486,80,47.172,77.545,77,553.71,37,40,43,49.415,31,14,53.0,16,4,12,3.9
6.469,80.821,74,45.108,72.214,71,551.65,31,40,43,46.381,29,11,55.0,17,4,12,7.0
7.0,89.684,82,49.034,80.156,79,592.72,36,43,46,50.637,30,12,59.0,19,7,12,7.6
7.602,85.655,78,47.064,76.752,75,585.67,33,42,45,48.051,29,11,56.0,17,6,12,6.7
6.387,88.774,81,47.479,78.319,78,552.73,38,40,43,49.966,31,14,53.0,16,3,12,5.1
6.796,83.529,76,45.844,74.643,73,570.66,32,41,44,46.841,28,10,55.0,17,5,12,8.2
6.602,101.728,94,54.85,89.425,90,613.86,45,45,49,58.552,38,16,61.0,21,2,18,3.3
8.076,78.765,72,43.935,70.538,69,562.07,30,39,42,45.239,27,10,52.0,16,4,12,7.2
7.444,79.738,73,43.613,70.996,70,526.64,32,38,41,45.137,28,11,51.0,16,4,12,5.7
7.367,83.256,75,45.785,74.636,72,595.63,30,42,45,45.955,28,11,55.0,16,4,12,6.9
7.31,84.738,77,46.559,75.97,74,586.66,32,42,45,47.296,28,11,57.0,18,6,12,8.1
5.504,95.952,88,52.721,86.141,84,658.74,37,47,51,53.722,33,15,62.0,17,7,12,4.8
7.0,86.268,79,47.507,77.272,76,578.69,34,42,45,48.875,29,11,58.0,19,7,12,7.9
5.55,80.742,75,45.516,72.767,71,568.63,30,41,45,46.284,29,11,56.0,17,6,12,5.6
6.77,82.32,75,45.129,73.316,72,554.66,32,40,43,46.387,28,10,54.0,17,4,12,8.3
7.174,87.774,80,46.479,77.319,77,540.72,38,39,42,48.966,30,14,51.0,15,3,12,5.2
7.108,86.233,79,47.186,77.021,76,566.69,35,41,44,48.87,30,12,55.0,17,6,12,5.3
6.066,104.229,96,56.774,92.297,92,658.86,44,48,52,59.705,38,15,65.0,22,4,18,4.3
7.0,94.897,88,51.796,83.657,84,585.8,41,43,47,55.029,36,14,59.0,21,2,18,3.6
6.857,93.099,85,50.561,83.04,82,606.75,38,44,47,52.398,31,13,60.0,19,7,12,7.3
6.292,86.861,79,46.876,77.309,76,571.69,35,41,44,48.358,29,12,54.0,16,5,12,6.6
6.854,88.691,81,46.984,78.101,78,539.73,39,39,42,49.722,31,15,51.0,15,3,12,3.8
8.13,65.125,60,36.68,58.429,57,459.51,24,33,36,37.33,24,8,45.5,18,3,17,5.3
6.53,56.196,53,31.885,50.676,50,382.45,22,28,31,32.898,21,7,40.0,17,5,16,4.0
7.638,81.323,74,45.032,73.087,71,572.63,30,41,44,45.534,27,10,56.0,18,6,12,8.5
7.097,97.399,90,53.721,86.53,86,630.8,40,46,50,56.182,36,13,63.0,22,4,18,4.7
6.569,83.153,76,45.14,73.879,73,540.67,34,39,42,46.898,29,12,52.0,16,4,12,5.5
7.319,85.837,79,47.631,76.832,76,583.14,35,41,44,49.79,30,12,55.0,17,6,12,5.3
7.745,83.446,76,45.35,74.425,73,557.66,33,40,43,46.597,28,11,53.0,16,5,12,6.8
5.928,90.308,83,49.33,80.392,80,574.74,38,42,45,51.694,32,13,58.0,19,6,12,5.0
4.403,85.391,77,44.825,75.61,75,527.69,37,38,40,46.938,27,14,50.0,13,6,6,6.7
5.308,92.806,85,50.351,82.494,82,589.76,39,43,46,52.699,32,13,59.0,19,6,12,6.1
6.143,91.225,85,49.835,81.174,81,573.75,39,42,46,52.449,33,14,57.0,17,6,12,3.7
5.1,59.97,54,32.766,53.767,53,408.92,25,28,29,34.279,20,8,36.0,10,5,6,3.8
5.467,93.723,87,50.857,83.276,83,588.77,40,43,47,53.455,33,14,58.0,17,6,12,4.8
6.99,51.768,48,29.457,46.312,46,361.87,21,25,27,31.086,20,7,34.0,13,2,12,2.2
4.613,94.095,86,50.658,83.269,83,588.78,40,43,46,53.25,32,13,59.0,19,5,12,7.2
4.403,71.727,65,37.815,63.305,63,441.59,31,32,34,39.745,23,11,43.0,12,4,6,7.9
5.724,83.767,77,45.583,74.4,74,533.69,35,39,42,47.722,29,11,54.0,18,5,12,6.8
4.538,88.102,81,48.518,78.836,78,576.71,36,42,45,50.387,31,12,58.0,19,7,12,5.1
6.284,96.016,88,53.066,85.821,85,629.78,39,46,49,55.154,34,14,64.0,20,7,12,5.9
5.565,92.806,85,50.351,82.494,82,589.76,39,43,46,52.699,32,13,59.0,19,6,12,6.1
5.3,39.694,37,21.961,35.036,35,256.34,16,19,21,23.046,14,4,27.5,12,1,11,11.4
8.2,37.196,35,20.94,32.934,33,241.32,15,18,20,22.04,14,3,26.5,12,1,11,9.1
8.551,58.607,56,31.509,51.789,52,354.49,26,26,30,33.512,21,12,36.0,11,3,10,3.8
6.95,40.321,38,22.939,35.567,36,271.42,17,19,21,24.995,15,4,27.5,12,0,11,8.3
7.33,40.611,38,22.467,35.818,36,255.35,17,19,21,23.801,15,4,27.5,12,1,11,8.3
4.0,39.694,37,21.961,35.036,35,256.34,16,19,21,23.046,14,4,27.5,12,1,11,11.4
4.0,42.9,40,23.773,37.592,38,266.38,18,20,22,25.353,16,4,29.0,13,0,12,10.5
5.7,50.463,47,30.187,45.774,45,505.26,19,26,28,32.586,17,5,36.0,14,3,12,6.7
7.52,39.484,37,22.246,34.709,35,252.35,16,19,21,23.591,15,3,28.0,13,0,12,11.4
4.0,36.279,34,20.434,32.153,32,242.31,14,18,20,21.284,13,3,26.5,12,1,11,12.5
8.79,36.279,34,20.434,32.153,32,242.31,14,18,20,21.284,13,3,26.5,12,1,11,12.5
8.43,36.279,34,20.434,32.153,32,242.31,14,18,20,21.284,13,3,26.5,12,1,11,12.5
7.11,38.568,36,21.741,33.927,34,253.34,15,19,21,22.836,14,3,28.0,13,0,12,14.7
5.3,41.066,38,22.762,36.029,36,268.36,16,20,22,23.841,14,3,29.0,13,0,12,16.7
4.0,44.524,40,23.015,38.803,39,260.38,20,19,20,24.569,14,6,25.0,8,1,6,10.3
5.4,50.612,47,30.619,46.287,45,450.8,18,27,29,32.455,17,5,37.0,14,3,12,6.7
5.3,73.322,68,40.374,65.356,65,486.66,31,34,37,42.836,26,11,47.0,16,4,12,3.1
8.719,66.776,60,35.179,59.287,59,422.6,30,29,30,37.591,21,9,38.0,14,5,12,3.4
8.68,70.776,65,39.179,63.287,63,470.64,30,33,35,41.591,25,7,46.0,20,5,18,3.2
8.26,64.38,57,34.802,57.941,56,462.54,25,31,32,35.642,20,8,40.0,14,5,12,3.6
7.17,60.946,56,33.126,54.52,54,406.55,26,28,30,35.068,20,8,38.0,14,5,12,3.7
7.5,60.946,56,33.126,54.52,54,406.55,26,28,30,35.068,20,8,38.0,14,5,12,3.7
5.0,75.976,70,39.352,66.752,67,441.63,35,32,35,42.017,25,15,42.0,12,4,10,4.5
5.0,72.561,67,37.825,63.869,64,427.6,33,31,34,40.256,24,14,41.0,12,4,10,4.7
5.0,23.426,22,17.05,22.073,21,246.25,4,17,18,17.057,12,0,27.5,13,0,11,9.5
4.0,46.896,43,24.816,40.796,41,284.41,20,21,23,26.364,15,6,29.5,12,0,11,14.6
4.0,44.398,41,23.795,38.694,39,269.39,19,20,22,25.358,15,5,28.5,12,0,11,12.8
8.3,36.651,34,20.236,32.145,32,242.32,14,18,20,21.08,12,3,26.5,12,0,11,18.8
4.0,41.9,39,22.773,36.592,37,254.37,18,19,21,24.353,15,4,27.5,12,0,11,10.8
9.27,57.697,54,32.367,51.596,51,421.6,23,28,31,34.54,18,9,37.5,12,3,11,9.8
7.5,103.49,97,55.932,90.825,92,627.34,47,45,50,60.54,38,18,61.0,20,2,18,4.3
5.3,40.066,37,21.762,35.029,35,256.35,16,19,21,22.841,13,4,27.5,12,0,11,17.1
6.7,49.385,46,28.348,43.909,44,341.87,20,24,26,30.182,19,5,34.0,14,1,12,6.8
6.5,52.8,49,29.875,46.792,47,355.9,22,25,27,31.944,20,6,35.0,14,1,12,6.4
7.9,53.8,51,30.875,47.792,48,367.91,22,26,29,32.944,21,7,37.0,14,1,12,6.3
6.8,58.481,55,32.289,51.68,52,363.5,25,27,30,34.302,22,8,38.0,14,2,12,5.8
6.4,55.066,52,30.762,48.796,49,349.47,23,26,29,32.54,21,7,37.0,14,2,12,6.1
5.7,61.896,58,33.815,54.563,55,377.53,27,28,31,36.063,23,9,39.0,14,2,12,5.5
7.1,54.196,51,30.43,47.981,48,351.46,22,26,29,32.023,21,7,37.0,14,1,12,6.3
7.8,57.272,54,31.574,50.352,51,347.5,25,26,29,33.847,22,8,37.0,14,1,12,5.9
5.7,67.517,63,36.154,59.003,60,389.59,31,29,32,39.131,25,11,40.0,14,1,12,5.0
5.7,60.69,57,34.003,54.007,54,391.51,25,29,32,35.756,23,8,41.0,15,3,12,5.6
5.7,57.275,54,32.477,51.123,51,377.48,23,28,31,33.995,22,7,40.0,15,3,12,5.9
6.4,54.196,51,30.43,47.981,48,351.46,22,26,29,32.023,21,7,37.0,14,1,12,6.3
6.2,53.8,51,30.875,47.792,48,367.91,22,26,29,32.944,21,7,37.0,14,1,12,6.3
5.7,58.481,55,32.289,51.68,52,363.5,25,27,30,34.302,22,8,38.0,14,2,12,5.8
6.3,57.272,54,31.574,50.352,51,347.5,25,26,29,33.847,22,8,37.0,14,1,12,5.9
6.5,54.536,51,30.814,48.494,48,369.45,21,27,30,31.961,21,7,38.0,14,1,12,6.3
5.7,63.106,59,34.53,55.891,56,393.53,27,29,32,36.517,23,9,40.0,14,3,12,5.4
5.7,61.102,57,31.627,53.12,54,339.53,29,25,28,34.37,21,13,33.0,8,1,6,5.6
6.7,57.272,54,31.574,50.352,51,347.5,25,26,29,33.847,22,8,37.0,14,1,12,5.9
6.0,56.687,52,29.101,49.236,50,313.49,27,23,25,31.608,19,11,30.0,8,1,6,6.0
7.7,53.8,51,30.875,47.792,48,367.91,22,26,29,32.944,21,7,37.0,14,1,12,6.3
7.1,53.8,51,30.875,47.792,48,367.91,22,26,29,32.944,21,7,37.0,14,1,12,6.3
8.2,53.8,51,30.875,47.792,48,367.91,22,26,29,32.944,21,7,37.0,14,1,12,6.3
6.5,57.216,54,32.401,50.676,51,381.94,24,27,30,34.705,22,8,38.0,14,1,12,5.9
6.8,57.216,54,32.401,50.676,51,381.94,24,27,30,34.705,22,8,38.0,14,1,12,5.9
6.9,100.075,94,54.405,87.941,89,613.31,45,44,49,58.779,37,17,60.0,20,2,18,4.5
7.1,106.906,100,57.459,93.708,95,641.37,49,46,51,62.302,39,19,62.0,20,2,18,4.2
7.0,110.321,103,58.986,96.592,98,655.4,51,47,52,64.063,40,20,63.0,20,2,18,4.1
6.5,99.075,92,53.405,86.941,88,601.3,45,43,47,57.779,36,16,58.0,20,2,18,4.5
5.7,102.49,95,54.932,89.825,91,615.33,47,44,48,59.54,37,17,59.0,20,2,18,4.4
7.5,106.906,100,57.459,93.708,95,641.37,49,46,51,62.302,39,19,62.0,20,2,18,4.2
7.3,111.586,104,58.873,97.596,99,636.96,52,47,52,63.66,40,20,63.0,20,3,18,4.0
6.9,108.171,101,57.346,94.712,96,622.93,50,46,51,61.898,39,19,62.0,20,3,18,4.2
7.3,110.321,103,58.986,96.592,98,655.4,51,47,52,64.063,40,20,63.0,20,2,18,4.1
7.4,106.906,100,57.459,93.708,95,641.37,49,46,51,62.302,39,19,62.0,20,2,18,4.2
6.733,70.53,70,40.68,62.618,63,568.5,29,34,41,44.489,27,15,48.0,13,2,12,6.3
7.602,67.115,67,39.154,59.734,60,554.47,27,33,40,42.728,26,14,47.0,13,2,12,6.7
4.0,44.5,40,24.439,39.451,38,324.35,15,23,25,24.415,14,5,31.5,12,0,11,15.8
6.5,46.896,43,24.816,40.796,41,284.41,20,21,23,26.364,15,6,29.5,12,0,11,14.6
5.3,43.481,40,23.289,37.912,38,270.38,18,20,22,24.603,14,5,28.5,12,0,11,15.8
4.0,40.983,38,22.268,35.811,36,255.36,17,19,21,23.597,14,4,27.5,12,0,11,13.9
7.3,40.983,38,22.268,35.811,36,255.36,17,19,21,23.597,14,4,27.5,12,0,11,13.9
9.51,61.112,57,33.894,54.48,54,435.63,25,29,32,36.301,19,10,38.5,12,3,11,9.3
6.0,67.563,63,35.561,59.189,60,400.64,32,28,31,38.989,23,13,38.5,13,2,11,3.3
8.9,71.357,66,38.474,63.131,63,477.72,31,32,35,41.586,22,13,41.5,12,3,11,7.9
5.721,89.861,83,49.876,80.309,79,607.72,35,44,48,51.358,32,14,60.0,17,5,12,6.3
5.13,66.521,62,36.057,58.774,59,407.56,29,30,33,38.279,24,10,41.0,14,3,12,5.1
5.65,61.84,58,34.643,54.887,55,411.97,26,29,32,36.921,23,9,40.0,14,2,12,5.5
6.95,69.936,65,37.584,61.658,62,421.59,31,31,34,40.04,25,11,42.0,14,3,12,4.8
6.95,65.255,61,36.17,57.771,58,426.0,28,30,33,38.682,24,10,41.0,14,2,12,5.2
6.48,69.88,65,38.411,61.981,62,456.03,30,32,35,40.898,25,11,43.0,14,3,12,4.8
7.62,73.351,68,39.111,64.541,65,435.62,33,32,35,41.802,26,12,43.0,14,3,12,4.6
7.52,68.671,64,37.696,60.654,61,440.03,30,31,34,40.444,25,11,42.0,14,2,12,4.9
6.97,73.295,68,39.938,64.865,65,470.06,32,33,36,42.659,26,12,44.0,14,3,12,4.6
7.01,76.766,71,40.637,67.425,68,449.65,35,33,36,43.563,27,13,44.0,14,3,12,4.4
6.95,66.465,62,36.884,59.098,59,442.0,28,31,34,39.137,24,10,42.0,14,3,12,5.1
5.0,61.784,58,35.47,55.211,55,446.41,25,30,33,37.779,23,9,41.0,14,2,12,5.5
6.9,69.88,65,38.411,61.981,62,456.03,30,32,35,40.898,25,11,43.0,14,3,12,4.8
6.87,65.199,61,36.997,58.094,58,460.44,27,31,34,39.54,24,10,42.0,14,2,12,5.2
6.61,73.295,68,39.938,64.865,65,470.06,32,33,36,42.659,26,12,44.0,14,3,12,4.6
6.89,72.438,67,39.508,64.531,64,466.59,30,34,37,41.193,25,11,47.0,16,5,12,6.3
6.68,75.853,70,41.035,67.414,67,480.62,32,35,38,42.955,26,12,48.0,16,5,12,6.0
6.89,73.351,68,39.111,64.541,65,435.62,33,32,35,41.802,26,12,43.0,14,3,12,4.6
6.71,73.295,68,39.938,64.865,65,470.06,32,33,36,42.659,26,12,44.0,14,3,12,4.6
7.25,76.766,71,40.637,67.425,68,449.65,35,33,36,43.563,27,13,44.0,14,3,12,4.4
6.82,76.71,71,41.465,67.749,68,484.09,34,34,37,44.421,27,13,45.0,14,3,12,4.4
5.3,70.936,67,38.584,62.658,63,433.6,31,32,36,41.04,26,12,44.0,14,3,12,4.8
6.63,74.351,70,40.111,65.541,66,447.63,33,33,37,42.802,27,13,45.0,14,3,12,4.5
7.42,77.766,73,41.637,68.425,69,461.66,35,34,38,44.563,28,14,46.0,14,3,12,4.3
9.17,63.066,60,36.707,56.771,56,445.52,23,33,37,37.699,24,6,48.5,20,4,17,8.9
6.458,96.803,90,53.449,85.723,86,607.82,41,45,49,56.552,36,12,64.0,24,4,18,5.8
5.0,72.4,69,40.254,64.047,65,467.75,33,32,36,44.392,27,14,43.0,13,2,12,1.5
7.4,40.066,37,21.762,35.029,35,256.35,16,19,21,22.841,13,4,27.5,12,0,11,17.1
6.49,107.341,99,58.238,94.919,95,666.9,46,49,53,61.535,38,14,68.0,24,5,18,6.3
7.4,40.983,38,22.268,35.811,36,255.36,17,19,21,23.597,14,4,27.5,12,0,11,13.9
4.0,47.813,44,25.321,41.578,42,283.42,21,21,23,27.12,16,6,29.5,12,0,11,11.9
6.7,50.311,46,26.343,43.68,44,298.44,22,22,24,28.125,16,7,30.5,12,0,11,13.6
6.5,84.348,80,49.208,74.77,76,537.75,35,41,45,52.654,37,5,62.0,32,1,30,3.9
6.7,87.178,81,48.261,76.538,78,517.77,39,39,42,52.177,35,8,56.0,26,1,24,3.8
6.754,74.565,73,41.274,65.945,66,474.63,31,35,42,43.529,28,16,49.0,13,2,12,6.1
6.959,81.81,76,42.854,71.596,72,480.69,37,35,39,45.813,28,16,46.0,13,2,12,5.6
7.42,78.395,73,41.327,68.712,69,466.66,35,34,38,44.052,27,15,45.0,13,2,12,5.8
6.5,93.424,86,48.842,81.188,83,511.82,45,38,41,53.461,34,15,51.0,19,1,18,3.6
5.854,62.991,58,33.109,55.472,55,391.51,27,28,31,34.699,21,13,36.0,8,2,6,5.5
6.42,63.33,58,33.492,55.985,55,409.5,26,29,32,34.637,21,13,37.0,8,2,6,5.5
7.556,64.185,58,33.068,56.312,56,388.53,28,28,30,34.773,19,10,36.5,12,3,11,10.7
8.17,69.438,66,38.562,61.556,62,430.59,30,32,36,41.034,27,9,45.0,18,3,18,3.2
6.91,61.315,58,34.299,54.243,55,373.53,27,28,31,36.813,25,7,40.0,18,2,18,1.8
7.4,65.939,62,36.541,58.454,59,403.56,29,30,33,39.029,26,8,42.0,18,3,18,1.7
8.05,71.643,68,39.374,63.112,64,428.62,32,32,36,42.341,28,10,45.0,18,2,18,3.1
6.0,62.315,59,35.299,55.243,56,385.54,27,29,32,37.813,26,7,42.0,19,2,18,1.8
6.0,66.939,63,37.541,59.454,60,415.57,29,31,34,40.029,27,8,44.0,19,3,18,1.7
6.85,72.643,69,40.374,64.112,65,440.63,32,33,37,43.341,29,10,47.0,19,2,18,3.1
6.0,64.73,61,35.826,57.127,58,387.56,29,29,32,38.574,26,8,41.0,18,2,18,1.7
6.54,64.73,61,35.826,57.127,58,387.56,29,29,32,38.574,26,8,41.0,18,2,18,1.7
7.13,69.355,65,38.068,61.338,62,417.59,31,31,34,40.79,27,9,43.0,18,3,18,1.6
6.78,75.059,71,40.901,65.996,67,442.65,34,33,37,44.103,29,11,46.0,18,2,18,3.0
6.61,75.059,71,40.901,65.996,67,442.65,34,33,37,44.103,29,11,46.0,18,2,18,3.0
8.378,81.85,75,44.078,72.618,72,522.67,34,38,41,45.966,27,11,51.5,19,5,17,8.3
6.074,44.109,41,24.488,38.92,39,282.38,18,21,23,25.807,16,3,30.0,13,1,12,10.3
9.4,69.86,64,38.895,62.982,62,468.55,28,34,36,40.091,25,7,47.0,20,7,18,3.2
9.1,69.86,64,38.895,62.982,62,468.55,28,34,36,40.091,25,7,47.0,20,7,18,3.2
8.476,74.019,68,40.024,65.851,65,482.6,30,35,38,41.443,24,10,48.0,18,5,16,9.2
8.2,71.983,66,39.212,64.32,64,453.58,31,33,35,41.154,26,8,44.0,18,6,18,1.6
9.8,67.302,62,37.798,60.432,60,457.99,28,32,34,39.796,25,7,43.0,18,5,18,1.7
9.6,70.773,65,38.497,62.992,63,437.58,31,32,34,40.699,26,8,43.0,18,5,18,1.6
9.39,55.651,52,31.181,49.887,49,383.45,21,28,31,31.938,19,6,40.0,17,4,16,10.2
8.6,69.86,64,38.895,62.982,62,468.55,28,34,36,40.091,25,7,47.0,20,7,18,3.2
9.6,70.773,65,38.497,62.992,63,437.58,31,32,34,40.699,26,8,43.0,18,5,18,1.6
9.0,67.302,62,37.798,60.432,60,457.99,28,32,34,39.796,25,7,43.0,18,5,18,1.7
9.4,71.983,66,39.212,64.32,64,453.58,31,33,35,41.154,26,8,44.0,18,6,18,1.6
9.25,67.302,62,37.798,60.432,60,457.99,28,32,34,39.796,25,7,43.0,18,5,18,1.7
5.0,39.235,41,20.763,34.054,35,213.35,19,16,22,22.858,15,15,22.0,0,0,0,2.9
5.0,55.986,53,32.17,50.349,50,378.46,22,28,31,33.443,22,7,42.0,19,4,16,4.0
7.37,59.598,56,33.51,53.08,53,401.94,25,28,31,35.608,23,10,38.0,13,2,12,1.9
7.125,70.955,65,38.734,63.196,62,475.56,28,34,37,39.853,25,11,45.0,14,3,12,4.8
6.479,56.398,52,29.794,49.461,50,326.48,26,24,26,32.057,20,9,32.0,12,2,12,4.0
7.275,62.102,58,32.627,54.12,55,351.54,29,26,29,35.37,22,11,35.0,12,1,12,5.5
7.364,67.643,63,35.374,59.112,60,380.58,32,28,31,38.341,24,12,37.0,12,2,12,3.3
7.9,65.125,60,36.68,58.429,57,459.51,24,33,36,37.33,24,8,45.5,18,3,17,5.3
7.319,70.955,65,38.734,63.196,62,475.56,28,34,37,39.853,25,11,45.0,14,3,12,4.8
8.788,57.195,55,32.664,51.2,51,397.54,23,28,32,34.642,21,9,39.5,13,3,11,5.9
6.26,60.318,57,34.202,54.014,54,391.5,25,29,32,35.961,24,6,41.0,18,4,18,1.9
7.21,60.318,57,34.202,54.014,54,391.5,25,29,32,35.961,24,6,41.0,18,4,18,1.9
6.8,52.883,50,30.369,47.011,47,368.9,21,26,29,32.188,20,7,37.0,14,1,12,8.5
8.0,60.923,57,34.138,54.105,54,412.96,25,29,32,36.165,22,9,40.0,14,2,12,7.4
7.8,64.046,60,35.455,56.443,57,410.0,28,29,32,38.228,24,10,40.0,14,1,12,5.3
7.9,61.84,58,34.643,54.887,55,411.97,26,29,32,36.921,23,9,40.0,14,2,12,5.5
6.9,52.883,50,30.369,47.011,47,368.9,21,26,29,32.188,20,7,37.0,14,1,12,8.5
7.6,52.883,50,30.369,47.011,47,368.9,21,26,29,32.188,20,7,37.0,14,1,12,8.5
8.1,63.129,59,34.949,55.661,56,410.99,27,29,32,37.472,23,10,40.0,14,1,12,7.1
7.0,63.129,59,34.949,55.661,56,410.99,27,29,32,37.472,23,10,40.0,14,1,12,7.1
6.5,60.923,57,34.138,54.105,54,412.96,25,29,32,36.165,22,9,40.0,14,2,12,7.4
7.3,52.883,50,30.369,47.011,47,368.9,21,26,29,32.188,20,7,37.0,14,1,12,8.5
7.7,63.129,59,34.949,55.661,56,410.99,27,29,32,37.472,23,10,40.0,14,1,12,7.1
7.4,60.923,57,34.138,54.105,54,412.96,25,29,32,36.165,22,9,40.0,14,2,12,7.4
6.6,51.967,49,29.864,46.229,46,369.89,20,26,29,31.432,19,7,37.0,14,1,12,10.9
7.4,105.989,99,56.954,92.927,94,642.36,48,46,51,61.546,38,19,62.0,20,2,18,5.3
7.96,60.318,57,34.202,54.014,54,391.5,25,29,32,35.961,24,6,41.0,18,4,18,1.9
6.73,60.318,57,34.202,54.014,54,391.5,25,29,32,35.961,24,6,41.0,18,4,18,1.9
6.82,60.318,57,34.202,54.014,54,391.5,25,29,32,35.961,24,6,41.0,18,4,18,1.9
7.14,54.113,50,29.39,48.458,48,345.43,23,25,27,30.654,19,7,33.0,12,5,12,2.1
7.75,60.318,57,34.202,54.014,54,391.5,25,29,32,35.961,24,6,41.0,18,4,18,1.9
6.05,60.528,57,33.917,54.342,54,395.49,25,29,32,35.415,23,7,40.5,17,5,17,1.9
7.51,55.322,51,30.105,49.785,49,361.43,23,26,28,31.108,19,7,34.0,12,6,12,2.0
6.4,55.322,51,30.105,49.785,49,361.43,23,26,28,31.108,19,7,34.0,12,6,12,2.0
8.561,58.737,54,31.632,52.669,52,375.46,25,27,29,32.87,20,8,35.0,12,6,12,1.9
7.1,58.737,54,31.632,52.669,52,375.46,25,27,29,32.87,20,8,35.0,12,6,12,1.9
8.66,54.057,50,30.218,48.782,48,379.87,22,26,28,31.512,19,7,34.0,12,5,12,2.1
7.47,54.057,50,30.218,48.782,48,379.87,22,26,28,31.512,19,7,34.0,12,5,12,2.1
8.62,54.452,50,29.774,48.971,48,363.42,22,26,28,30.591,19,7,34.0,12,5,12,2.1
6.99,54.452,50,29.774,48.971,48,363.42,22,26,28,30.591,19,7,34.0,12,5,12,2.1
6.35,58.737,54,31.632,52.669,52,375.46,25,27,29,32.87,20,8,35.0,12,6,12,1.9
6.19,58.737,54,31.632,52.669,52,375.46,25,27,29,32.87,20,8,35.0,12,6,12,1.9
8.24,54.113,50,29.39,48.458,48,345.43,23,25,27,30.654,19,7,33.0,12,5,12,2.1
6.4,65.358,61,34.971,58.109,58,399.53,29,29,32,36.938,23,11,38.0,12,5,12,1.7
5.978,69.015,64,36.176,60.105,61,392.6,32,29,32,39.137,24,12,39.0,13,1,12,6.6
6.529,67.517,63,36.154,59.003,60,389.59,31,29,32,39.131,25,11,40.0,14,1,12,5.0
7.31,60.734,57,32.729,53.898,54,369.5,27,27,30,34.722,22,10,36.0,12,4,12,1.9
7.8,55.903,53,31.675,50.131,50,365.46,23,27,30,33.199,22,6,38.5,17,4,17,2.0
6.02,62.97,59,35.545,56.291,56,448.03,26,30,33,38.023,22,8,43.0,18,3,16,5.4
5.421,62.053,58,35.039,55.509,55,449.02,25,30,33,37.267,21,8,43.0,18,3,16,7.3
6.24,65.358,61,34.971,58.109,58,399.53,29,29,32,36.938,23,11,38.0,12,5,12,1.7
6.26,67.149,64,37.256,59.781,60,419.56,29,31,35,39.483,26,10,43.5,17,4,17,1.7
4.72,56.957,55,35.098,51.738,51,475.43,20,31,35,37.148,22,6,45.0,18,2,16,7.8
6.22,65.366,62,37.986,58.531,58,486.44,25,33,37,40.029,24,8,47.0,18,2,16,8.6
7.76,63.899,61,36.497,56.858,57,434.61,26,31,35,38.955,24,8,45.0,18,2,16,7.0
5.745,50.65,48,28.014,44.436,45,326.51,22,23,26,30.523,18,7,32.5,12,0,11,8.9
8.35,65.422,62,37.159,58.207,58,452.0,26,32,36,39.171,24,8,46.5,21,2,21,8.6
5.0,51.484,52,28.246,45.476,46,309.44,23,23,29,30.29,20,14,32.0,6,2,6,2.2
6.271,48.069,49,26.719,42.592,43,295.41,21,22,28,28.529,19,13,31.0,6,2,6,2.3
5.558,52.694,53,28.961,46.803,47,325.44,23,24,30,30.745,20,14,33.0,6,3,6,2.1
5.457,51.484,52,28.246,45.476,46,309.44,23,23,29,30.29,20,14,32.0,6,2,6,2.2
7.08,60.741,58,35.745,54.32,54,456.41,23,31,35,37.813,23,7,45.5,21,1,21,9.3
8.05,61.693,59,35.685,55.302,55,436.58,24,31,35,37.648,23,7,45.0,18,3,16,7.3
7.76,63.843,61,37.325,57.182,57,469.05,25,32,36,39.813,24,8,46.0,18,2,16,7.0
7.04,61.637,59,36.513,55.625,55,471.02,23,32,36,38.506,23,7,46.0,18,3,16,7.3
7.68,65.478,62,36.331,57.883,58,417.56,27,31,35,38.313,24,8,45.5,21,2,21,8.6
6.876,83.437,78,44.286,73.821,74,514.75,38,36,40,47.637,28,16,48.0,14,5,12,2.7
6.516,78.757,74,42.872,69.934,70,519.16,35,35,39,46.279,27,15,47.0,14,4,12,2.9
6.971,74.472,70,41.014,66.236,66,507.12,32,34,38,44.0,26,14,46.0,14,3,12,3.0
6.472,74.472,70,41.014,66.236,66,507.12,32,34,38,44.0,26,14,46.0,14,3,12,3.0
6.469,77.607,74,42.233,69.054,69,498.7,34,35,40,45.114,27,15,48.0,14,5,12,2.9
6.91,83.456,76,44.436,74.359,73,556.71,35,38,41,46.449,27,15,49.0,14,5,12,2.7
6.434,83.456,76,44.436,74.359,73,556.71,35,38,41,46.449,27,15,49.0,14,5,12,2.7
7.041,81.041,75,43.909,72.476,71,554.69,33,38,42,45.688,27,15,50.0,14,5,12,2.8
6.742,74.491,68,41.164,66.774,65,549.08,29,36,39,42.813,25,13,47.0,14,3,12,3.1
6.104,74.491,68,41.164,66.774,65,549.08,29,36,39,42.813,25,13,47.0,14,3,12,3.1
6.583,79.511,72,42.961,71.174,69,562.66,31,38,41,44.108,26,14,49.0,14,4,12,2.9
6.45,79.511,72,42.961,71.174,69,562.66,31,38,41,44.108,26,14,49.0,14,4,12,2.9
6.52,79.511,72,42.961,71.174,69,562.66,31,38,41,44.108,26,14,49.0,14,4,12,2.9
5.356,82.777,76,43.67,73.334,73,520.73,37,36,39,46.574,27,15,47.0,14,5,12,2.7
6.167,83.117,76,44.053,73.847,73,538.72,36,37,40,46.512,27,15,48.0,14,5,12,2.7
6.161,86.192,79,45.196,76.218,76,534.76,39,37,40,48.336,28,16,48.0,14,5,12,2.6
6.194,86.192,79,45.196,76.218,76,534.76,39,37,40,48.336,28,16,48.0,14,5,12,2.6
6.524,86.192,79,45.196,76.218,76,534.76,39,37,40,48.336,28,16,48.0,14,5,12,2.6
5.859,77.283,71,41.096,68.309,68,492.69,34,34,37,43.841,26,14,45.0,14,3,12,2.9
6.851,83.437,78,44.286,73.821,74,514.75,38,36,40,47.637,28,16,48.0,14,5,12,2.7
5.0,26.842,25,18.577,24.956,24,260.28,6,18,19,18.818,13,1,28.5,13,0,11,8.3
6.49,71.773,67,39.497,63.992,64,449.59,31,33,36,41.699,27,9,45.0,18,5,18,1.6
5.78,71.773,67,39.497,63.992,64,449.59,31,33,36,41.699,27,9,45.0,18,5,18,1.6
7.25,67.149,63,37.256,59.781,60,419.56,29,31,34,39.483,26,8,43.0,18,4,18,1.7
6.38,67.149,63,37.256,59.781,60,419.56,29,31,34,39.483,26,8,43.0,18,4,18,1.7
6.92,62.524,59,35.014,55.571,56,389.53,27,29,32,37.267,25,7,41.0,18,3,18,1.8
6.77,62.524,59,35.014,55.571,56,389.53,27,29,32,37.267,25,7,41.0,18,3,18,1.8
6.697,78.188,72,41.749,69.374,69,502.7,34,35,38,44.364,25,13,48.0,16,5,12,5.8
6.627,78.188,72,41.749,69.374,69,502.7,34,35,38,44.364,25,13,48.0,16,5,12,5.8
6.772,79.394,73,41.561,69.93,70,488.72,36,34,37,44.671,25,14,45.0,14,4,12,5.7
6.903,74.555,69,41.172,66.272,66,572.02,32,34,37,44.665,24,13,45.0,14,3,12,6.1
6.967,76.026,70,40.208,67.014,67,475.69,34,33,36,43.148,25,13,44.0,14,3,12,4.5
6.264,76.026,70,40.208,67.014,67,475.69,34,33,36,43.148,25,13,44.0,14,3,12,4.5
6.921,75.97,70,41.035,67.338,67,510.13,33,34,37,44.006,25,13,45.0,14,3,12,4.5
6.996,75.97,70,41.035,67.338,67,510.13,33,34,37,44.006,25,13,45.0,14,3,12,4.5
6.476,80.121,73,42.501,70.923,70,525.7,34,36,39,44.785,26,14,47.0,14,3,12,4.3
6.614,75.97,70,41.035,67.338,67,510.13,33,34,37,44.006,25,13,45.0,14,3,12,4.5
6.439,85.936,80,45.308,75.923,76,529.77,39,37,41,48.642,28,16,49.0,14,5,12,3.9
6.654,80.121,73,42.501,70.923,70,525.7,34,36,39,44.785,26,14,47.0,14,3,12,4.3
6.662,83.726,77,43.593,73.596,74,501.76,39,35,38,47.188,27,15,46.0,14,4,12,4.1
6.554,74.555,69,41.172,66.272,66,572.02,32,34,37,44.665,24,13,45.0,14,3,12,6.1
6.79,80.651,74,42.449,71.225,71,505.72,36,35,38,45.364,26,14,46.0,14,4,12,4.2
6.399,80.255,74,42.894,71.036,71,522.17,36,35,38,46.284,26,14,46.0,14,4,12,4.2
7.377,80.153,74,43.091,70.941,71,566.62,36,35,38,46.779,26,14,46.0,14,4,12,4.2
6.373,84.936,78,44.308,74.923,75,517.76,39,36,39,47.642,27,15,47.0,14,5,12,4.0
6.325,84.745,77,44.743,75.134,74,555.73,36,38,41,47.0,27,15,49.0,14,4,12,4.1
6.588,84.745,77,44.743,75.134,74,555.73,36,38,41,47.0,27,15,49.0,14,4,12,4.1
6.762,82.813,76,43.99,73.585,73,532.73,36,37,40,46.58,26,14,50.0,16,6,12,5.5
6.777,79.046,73,42.179,69.709,70,506.17,36,34,37,45.83,26,14,45.0,14,3,12,4.3
6.221,81.255,76,43.894,72.036,72,534.18,36,36,40,47.284,27,15,48.0,14,4,12,4.2
6.021,76.97,72,42.035,68.338,68,522.14,33,35,39,45.006,26,14,47.0,14,3,12,4.4
6.602,80.255,74,42.894,71.036,71,522.17,36,35,38,46.284,26,14,46.0,14,4,12,4.2
6.714,79.046,73,42.179,69.709,70,506.17,36,34,37,45.83,26,14,45.0,14,3,12,4.3
7.086,79.102,73,41.351,69.385,70,471.73,37,33,36,44.972,26,14,44.0,14,3,12,4.3
6.699,79.102,73,41.351,69.385,70,471.73,37,33,36,44.972,26,14,44.0,14,3,12,4.3
6.312,75.686,70,39.824,66.501,67,457.7,35,32,35,43.211,25,13,43.0,14,3,12,4.5
6.664,76.769,71,41.319,67.72,68,482.71,34,34,37,44.455,26,13,47.0,15,3,12,5.9
7.509,76.769,71,41.319,67.72,68,482.71,34,34,37,44.455,26,13,47.0,15,3,12,5.9
6.415,76.026,70,40.208,67.014,67,475.69,34,33,36,43.148,25,13,44.0,14,3,12,4.5
6.398,74.769,69,39.319,65.72,66,458.69,34,32,35,42.455,24,13,43.0,14,3,12,6.1
6.824,76.026,70,40.208,67.014,67,475.69,34,33,36,43.148,25,13,44.0,14,3,12,4.5
6.71,82.44,76,43.968,73.116,73,535.8,37,36,39,47.529,26,14,49.0,16,5,12,4.1
6.407,82.44,76,43.968,73.116,73,535.8,37,36,39,47.529,26,14,49.0,16,5,12,4.1
6.9,84.936,78,44.308,74.923,75,517.76,39,36,39,47.642,27,15,47.0,14,5,12,4.0
6.759,81.33,74,43.216,72.25,71,541.7,34,37,40,45.239,26,14,48.0,14,4,12,4.2
6.815,84.936,78,44.308,74.923,75,517.76,39,36,39,47.642,27,15,47.0,14,5,12,4.0
6.963,91.766,84,47.361,80.69,81,545.82,43,38,41,51.165,29,17,49.0,14,5,12,3.7
7.409,82.539,75,43.931,73.578,72,557.7,34,38,41,45.694,26,14,49.0,14,5,12,4.2
6.1,71.019,66,39.078,62.876,63,446.6,30,33,36,41.284,26,11,46.0,15,3,12,6.3
5.8,70.615,65,38.35,62.683,62,457.57,29,33,36,39.915,25,11,44.0,14,3,12,4.8
6.1,72.019,68,40.078,63.876,64,458.61,30,34,38,42.284,27,12,48.0,15,3,12,6.3
6.1,71.615,67,39.35,63.683,63,469.58,29,34,38,40.915,26,12,46.0,14,3,12,4.8
6.1,70.615,65,38.35,62.683,62,457.57,29,33,36,39.915,25,11,44.0,14,3,12,4.8
5.712,90.987,84,50.097,81.418,80,610.72,36,44,48,51.569,32,14,59.0,17,6,12,5.0
5.6,70.276,65,37.967,62.17,62,439.58,30,32,35,39.978,25,11,43.0,14,3,12,4.8
9.06,70.312,66,38.288,62.421,62,451.58,29,33,37,39.983,24,11,46.0,17,4,16,8.1
9.06,71.521,67,39.003,63.749,63,467.58,29,34,38,40.438,24,11,47.0,17,5,16,7.9
8.86,72.521,68,40.003,64.749,64,479.59,29,35,39,41.438,25,11,49.0,18,5,16,7.8
9.62,66.607,63,37.233,59.287,59,453.62,27,32,36,39.415,23,10,45.0,17,3,16,8.5
8.23,69.185,65,38.068,61.312,61,448.58,28,33,37,39.773,24,10,46.5,18,3,17,9.8
9.31,70.102,66,38.573,62.094,62,447.59,29,33,37,40.529,25,10,46.5,18,3,17,8.1
7.351,73.434,69,39.605,64.76,65,448.62,32,33,37,42.046,26,13,45.0,14,3,12,6.2
7.65,73.434,69,39.605,64.76,65,448.62,32,33,37,42.046,26,13,45.0,14,3,12,6.2
5.386,75.71,70,41.644,67.592,66,519.59,29,37,41,42.552,27,13,49.0,14,3,12,4.5
5.966,74.239,70,41.766,66.189,66,516.51,31,35,39,44.517,27,13,47.0,14,3,12,4.5
6.896,74.691,70,40.494,66.054,66,465.62,32,34,38,42.739,27,13,46.0,14,3,12,4.5
7.824,80.766,77,44.637,71.425,72,497.69,35,37,42,47.563,31,13,52.5,19,3,17,4.2
6.57,81.106,77,45.021,71.938,72,515.68,34,38,43,47.5,31,13,53.5,19,3,17,4.2
5.7,83.221,79,46.712,73.159,74,537.8,35,39,44,50.347,31,11,57.5,27,0,27,9.5
6.686,83.478,78,46.276,74.625,74,546.68,34,40,44,48.171,30,10,55.5,23,6,23,5.4
7.1,63.963,57,34.085,57.043,55,444.48,24,31,33,34.273,20,10,39.0,9,3,6,7.3
7.7,76.995,69,40.502,68.29,67,495.6,32,35,37,41.83,25,12,44.0,13,4,12,4.5
7.9,60.505,55,32.654,53.425,53,404.95,25,28,30,34.415,19,8,37.0,13,2,12,11.3
5.0,45.602,43,27.923,41.804,41,357.81,16,25,27,28.773,19,2,36.5,18,4,17,2.4
6.83,98.929,92,54.669,87.832,88,622.83,42,46,50,57.762,37,13,65.0,24,5,18,4.5
8.9,72.394,65,36.836,63.432,64,401.6,35,29,30,39.767,24,12,36.0,12,4,12,1.6
7.669,34.269,33,20.724,30.687,31,263.81,14,17,19,22.841,14,4,25.0,11,0,10,3.2
8.0,54.113,50,29.39,48.458,48,345.43,23,25,27,30.654,19,7,33.0,12,5,12,2.1
5.0,33.641,32,19.746,30.156,30,248.73,13,17,19,20.892,13,4,24.5,11,1,11,6.7
5.0,41.74,39,23.369,37.222,37,291.41,17,20,22,24.904,14,5,29.5,13,2,11,8.1
6.634,76.887,71,42.426,68.171,68,539.98,33,35,38,45.688,26,13,45.0,13,2,12,5.9
6.151,80.81,74,41.854,70.596,71,468.68,37,34,37,44.813,27,14,44.0,13,2,12,5.6
6.539,76.943,71,41.599,67.847,68,505.54,34,34,37,44.83,26,13,44.0,13,2,12,5.9
6.016,77.735,71,40.711,68.225,68,472.64,34,34,37,42.989,26,13,44.0,13,2,12,5.9
6.497,86.304,79,44.427,75.621,76,496.72,40,36,39,47.546,28,15,46.0,13,4,12,5.3
5.0,41.684,39,24.196,37.545,37,325.85,16,21,23,25.762,14,5,30.5,13,2,11,8.1
6.222,37.069,36,21.72,32.825,33,250.33,14,19,22,22.83,15,3,30.0,16,0,16,12.1
5.0,37.112,35,20.445,32.716,33,228.32,16,17,19,21.796,14,5,24.5,11,1,11,6.1
6.558,76.999,71,40.771,67.523,68,471.1,35,33,36,43.972,26,13,43.0,13,2,12,5.9
6.587,77.735,71,40.711,68.225,68,472.64,34,34,37,42.989,26,13,44.0,13,2,12,5.9
6.428,76.999,71,40.771,67.523,68,471.1,35,33,36,43.972,26,13,43.0,13,2,12,5.9
5.0,37.013,36,22.547,33.149,33,284.77,13,20,23,23.688,15,3,31.0,16,0,16,12.1
5.0,38.325,36,21.842,34.338,34,277.38,15,19,21,23.142,13,4,28.5,13,2,11,8.8
5.0,45.155,42,24.895,40.105,40,305.44,19,21,23,26.665,15,6,30.5,13,2,11,7.5
5.0,37.196,35,20.94,32.934,33,241.32,15,18,20,22.04,14,4,26.5,12,1,11,9.1
5.0,41.74,39,23.369,37.222,37,291.41,17,20,22,24.904,14,5,29.5,13,2,11,8.1
5.0,40.894,37,22.911,36.873,36,317.83,16,20,21,24.216,12,5,27.0,9,3,6,8.3
6.102,32.488,31,18.204,28.505,29,198.29,14,15,17,19.58,13,4,22.5,11,0,11,6.9
5.0,29.073,28,16.677,25.622,26,184.26,12,14,16,17.818,12,3,21.5,11,0,11,7.7
5.0,39.196,38,22.94,34.934,35,265.34,15,20,23,24.04,16,4,31.0,16,1,16,8.6
5.0,35.491,35,21.885,31.8,32,267.38,13,19,22,23.472,15,3,30.0,16,0,16,9.4
5.0,38.986,38,23.225,34.607,35,261.35,15,20,23,24.586,17,3,31.5,17,0,17,8.6
5.0,38.986,38,23.225,34.607,35,261.35,15,20,23,24.586,17,3,31.5,17,0,17,8.6
6.045,40.484,39,23.246,35.709,36,264.36,16,20,23,24.591,16,4,31.0,16,0,16,11.1
5.0,40.484,39,23.246,35.709,36,264.36,16,20,23,24.591,16,4,31.0,16,0,16,11.1
5.0,40.484,39,23.246,35.709,36,264.36,16,20,23,24.591,16,4,31.0,16,0,16,11.1
7.041,89.861,83,49.876,80.309,79,607.72,35,44,48,51.358,32,14,60.0,17,5,12,6.3
6.824,85.786,78,47.733,76.938,75,599.67,32,43,46,48.534,30,12,58.0,17,5,12,6.7
7.8,78.049,71,43.26,70.323,68,571.65,29,39,42,44.108,26,11,52.5,19,5,17,4.4
8.15,62.236,58,34.199,55.076,55,395.52,26,29,32,36.0,23,9,40.0,14,2,12,5.5
5.0,75.265,68,37.659,65.527,66,416.63,36,30,32,40.569,23,15,37.0,8,3,6,6.1
8.332,66.109,63,38.212,59.185,59,462.62,26,33,37,40.409,25,7,47.5,19,3,17,6.8
5.0,31.282,30,18.392,27.949,28,212.27,12,16,18,19.273,13,2,25.5,15,1,15,7.1
9.96,71.727,65,37.815,63.305,63,441.59,31,32,34,39.745,23,10,43.0,17,4,16,7.9
6.524,77.735,71,40.711,68.225,68,472.64,34,34,37,42.989,26,13,44.0,13,2,12,5.9
6.684,81.624,75,43.013,71.734,72,501.13,37,35,38,46.188,27,14,45.0,13,3,12,5.6
6.812,81.68,75,42.186,71.41,72,466.69,38,34,37,45.33,27,14,44.0,13,3,12,5.6
4.0,40.983,38,22.268,35.811,36,255.36,17,19,21,23.597,14,4,27.5,12,0,11,13.9
7.2,43.481,40,23.289,37.912,38,270.38,18,20,22,24.603,14,5,28.5,12,0,11,15.8
5.0,71.561,65,36.825,62.869,63,415.59,33,30,32,39.256,23,14,38.0,9,4,6,4.8
4.0,47.813,44,25.321,41.578,42,283.42,21,21,23,27.12,16,6,29.5,12,0,11,11.9
4.336,71.849,65,36.132,62.643,63,402.6,34,29,31,38.807,22,14,36.0,8,3,6,6.3
7.1,37.568,35,20.741,32.927,33,241.33,15,18,20,21.836,13,3,26.5,12,0,11,15.2
4.0,45.315,42,24.3,39.476,40,268.4,20,20,22,26.114,16,5,28.5,12,0,11,10.0
4.0,44.398,41,23.795,38.694,39,269.39,19,20,22,25.358,15,5,28.5,12,0,11,12.8
6.55,102.344,95,56.196,90.716,91,636.86,44,47,51,59.523,38,14,66.0,24,5,18,4.4
4.0,45.417,41,24.945,40.232,39,323.36,16,23,25,25.171,15,5,31.5,12,0,11,12.8
8.3,37.568,35,20.741,32.927,33,241.33,15,18,20,21.836,13,3,26.5,12,0,11,15.2
7.824,88.944,82,49.371,79.527,78,608.71,34,44,48,50.603,31,13,60.0,17,5,12,7.7
7.5,79.561,75,44.825,70.869,71,511.67,33,38,42,47.256,31,9,54.0,21,4,18,4.2
6.76,104.467,97,56.513,92.054,93,621.89,47,46,50,60.586,39,15,63.0,22,4,18,3.2
8.0,35.907,34,20.633,32.16,32,242.3,14,18,20,21.489,14,3,26.5,12,2,11,6.3
6.46,93.388,87,51.922,82.839,83,593.79,39,44,48,54.79,35,11,63.0,24,4,18,6.0
7.538,57.272,54,31.574,50.352,51,347.5,25,26,29,33.847,22,7,38.0,17,1,16,5.9
5.0,58.942,54,30.223,51.749,52,352.55,28,24,26,32.921,18,12,31.0,8,3,6,3.8
7.4,52.69,49,28.058,46.032,47,295.46,25,22,24,30.597,20,8,30.0,12,1,12,2.1
6.0,64.89,62,37.732,58.367,58,492.11,26,32,36,40.671,23,9,46.0,18,3,16,5.2
6.345,96.803,90,53.449,85.723,86,607.82,41,45,49,56.552,36,12,64.0,24,4,18,5.8
6.87,98.929,92,54.669,87.832,88,622.83,42,46,50,57.762,37,13,65.0,24,5,18,4.5
7.335,63.734,60,35.729,56.898,57,405.53,27,30,33,37.722,25,7,42.0,18,4,18,1.8
6.71,68.358,64,37.971,61.109,61,435.56,29,32,35,39.938,26,8,44.0,18,5,18,1.6
6.7,58.398,54,31.794,51.461,52,350.5,26,26,28,34.057,22,8,36.0,14,2,12,3.8
7.268,77.576,71,42.072,68.636,68,499.63,32,36,39,43.921,28,12,48.0,15,2,12,4.4
5.983,75.244,69,42.04,66.97,66,510.61,29,37,40,43.404,28,11,51.0,16,2,12,6.1
6.437,78.659,72,43.567,69.854,69,524.64,31,38,41,45.165,29,12,52.0,16,2,12,5.8
6.06,74.292,68,40.035,65.094,66,452.09,34,32,34,43.512,27,13,43.0,14,1,12,4.5
4.67,33.112,31,16.445,28.716,29,180.28,16,13,15,17.796,10,9,16.0,1,1,0,6.9
6.174,76.348,71,41.208,66.77,68,441.67,35,33,36,44.654,29,11,46.0,19,1,18,4.4
7.455,61.721,60,37.007,55.843,55,484.02,22,33,38,38.75,23,9,48.0,18,3,16,9.1
7.301,94.225,88,52.835,84.174,84,609.78,39,45,49,55.449,36,12,64.0,24,6,18,3.6
6.372,78.659,72,43.567,69.854,69,524.64,31,38,41,45.165,29,12,52.0,16,2,12,5.8
8.19,69.94,66,38.487,62.429,62,451.57,29,33,37,40.188,25,11,45.0,14,5,12,4.8
7.213,72.062,68,38.804,63.767,64,436.6,32,32,36,41.25,26,13,43.0,13,4,12,3.1
8.636,72.065,68,39.486,64.061,64,469.66,31,33,37,42.142,25,13,44.5,13,4,11,4.7
7.976,59.773,57,33.498,53.225,53,392.5,24,29,33,35.0,22,9,41.0,14,3,12,7.5
7.788,67.521,64,37.057,59.774,60,419.57,29,31,35,39.279,25,11,43.0,14,3,12,5.0
8.788,57.195,55,32.664,51.2,51,397.54,23,28,32,34.642,21,9,39.5,13,3,11,5.9
7.134,65.727,61,33.869,57.33,58,369.56,31,27,30,36.586,22,14,35.0,8,2,6,5.2
6.7,69.876,62,36.633,62.029,60,473.53,27,33,35,37.04,21,11,41.0,9,3,6,8.3
7.8,67.038,60,35.228,59.414,58,440.52,27,31,33,36.097,21,11,39.0,9,3,6,6.9
7.155,89.861,83,49.876,80.309,79,607.72,35,44,48,51.358,32,14,60.0,17,5,12,6.3
7.8,60.99,57,33.282,53.767,54,408.41,27,27,30,36.086,21,12,35.0,8,1,6,5.6
6.893,59.91,55,32.691,53.32,53,413.38,26,27,29,34.989,20,12,34.0,8,3,6,3.8
7.0,63.623,57,33.702,56.53,55,426.49,25,30,32,34.336,20,10,38.0,9,3,6,7.3
6.562,63.228,59,32.848,55.229,56,354.54,30,26,29,35.58,22,14,34.0,8,2,6,3.6
5.6,54.037,50,30.689,48.429,48,440.4,22,26,28,32.995,18,6,36.0,14,3,12,6.3
6.886,40.911,41,26.745,37.054,37,377.26,13,24,28,28.182,19,0,40.5,25,0,25,10.8
8.676,57.195,55,32.664,51.2,51,397.54,23,28,32,34.642,21,9,39.5,13,3,11,5.9
7.277,65.615,61,35.524,57.978,58,438.44,29,29,32,38.301,22,14,37.0,8,2,6,5.2
7.8,60.547,54,32.558,54.16,52,430.45,22,30,32,32.512,19,9,38.0,9,3,6,7.7
8.472,64.029,61,36.62,57.738,57,455.58,25,32,36,38.313,23,10,44.5,14,5,11,5.3
5.886,87.861,81,47.876,78.309,77,583.7,35,42,46,49.358,30,14,56.0,16,5,12,6.5
7.998,62.595,58,33.553,55.283,55,407.96,27,28,31,35.62,21,13,36.0,8,2,6,5.5
9.18,69.94,66,38.487,62.429,62,451.57,29,33,37,40.188,25,11,45.0,14,5,12,4.8
7.075,64.667,60,32.794,55.883,57,362.01,32,25,28,36.296,21,15,31.0,6,0,6,5.3
6.578,62.311,58,32.342,54.447,55,355.53,29,26,29,34.824,21,13,34.0,8,2,6,5.5
6.102,66.69,61,35.846,59.192,58,457.97,27,31,34,37.256,22,14,39.0,8,2,6,5.2
8.146,65.235,62,36.432,58.294,58,441.6,27,31,35,38.62,23,11,42.5,13,4,11,5.2
8.588,58.773,56,32.498,52.225,52,380.49,24,28,32,34.0,21,9,39.5,13,3,11,7.7
5.7,68.305,65,39.259,61.251,61,506.14,28,33,37,42.432,24,10,47.0,18,3,16,4.9
7.267,50.954,47,28.417,45.443,45,370.31,21,24,26,30.256,17,9,31.0,8,2,6,6.7
5.8,64.89,62,37.732,58.367,58,492.11,26,32,36,40.671,23,9,46.0,18,3,16,5.2
7.064,47.539,44,26.89,42.56,42,356.28,19,23,25,28.495,16,8,30.0,8,2,6,7.1
5.0,49.651,47,27.235,43.912,44,311.42,21,23,26,28.779,18,8,33.0,12,2,10,6.8
6.094,75.584,69,42.424,67.483,66,528.6,28,38,41,43.341,28,11,52.0,16,2,12,6.1
5.398,26.542,23,14.183,24.014,23,187.19,10,13,13,14.114,8,2,16.0,6,3,6,4.3
7.469,77.264,72,41.713,67.552,69,440.68,36,33,36,45.41,30,11,46.0,19,1,18,2.9
6.075,78.999,72,43.95,70.367,69,542.63,30,39,42,45.103,29,12,53.0,16,2,12,5.8
8.97,66.736,61,37.135,59.691,59,477.67,27,32,34,39.517,21,8,43.0,17,4,16,8.5
6.076,71.517,67,40.154,63.003,64,437.63,31,33,36,43.131,29,9,48.0,20,1,18,4.7
6.187,77.763,71,40.735,67.654,69,431.68,37,32,34,44.415,28,14,43.0,14,1,12,4.3
6.444,81.763,76,44.735,71.654,73,479.72,37,36,39,48.415,32,12,51.0,20,1,18,4.1
5.7,60.474,57,35.205,54.483,54,466.07,24,30,33,37.909,21,7,43.0,18,3,16,5.6
6.013,74.991,70,43.054,67.447,66,535.6,27,39,43,43.858,28,10,55.0,17,4,12,7.6
7.939,65.671,61,34.697,57.654,58,404.0,30,28,31,37.444,22,14,36.0,8,2,6,5.2
4.8,49.651,47,27.235,43.912,44,311.42,21,23,26,28.779,18,8,33.0,12,2,10,6.8
7.347,86.572,79,47.57,77.534,76,584.68,34,42,45,48.807,30,12,56.0,17,6,12,5.3
7.3,60.491,54,33.386,54.483,52,464.89,21,31,33,33.37,19,9,39.0,9,3,6,7.7
7.336,63.394,59,33.837,55.665,56,380.54,28,28,31,36.069,22,13,38.0,9,2,6,7.1
7.694,61.046,57,32.455,53.443,54,373.97,28,26,29,35.228,21,12,34.0,8,1,6,5.6
7.0,60.547,54,32.558,54.16,52,430.45,22,30,32,32.512,19,9,38.0,9,3,6,7.7
7.444,63.461,59,32.982,55.327,56,375.99,30,26,29,35.989,21,14,33.0,7,1,6,5.4
6.523,81.438,77,46.454,73.505,72,574.65,30,42,47,47.352,29,11,60.0,21,7,16,8.3
7.189,62.651,58,32.726,54.96,55,373.52,28,27,30,34.762,21,13,35.0,8,2,6,5.5
8.086,59.773,57,33.498,53.225,53,392.5,24,29,33,35.0,22,9,41.0,14,3,12,7.5
5.721,84.972,80,47.449,74.981,76,519.74,37,39,43,50.87,34,13,56.0,21,2,18,3.9
6.409,83.481,79,47.179,75.396,74,576.66,32,42,47,48.318,30,12,58.0,17,8,12,5.4
7.882,65.615,61,35.524,57.978,58,438.44,29,29,32,38.301,22,14,37.0,8,2,6,5.2
6.481,80.742,75,45.516,72.767,71,568.63,30,41,45,46.284,29,11,56.0,17,6,12,5.6
5.921,77.327,72,43.989,69.883,68,554.6,28,40,44,44.523,28,10,55.0,17,6,12,5.9
6.137,89.861,83,49.876,80.309,79,607.72,35,44,48,51.358,32,14,60.0,17,5,12,6.3
6.886,89.861,83,49.876,80.309,79,607.72,35,44,48,51.358,32,14,60.0,17,5,12,6.3
7.553,88.944,82,49.371,79.527,78,608.71,34,44,48,50.603,31,13,60.0,17,5,12,7.7
7.292,88.944,82,49.371,79.527,78,608.71,34,44,48,50.603,31,13,60.0,17,5,12,7.7
6.0,66.936,62,34.584,58.658,59,385.56,31,28,31,37.04,22,14,36.0,8,3,6,5.1
6.921,89.861,83,49.876,80.309,79,607.72,35,44,48,51.358,32,14,60.0,17,5,12,6.3
6.886,82.564,77,46.674,74.614,73,577.65,31,42,46,47.563,29,11,59.0,19,8,12,6.8
7.818,67.003,63,37.675,59.527,59,468.01,26,33,37,39.421,23,8,47.0,18,2,16,11.9
6.42,63.405,59,33.809,55.651,56,410.43,29,27,30,36.847,21,14,34.0,7,1,6,5.4
5.699,82.766,78,46.637,73.425,74,521.71,35,39,43,49.563,33,12,56.0,21,3,18,4.1
8.2,64.642,57,34.851,58.069,55,480.46,22,33,35,34.148,20,10,41.0,9,3,6,7.3
8.74,63.272,60,35.519,56.327,56,419.53,25,31,35,37.006,23,7,45.0,18,3,16,8.9
7.656,70.102,65,38.573,62.094,62,447.59,29,33,36,40.529,25,8,46.0,16,3,12,8.1
5.912,83.156,78,48.217,74.945,74,611.57,32,42,46,50.432,31,10,58.0,21,5,18,5.4
7.2,72.351,68,38.111,63.541,64,423.61,33,31,35,40.802,25,13,41.0,12,3,12,4.7
8.644,65.315,62,36.245,58.218,58,421.54,27,31,35,37.972,24,10,43.0,14,4,12,5.2
5.699,83.608,78,46.945,74.81,74,560.68,33,41,45,48.654,31,10,57.0,21,5,18,5.4
5.973,49.487,46,26.928,43.771,44,318.48,22,22,24,29.182,17,7,29.5,11,2,11,4.5
6.284,40.752,41,27.77,37.283,37,456.15,12,25,29,29.534,19,0,41.5,25,0,25,10.8
4.0,40.759,36,22.518,36.76,35,321.36,14,21,22,22.716,12,5,28.0,9,2,6,8.6
7.103,53.464,52,33.617,48.374,48,583.14,19,29,33,36.387,21,5,43.0,20,1,20,8.3
5.699,87.893,82,48.803,78.509,78,572.72,36,42,46,50.932,32,11,58.0,21,6,18,5.1
5.699,87.893,82,48.803,78.509,78,572.72,36,42,46,50.932,32,11,58.0,21,6,18,5.1
5.699,86.683,81,48.088,77.181,77,556.72,36,41,45,50.478,32,11,57.0,21,5,18,5.2
5.939,44.488,44,28.149,40.48,40,342.38,14,26,30,28.739,20,0,43.5,26,2,25,10.0
7.507,67.687,64,38.046,60.211,60,445.57,27,33,37,39.767,25,8,47.5,19,3,17,8.3
5.301,56.318,52,29.981,49.538,50,346.54,26,24,26,32.705,19,9,31.5,11,2,11,4.0
5.699,83.608,78,46.945,74.81,74,560.68,33,41,45,48.654,31,10,57.0,21,5,18,5.4
7.021,71.145,67,38.299,62.985,63,437.59,31,32,36,40.495,25,12,43.0,13,4,12,4.8
5.699,85.474,80,47.374,75.854,76,540.72,36,40,44,50.023,32,11,56.0,21,4,18,5.3
8.478,63.192,60,35.928,56.88,56,436.51,24,32,36,36.909,23,9,46.0,16,5,12,7.1
6.442,86.683,81,48.088,77.181,77,556.72,36,41,45,50.478,32,11,57.0,21,5,18,5.2
5.699,84.478,79,47.276,75.625,75,558.69,34,41,45,49.171,31,10,57.0,21,6,18,5.3
6.384,71.062,66,37.583,62.29,63,427.67,33,30,33,40.995,24,13,39.5,12,2,11,4.8
4.55,35.528,32,16.972,30.6,31,182.3,18,13,14,18.557,10,9,15.0,1,1,0,6.5
5.17,39.528,37,20.972,34.6,35,230.34,18,17,19,22.557,14,7,23.0,7,1,6,5.7
7.82,34.246,31,18.795,30.196,30,239.35,14,16,17,20.171,11,4,21.0,7,0,6,10.0
5.78,83.608,78,46.945,74.81,74,560.68,33,41,45,48.654,31,10,57.0,21,5,18,5.4
5.699,92.597,86,50.637,82.167,82,585.77,39,43,47,53.245,33,12,59.0,21,5,18,6.1
8.0,68.364,65,39.334,61.698,61,501.68,27,34,38,41.722,24,10,48.0,16,5,12,4.9
6.17,75.275,72,42.2,67.389,67,509.68,31,36,41,44.597,27,13,51.0,16,5,12,4.5
5.524,67.019,62,35.078,58.876,59,398.56,30,29,32,37.285,22,12,38.5,12,3,11,6.8
5.699,70.72,66,40.007,63.611,63,505.08,29,34,37,42.449,25,11,47.0,16,5,12,3.2
5.4,42.358,38,20.026,36.367,37,210.36,22,15,16,22.08,12,11,17.0,1,1,0,5.4
5.407,71.723,66,36.912,62.534,63,411.61,33,30,33,39.597,23,13,39.5,12,2,11,7.9
9.125,68.837,64,38.686,61.091,61,466.03,28,33,36,40.932,25,8,46.0,16,2,12,8.2
5.372,66.73,62,35.551,58.625,59,414.63,30,29,32,38.478,22,12,38.5,12,2,11,6.8
5.761,70.145,65,37.077,61.509,62,428.66,32,30,33,40.239,23,13,39.5,12,2,11,6.5
5.783,68.654,65,38.862,61.949,61,485.61,27,34,38,40.529,24,10,48.0,16,6,12,4.9
8.523,64.189,61,36.025,57.109,57,418.54,26,31,35,37.762,24,9,45.0,18,3,16,7.0
5.708,70.863,67,40.576,64.276,63,513.62,27,36,40,41.983,25,10,51.0,17,7,12,4.8
8.697,67.893,63,36.858,59.767,60,419.58,29,31,34,39.074,24,8,43.0,15,2,12,8.3
7.854,64.029,61,36.62,57.738,57,455.58,25,32,36,38.313,23,9,46.0,16,5,12,5.3
5.93,94.304,89,52.427,83.621,84,592.8,40,44,49,55.546,36,12,62.0,22,4,18,4.8
6.79,100.138,93,55.384,89.159,89,638.83,42,47,51,58.216,37,13,66.0,24,6,18,4.5
6.01,93.016,88,52.121,82.847,83,593.78,39,44,49,54.995,36,12,62.0,22,5,18,3.6
6.492,73.64,68,38.417,64.316,65,422.63,34,31,34,41.353,25,13,41.0,13,2,12,6.2
5.0,29.571,27,15.698,25.723,26,175.26,13,13,14,16.824,10,4,18.0,7,0,6,11.5
6.79,107.048,99,58.029,94.374,95,649.91,47,48,52,61.836,39,15,67.0,24,4,18,5.3
7.62,63.973,61,37.448,58.062,57,490.02,24,33,37,39.171,23,9,47.0,16,5,12,5.3
6.287,58.607,56,31.509,51.789,52,354.49,26,26,30,33.512,21,12,36.0,11,3,10,3.8
6.91,92.956,87,52.045,82.399,83,598.24,40,43,47,55.705,36,12,60.0,22,3,18,3.6
5.93,100.218,93,54.975,88.607,89,621.85,43,46,50,58.313,37,13,65.0,24,4,18,5.6
6.69,97.637,91,53.459,86.287,87,593.83,43,44,48,57.063,37,13,61.0,22,4,18,3.4
6.57,96.427,90,52.745,84.959,86,577.83,43,43,47,56.609,37,13,60.0,22,3,18,3.5
6.854,70.912,65,40.008,63.305,62,497.57,26,36,39,40.887,26,9,50.0,16,2,12,8.1
6.357,75.41,69,43.029,67.407,66,536.61,27,39,42,43.892,28,10,55.0,17,2,12,9.1
6.742,110.464,102,59.556,97.257,98,663.94,49,49,53,63.597,40,16,68.0,24,4,18,5.1
5.54,67.149,63,37.256,59.781,60,419.56,29,31,34,39.483,26,8,43.0,18,4,18,1.7
7.1,44.524,40,23.015,38.803,39,260.38,20,19,20,24.569,14,6,25.0,8,1,6,10.3
5.3,43.235,39,22.708,38.029,38,261.36,19,19,20,24.017,14,6,25.0,8,2,6,7.9
6.444,50.488,48,28.149,45.247,45,327.41,21,24,27,29.438,19,7,33.0,12,4,12,2.2
5.3,47.939,43,24.542,41.687,42,274.41,22,20,21,26.33,15,7,26.0,8,1,6,9.5
6.752,105.862,97,58.367,94.356,93,705.85,42,51,55,60.341,38,14,70.0,24,5,18,5.4
5.3,48.939,45,25.542,42.687,43,286.42,22,21,23,27.33,16,8,28.0,8,1,6,9.3
6.076,99.929,91,53.614,88.807,88,634.81,42,46,49,55.921,33,14,62.0,19,7,12,6.8
7.62,78.982,76,45.991,70.843,71,540.73,32,39,44,48.898,32,9,58.5,26,4,23,2.8
6.487,107.341,99,58.238,94.919,95,666.9,46,49,53,61.535,38,14,68.0,24,5,18,6.3
6.51,73.148,70,40.98,65.28,65,494.67,30,35,40,43.387,26,11,51.0,19,4,16,6.2
9.959,60.9,57,33.718,54.334,54,395.5,25,29,32,35.211,22,7,40.5,17,4,17,5.6
5.3,44.315,41,23.3,38.476,39,256.39,20,19,21,25.114,15,6,26.5,11,0,11,10.3
6.5,42.109,38,22.488,36.92,37,258.36,18,19,20,23.807,14,4,26.5,12,1,11,10.8
5.3,33.863,32,19.908,30.269,30,240.29,12,18,20,20.523,13,1,28.0,16,1,16,13.3
5.0,37.325,34,20.842,33.338,33,265.37,15,18,19,22.142,12,3,26.5,13,2,11,9.1
4.0,44.235,40,23.708,39.029,39,273.37,19,20,21,25.017,15,5,27.5,12,2,11,7.7
7.0,34.99,33,20.128,31.378,31,243.29,13,18,20,20.733,13,3,26.5,12,2,11,9.7
5.699,71.987,66,39.152,63.676,63,469.59,29,34,37,40.711,25,10,46.0,15,2,12,7.9
6.94,92.9,87,52.873,82.723,83,632.68,39,44,48,56.563,36,12,61.0,22,3,18,3.6
6.545,78.612,72,43.393,69.887,69,523.64,31,38,41,44.927,28,11,52.0,16,3,12,7.2
6.78,89.763,84,50.68,79.629,80,575.77,37,43,47,53.574,35,11,63.0,24,3,18,6.3
7.38,84.627,78,46.916,75.505,75,567.14,35,40,43,49.336,30,12,55.0,18,5,12,5.3
6.959,76.659,70,41.567,67.854,67,500.62,31,36,39,43.165,27,11,48.0,15,2,12,6.0
6.801,73.987,68,41.152,65.676,65,493.61,29,36,39,42.711,27,10,50.0,16,2,12,7.7
7.456,78.952,72,43.776,70.399,69,541.63,30,39,42,44.864,28,11,53.0,16,3,12,7.2
6.796,71.038,65,39.228,63.414,62,488.56,27,35,38,40.097,25,9,47.0,15,3,12,6.5
5.3,47.651,44,25.235,41.912,42,287.4,21,21,23,26.779,16,8,28.0,8,2,6,7.1
5.1,50.803,47,30.571,46.287,45,523.25,18,27,29,32.523,17,5,37.0,14,3,12,6.7
6.8,39.82,36,21.181,35.145,35,247.33,17,18,19,22.256,13,5,24.0,8,2,6,8.6
5.0,62.231,58,32.529,54.523,55,375.59,29,26,29,35.472,20,12,36.0,12,2,10,5.5
6.32,108.55,100,58.953,96.247,96,682.9,46,50,54,61.989,38,14,69.0,24,6,18,6.3
7.05,74.145,71,41.077,65.509,66,476.7,32,34,39,44.239,27,11,51.0,22,2,20,6.1
5.7,57.621,53,31.163,51.069,51,405.43,26,25,27,34.182,18,12,32.0,8,2,6,3.9
5.102,69.81,64,38.364,61.549,62,430.6,30,32,34,40.83,26,6,45.0,20,2,18,6.5
4.523,55.459,51,32.904,50.342,49,431.5,19,30,32,33.756,21,3,44.0,21,3,18,6.1
8.043,72.73,67,39.717,65.076,64,483.58,29,35,38,40.892,24,9,47.5,18,6,17,7.8
4.523,65.705,60,37.484,58.992,58,473.59,25,33,35,39.04,24,5,47.0,21,3,18,5.2
4.0,40.401,38,22.752,35.491,36,251.36,17,19,21,24.347,16,3,28.0,13,0,12,8.3
8.921,90.102,84,50.518,80.836,80,600.73,36,44,48,52.387,33,11,62.0,23,7,18,5.0
8.328,89.976,85,51.298,80.727,80,609.74,35,45,50,53.176,34,10,65.5,27,6,23,6.3
4.523,70.361,66,40.431,62.927,63,495.72,29,34,37,43.574,26,7,49.0,21,3,18,4.8
9.78,87.676,79,45.228,76.614,77,508.74,40,37,39,48.341,28,13,48.5,18,3,17,7.8
4.0,38.116,36,22.127,34.011,34,273.39,15,19,21,23.688,14,4,27.5,12,1,11,8.8
5.58,95.612,88,52.338,85.629,84,640.75,38,46,50,53.784,33,15,61.0,17,7,12,4.8
7.886,84.738,77,46.559,75.97,74,586.66,32,42,45,47.296,28,11,57.0,18,6,12,8.1
9.515,66.896,63,36.761,59.538,59,437.55,27,32,36,38.222,23,10,45.0,17,4,16,8.5
4.81,92.276,85,50.403,82.192,81,609.74,37,44,48,52.12,32,14,59.0,17,5,12,6.2
5.827,80.742,75,45.516,72.767,71,568.63,30,41,45,46.284,29,11,56.0,17,6,12,5.6
7.699,91.248,84,51.434,81.788,80,638.72,34,46,50,52.535,34,11,63.0,22,4,18,5.0
4.0,41.611,39,23.467,36.818,37,267.36,17,20,22,24.801,16,4,29.0,13,1,12,8.1
5.824,91.273,83,48.5,80.421,80,567.75,39,41,44,50.972,31,14,54.0,16,3,12,6.3
6.155,86.572,79,47.57,77.534,76,584.68,34,42,45,48.807,30,12,56.0,17,6,12,5.3
8.125,78.821,72,43.108,70.214,69,527.63,31,38,41,44.381,27,10,51.0,16,4,12,7.2
5.155,72.94,68,42.032,64.734,65,480.63,29,36,39,44.313,30,4,53.0,26,1,24,6.2
8.068,68.106,63,37.476,60.865,60,453.55,27,33,36,38.676,23,8,45.5,18,5,17,8.3
4.0,41.611,39,23.467,36.818,37,267.36,17,20,22,24.801,16,4,29.0,13,1,12,8.1
6.509,87.569,81,47.667,77.763,77,566.71,36,41,45,49.66,31,14,55.0,16,4,12,5.2
7.578,59.813,55,31.321,52.345,53,340.51,28,25,27,33.819,21,10,33.0,12,2,12,3.8
7.77,82.237,75,44.635,73.098,72,541.66,33,39,42,46.142,28,11,52.0,16,4,12,6.9
7.1,36.279,34,20.434,32.153,32,242.31,14,18,20,21.284,13,3,26.5,12,1,11,12.5
4.523,63.115,60,38.851,57.276,57,489.66,23,34,37,41.29,26,2,52.0,27,3,24,5.3
4.0,38.116,36,22.127,34.011,34,273.39,15,19,21,23.688,14,4,27.5,12,1,11,8.8
8.24,36.906,35,21.412,32.683,33,257.39,15,18,20,23.233,14,3,26.5,12,0,11,9.1
5.3,44.524,40,23.015,38.803,39,260.38,20,19,20,24.569,14,6,25.0,8,1,6,10.3
6.409,94.933,87,51.572,84.603,84,604.77,40,44,47,53.909,33,14,60.0,19,7,12,4.8
7.02,39.694,37,21.961,35.036,35,256.34,16,19,21,23.046,14,4,27.5,12,1,11,11.4
5.928,93.723,86,50.857,83.276,83,588.77,40,43,46,53.455,33,14,59.0,19,6,12,4.8
5.796,96.142,88,52.286,85.93,85,620.77,40,45,48,54.364,33,14,61.0,19,8,12,4.7
5.28,88.182,81,48.11,78.283,78,559.73,37,41,44,50.483,31,12,57.0,19,5,12,6.4
5.991,83.64,77,46.363,74.29,74,542.7,34,40,43,48.512,30,11,57.0,19,4,12,8.1
5.3,38.777,36,21.456,34.254,34,257.33,15,19,21,22.29,13,4,27.5,12,1,11,14.7
6.47,38.568,36,21.741,33.927,34,253.34,15,19,21,22.836,14,3,28.0,13,0,12,14.7
4.0,43.919,40,24.923,39.131,38,320.35,15,23,25,25.165,16,4,32.0,13,0,12,10.5
5.3,37.694,34,19.961,33.036,33,232.32,16,17,18,21.046,12,4,23.0,8,1,6,12.1
4.0,40.321,38,22.939,35.567,36,271.42,17,19,21,24.995,15,4,27.5,12,0,11,8.3
5.3,39.694,37,21.961,35.036,35,256.34,16,19,21,23.046,14,4,27.5,12,1,11,11.4
5.71,35.903,34,19.73,31.389,32,212.32,16,16,18,21.341,14,5,23.5,11,0,11,6.3
5.407,96.222,88,51.878,85.378,85,603.79,41,44,47,54.461,33,14,60.0,19,6,12,5.9
5.3,41.109,37,21.488,35.92,36,246.35,18,18,19,22.807,13,5,24.0,8,1,6,11.1
7.076,90.457,84,52.322,81.41,80,671.62,34,46,50,54.375,34,11,63.0,22,4,18,5.0
6.594,87.861,80,47.876,78.309,77,583.7,35,42,45,49.358,30,12,56.0,17,5,12,6.5
7.1,38.196,36,21.94,33.934,34,253.33,15,19,21,23.04,15,3,28.0,13,1,12,8.8
5.26,94.016,86,51.066,83.821,83,605.76,39,44,47,53.154,32,13,60.0,19,7,12,6.0
5.497,89.391,82,48.825,79.61,79,575.73,37,42,45,50.938,31,12,58.0,19,6,12,6.3
4.347,98.716,90,51.997,86.708,87,588.83,44,43,46,55.319,33,15,58.0,18,4,12,6.9
7.174,86.233,79,47.186,77.021,76,566.69,35,41,44,48.87,30,12,55.0,17,6,12,5.3
5.804,97.431,89,52.593,86.705,86,619.79,41,45,48,54.915,33,14,61.0,19,7,12,5.8
9.0,37.196,35,20.94,32.934,33,241.32,15,18,20,22.04,14,3,26.5,12,1,11,9.1
6.367,94.316,86,50.226,83.312,83,581.77,41,42,45,52.938,33,16,55.0,16,4,12,3.6
7.237,83.869,76,46.227,75.156,73,588.65,31,42,45,46.779,28,10,56.0,17,5,12,8.2
6.387,83.446,76,45.35,74.425,73,557.66,33,40,43,46.597,28,11,53.0,16,5,12,6.8
6.215,82.11,75,45.415,72.989,72,550.67,32,40,43,46.932,29,11,55.0,17,3,12,8.3
5.513,96.222,88,51.878,85.378,85,603.79,41,44,47,54.461,33,14,60.0,19,6,12,5.9
6.62,87.858,80,46.974,77.538,77,553.72,37,40,43,49.211,30,13,53.0,16,3,12,6.5
6.796,90.901,83,48.699,80.428,80,567.74,39,41,44,51.177,32,15,54.0,16,4,12,3.8
6.668,85.972,79,46.395,75.956,76,531.72,37,39,42,49.029,30,12,54.0,18,4,12,6.6
6.092,91.273,83,48.5,80.421,80,567.75,39,41,44,50.972,31,14,54.0,16,3,12,6.3
6.807,96.806,90,54.351,86.494,86,637.8,39,47,51,56.699,36,11,67.0,25,6,18,5.8
6.959,89.308,82,48.33,79.392,79,562.73,38,41,44,50.694,31,13,55.0,17,6,12,5.1
5.835,91.276,83,49.403,81.192,80,597.73,37,43,46,51.12,31,13,57.0,17,5,12,6.3
6.796,89.684,82,49.034,80.156,79,592.72,36,43,46,50.637,30,12,59.0,19,7,12,7.6
6.17,38.777,36,21.456,34.254,34,257.33,15,19,21,22.29,13,4,27.5,12,1,11,14.7
6.602,84.157,78,47.043,75.65,74,582.66,32,42,46,48.046,30,12,57.0,17,6,12,5.4
6.658,82.659,75,45.513,73.829,72,572.65,31,41,44,46.324,28,10,55.0,17,4,12,8.3
4.0,37.279,35,21.434,33.153,33,254.32,14,19,21,22.284,14,3,28.0,13,1,12,12.1
6.31,85.363,79,46.855,76.207,75,568.68,34,41,45,48.353,30,13,55.0,16,5,12,5.3
7.114,89.308,82,48.33,79.392,79,562.73,38,41,44,50.694,31,13,55.0,17,6,12,5.1
6.276,85.972,79,46.395,75.956,76,531.72,37,39,42,49.029,30,12,54.0,18,4,12,6.6
7.032,84.067,77,44.743,73.89,74,509.7,37,37,40,47.506,30,14,49.0,15,2,12,4.1
5.77,88.565,81,47.764,77.992,78,548.74,38,40,43,50.512,32,15,54.0,16,2,12,5.1
6.824,81.323,74,45.032,73.087,71,572.63,30,41,44,45.534,27,10,56.0,18,6,12,8.5
6.988,47.524,44,26.015,41.803,42,296.41,20,22,24,27.569,17,4,31.0,13,1,12,9.5
7.14,54.113,50,29.39,48.458,48,345.43,23,25,27,30.654,19,7,33.0,12,5,12,2.1
8.785,67.524,64,37.96,60.545,60,449.55,27,33,37,39.426,25,10,46.0,15,5,12,5.0
4.523,30.78,28,16.413,27.051,27,191.26,13,14,15,17.279,10,3,20.0,10,1,10,11.1
7.69,67.147,63,36.804,59.396,60,404.57,30,30,33,39.409,26,8,42.0,18,3,18,1.7
7.2,59.109,56,33.487,52.687,53,375.5,25,28,31,35.506,24,6,40.0,18,3,18,1.9
6.59,62.524,59,35.014,55.571,56,389.53,27,29,32,37.267,25,7,41.0,18,3,18,1.8
9.1,70.773,65,38.497,62.992,63,437.58,31,32,34,40.699,26,8,43.0,18,5,18,1.6
7.72,60.734,57,32.729,53.898,54,369.5,27,27,30,34.722,22,10,36.0,12,4,12,1.9
6.43,67.149,64,37.256,59.781,60,419.56,29,31,35,39.483,26,10,43.5,17,4,17,1.7
7.97,63.216,60,36.347,56.651,56,453.97,24,32,36,37.864,23,7,46.0,18,3,16,8.9
7.119,79.511,72,42.961,71.174,69,562.66,31,38,41,44.108,26,14,49.0,14,4,12,2.9
6.54,83.117,76,44.053,73.847,73,538.72,36,37,40,46.512,27,15,48.0,14,5,12,2.7
6.83,85.852,79,44.813,75.705,76,516.77,40,36,39,48.398,28,16,47.0,14,5,12,2.6
9.51,66.738,63,37.786,59.767,59,516.44,26,33,37,39.574,23,10,46.0,17,4,16,8.5
7.086,78.757,74,42.872,69.934,70,519.16,35,35,39,46.279,27,15,47.0,14,4,12,2.9
6.561,77.607,74,42.233,69.054,69,498.7,34,35,40,45.114,27,15,48.0,14,5,12,2.9
8.5,68.185,64,37.068,60.312,60,436.57,28,32,36,38.773,23,10,45.0,17,3,16,10.0
6.832,85.852,79,44.813,75.705,76,516.77,40,36,39,48.398,28,16,47.0,14,5,12,2.6
6.328,77.283,71,41.096,68.309,68,492.69,34,34,37,43.841,26,14,45.0,14,3,12,2.9
6.153,78.776,72,43.022,70.472,69,561.12,32,37,40,45.091,26,14,48.0,14,4,12,2.9
5.828,86.192,79,45.196,76.218,76,534.76,39,37,40,48.336,28,16,48.0,14,5,12,2.6
6.717,74.769,69,39.319,65.72,66,458.69,34,32,35,42.455,24,13,43.0,14,3,12,6.1
6.572,79.394,73,41.561,69.93,70,488.72,36,34,37,44.671,25,14,45.0,14,4,12,5.7
6.752,75.574,70,41.479,67.149,67,526.58,33,34,37,44.926,25,13,45.0,14,3,12,4.5
6.955,75.686,70,39.824,66.501,67,457.7,35,32,35,43.211,25,13,43.0,14,3,12,4.5
6.963,84.936,78,44.308,74.923,75,517.76,39,36,39,47.642,27,15,47.0,14,5,12,4.0
6.146,80.651,74,42.449,71.225,71,505.72,36,35,38,45.364,26,14,46.0,14,4,12,4.2
5.902,81.33,74,43.216,72.25,71,541.7,34,37,40,45.239,26,14,48.0,14,4,12,4.2
6.225,75.574,70,41.479,67.149,67,526.58,33,34,37,44.926,25,13,45.0,14,3,12,4.5
6.458,75.97,70,41.035,67.338,67,510.13,33,34,37,44.006,25,13,45.0,14,3,12,4.5
6.79,83.726,77,43.593,73.596,74,501.76,39,35,38,47.188,27,15,46.0,14,4,12,4.1
5.732,75.97,70,41.035,67.338,67,510.13,33,34,37,44.006,25,13,45.0,14,3,12,4.5
5.8,70.276,65,37.967,62.17,62,439.58,30,32,35,39.978,25,11,43.0,14,3,12,4.8
6.987,76.026,70,40.208,67.014,67,475.69,34,33,36,43.148,25,13,44.0,14,3,12,4.5
5.0,37.013,36,22.547,33.149,33,284.77,13,20,23,23.688,15,3,31.0,16,0,16,12.1
6.488,66.034,60,34.834,58.363,58,405.53,29,29,31,36.665,23,11,37.0,12,3,12,1.7
5.0,33.697,32,18.918,29.833,30,214.29,14,16,18,20.034,13,4,23.5,11,1,11,6.7
5.959,78.763,73,41.735,68.654,70,443.69,37,33,36,45.415,29,15,45.0,14,1,12,4.3
7.56,66.859,63,37.728,59.531,60,435.63,29,31,34,40.676,26,8,43.0,18,3,18,1.7
6.323,77.735,71,40.711,68.225,68,472.64,34,34,37,42.989,26,13,44.0,13,2,12,5.9
5.0,41.74,39,23.369,37.222,37,291.41,17,20,22,24.904,14,5,29.5,13,2,11,8.1
5.921,78.319,72,43.184,69.341,69,506.65,32,37,40,45.228,29,12,51.0,16,2,12,5.8
7.337,94.225,88,52.835,84.174,84,609.78,39,45,49,55.449,36,12,64.0,24,6,18,3.6
5.0,37.069,36,21.72,32.825,33,250.33,14,19,22,22.83,15,3,30.0,16,0,16,12.1
5.0,40.484,39,23.246,35.709,36,264.36,16,20,23,24.591,16,4,31.0,16,0,16,11.1
8.158,62.693,61,36.685,56.302,56,448.59,24,32,37,38.648,24,9,47.0,18,3,16,7.1
5.0,35.78,35,21.413,32.051,32,251.31,13,19,22,22.279,15,3,30.0,16,1,16,9.4
7.52,71.196,67,39.154,63.247,63,471.65,30,33,37,41.625,25,11,47.0,18,3,16,4.8
9.4,36.405,33,19.655,32.262,32,233.3,15,17,18,20.495,12,4,23.0,8,2,6,9.4
6.0,54.916,52,31.981,49.269,49,499.41,22,27,30,35.301,19,7,38.0,14,3,12,6.1
8.18,79.763,74,42.735,69.654,71,455.7,37,34,37,46.415,30,11,47.0,19,1,18,4.2
5.699,75.348,70,40.208,65.77,67,429.66,35,32,35,43.654,28,14,44.0,14,1,12,4.5
6.559,84.098,78,45.67,74.09,75,498.72,38,37,40,49.08,32,12,51.0,20,3,18,2.7
6.018,74.687,68,39.591,65.283,66,435.64,34,32,34,42.591,27,13,43.0,14,1,12,4.5
6.4,70.453,63,36.755,62.298,61,454.55,29,32,34,37.858,22,12,40.0,9,3,6,6.6
8.086,64.647,59,33.277,56.883,57,374.53,30,27,29,35.489,21,13,34.0,8,4,6,3.5
7.0,60.887,54,32.941,54.672,52,448.44,21,31,33,32.449,19,9,39.0,9,3,6,7.7
4.0,44.398,41,23.795,38.694,39,269.39,19,20,22,25.358,15,5,28.5,12,0,11,12.8
6.8,65.172,58,34.8,58.37,56,460.48,24,32,34,34.728,20,10,40.0,9,4,6,7.1
6.155,91.517,84,50.045,81.72,81,590.74,38,43,46,52.148,32,13,59.0,19,7,12,4.9
5.0,72.189,65,36.515,63.156,63,420.59,33,30,32,38.745,22,14,37.0,8,3,6,6.3
5.726,47.072,44,26.401,41.887,42,316.46,20,22,24,28.421,17,6,30.5,12,2,11,4.8
5.854,70.72,66,40.007,63.611,63,505.08,29,34,37,42.449,25,11,47.0,16,5,12,3.2
5.699,60.82,57,33.905,54.411,54,415.56,25,29,32,35.858,21,9,41.0,15,4,12,5.6
7.26,94.225,88,52.835,84.174,84,609.78,39,45,49,55.449,36,12,64.0,24,6,18,3.6
4.0,36.665,33,20.225,32.851,32,271.35,14,18,19,21.08,11,4,25.0,9,2,6,9.4
6.495,74.327,68,41.535,66.189,65,511.6,28,37,40,42.648,27,10,51.0,16,2,12,7.7
5.523,68.94,63,37.487,61.429,61,439.56,29,32,34,39.188,24,10,44.0,16,5,12,4.9
4.699,80.193,75,45.418,71.927,71,546.65,31,40,44,46.892,30,9,56.0,21,5,18,5.6
5.888,75.027,68,39.974,65.796,66,453.63,33,33,35,42.529,27,13,44.0,14,1,12,4.5
5.699,77.403,71,42.678,68.559,68,507.64,31,37,40,44.472,28,12,51.0,16,2,12,7.4
7.218,68.517,62,35.1,59.978,60,401.57,31,29,31,37.29,21,11,37.0,9,3,6,8.3
5.301,64.231,60,34.529,56.523,57,399.61,29,28,31,37.472,22,11,37.5,12,2,11,5.3
8.424,69.232,64,38.241,61.28,61,449.58,28,33,36,40.012,25,8,46.0,16,2,12,8.2
5.699,77.403,71,42.678,68.559,68,507.64,31,37,40,44.472,28,12,51.0,16,2,12,7.4
6.967,70.86,67,39.674,63.505,63,483.64,29,34,38,41.835,25,11,48.0,16,5,12,4.8
4.0,38.196,36,21.94,33.934,34,253.33,15,19,21,23.04,15,3,28.0,13,1,12,8.8
7.309,72.877,66,38.454,64.185,64,462.05,32,32,34,40.909,23,12,41.0,10,3,6,7.8
5.7,47.939,43,24.542,41.687,42,274.41,22,20,21,26.33,15,7,26.0,8,1,6,9.5
4.523,65.189,60,37.025,58.109,58,430.55,26,32,34,38.762,25,5,46.0,18,3,12,6.9
6.211,74.477,69,39.11,65.174,66,441.7,35,31,34,42.756,25,14,40.5,12,2,11,4.5
5.351,70.434,65,36.605,61.76,62,412.59,32,30,33,39.046,23,13,39.5,12,3,11,6.5
6.041,72.355,66,39.013,64.312,64,453.59,31,33,35,40.949,25,11,45.0,16,5,12,4.7
6.244,82.972,77,45.449,72.981,74,495.72,37,37,40,48.87,32,12,52.0,20,2,18,4.1
7.91,69.355,65,38.068,61.338,62,417.59,31,31,34,40.79,27,9,43.0,18,3,18,1.6
7.8,35.617,34,21.106,31.909,32,258.37,14,18,20,22.682,14,3,26.5,12,1,11,6.3
7.1,54.069,51,30.665,48.567,48,367.44,21,27,30,31.688,20,6,39.0,17,4,16,6.3
9.605,66.896,63,36.761,59.538,59,437.55,27,32,36,38.222,23,10,45.0,17,4,16,8.5
5.699,76.327,70,43.535,68.189,67,535.62,28,39,42,44.648,29,11,55.0,17,2,12,7.5
4.523,73.361,69,43.431,65.927,66,531.75,29,37,40,46.574,29,4,55.0,27,3,24,4.5
5.921,70.932,65,37.681,61.887,63,403.62,33,30,32,40.893,26,12,41.0,14,1,12,4.8
6.387,84.153,78,46.14,74.879,74,552.68,34,40,44,47.898,30,13,54.0,16,4,12,5.4
8.354,67.896,63,37.761,60.538,60,449.56,27,33,36,39.222,24,8,46.5,19,4,17,8.3
10.4,67.149,63,37.256,59.781,60,419.56,29,31,34,39.483,26,8,43.0,18,4,18,1.7
6.167,74.687,68,39.591,65.283,66,435.64,34,32,34,42.591,27,13,43.0,14,1,12,4.5
6.0,66.185,63,37.122,58.338,59,412.58,28,31,35,39.614,26,8,46.0,22,1,22,6.8
7.289,68.358,64,37.971,61.109,61,435.56,29,32,35,39.938,26,8,44.0,18,5,18,1.6
8.55,66.149,61,36.256,58.781,59,407.55,29,30,32,38.483,25,7,41.0,18,4,18,1.7
6.423,61.687,56,32.046,54.211,54,373.51,27,27,29,33.767,19,10,35.0,9,3,6,9.3
6.481,74.904,69,41.657,66.458,66,492.62,30,36,39,43.466,28,11,50.0,16,2,12,6.1
8.7,71.983,66,39.212,64.32,64,453.58,31,33,35,41.154,26,8,44.0,18,6,18,1.6
5.721,82.782,76,45.884,73.192,73,533.69,34,39,42,48.228,32,12,54.0,20,1,18,4.1
6.521,76.026,70,40.208,67.014,67,475.69,34,33,36,43.148,25,13,44.0,14,3,12,4.5
6.883,80.153,74,43.091,70.941,71,566.62,36,35,38,46.779,26,14,46.0,14,4,12,4.2
6.487,91.766,84,47.361,80.69,81,545.82,43,38,41,51.165,29,17,49.0,14,5,12,3.7
7.071,82.813,76,43.99,73.585,73,532.73,36,37,40,46.58,26,14,50.0,16,6,12,5.5
6.456,87.861,81,47.876,78.309,77,583.7,35,42,46,49.358,30,14,56.0,16,5,12,6.5
8.89,74.145,71,41.077,65.509,66,476.7,32,34,39,44.239,27,11,51.0,22,2,20,6.1
8.921,78.351,72,42.056,69.516,69,495.64,33,36,39,43.961,26,11,48.5,18,5,17,7.2
9.27,67.358,62,36.971,60.109,60,423.55,29,31,33,38.938,25,7,42.0,18,5,18,1.7
5.7,57.059,54,33.678,51.6,51,452.04,22,29,32,36.148,20,6,42.0,18,3,16,5.9
6.774,69.142,64,35.396,60.214,61,383.59,33,28,31,38.347,23,15,36.0,8,2,6,4.9
5.783,86.683,81,48.088,77.181,77,556.72,36,41,45,50.478,32,11,57.0,21,5,18,5.2
6.757,66.361,62,36.652,59.403,59,444.6,28,31,34,38.83,23,10,43.0,15,5,12,3.4
8.879,67.521,64,37.057,59.774,60,419.57,29,31,35,39.279,25,11,43.0,14,3,12,5.0
7.239,65.671,61,34.697,57.654,58,404.0,30,28,31,37.444,22,14,36.0,8,2,6,5.2
7.44,107.341,99,58.238,94.919,95,666.9,46,49,53,61.535,38,14,68.0,24,5,18,6.3
8.509,59.773,57,33.498,53.225,53,392.5,24,29,33,35.0,22,9,41.0,14,3,12,7.5
5.3,47.939,43,24.542,41.687,42,274.41,22,20,21,26.33,15,7,26.0,8,1,6,9.5
5.699,77.431,72,42.702,67.989,69,466.68,34,35,38,45.898,30,11,50.0,20,1,18,5.8
7.432,67.444,64,38.147,60.622,60,469.61,27,33,37,40.074,24,10,47.0,16,5,12,5.0
6.678,89.861,83,49.876,80.309,79,607.72,35,44,48,51.358,32,14,60.0,17,5,12,6.3
7.444,89.861,83,49.876,80.309,79,607.72,35,44,48,51.358,32,14,60.0,17,5,12,6.3
7.16,39.404,37,22.434,34.785,35,272.41,16,19,21,24.239,14,4,27.5,12,0,11,11.4
8.265,64.481,60,36.234,57.654,57,435.53,25,32,35,37.46,23,7,45.5,19,4,17,8.8
7.0,75.244,69,42.04,66.97,66,510.61,29,37,40,43.404,28,11,51.0,16,2,12,6.1
7.638,76.348,71,41.208,66.77,68,441.67,35,33,36,44.654,29,10,46.0,19,1,18,4.4
5.699,79.742,73,45.062,71.072,70,549.65,30,40,43,46.41,30,12,56.0,17,2,12,7.1
7.26,94.225,88,52.835,84.174,84,609.78,39,45,49,55.449,36,12,64.0,24,6,18,3.6
7.469,89.984,82,48.194,79.647,79,568.73,38,41,44,50.421,31,14,54.0,16,4,12,5.1
5.699,79.403,73,44.678,70.559,70,531.66,31,39,42,46.472,30,12,55.0,17,2,12,7.1
6.131,44.33,44,29.174,40.709,40,421.27,13,27,31,30.091,20,0,44.5,26,2,25,10.0
6.37,60.528,57,33.917,54.342,54,395.49,25,29,32,35.415,23,7,40.5,17,5,17,1.9
5.481,68.94,63,37.487,61.429,61,439.56,29,32,34,39.188,24,10,44.0,16,5,12,4.9
5.523,69.853,64,37.089,61.44,62,408.59,32,30,32,39.796,25,11,40.0,14,3,12,3.2
7.432,74.161,68,40.546,65.752,65,485.6,30,35,38,42.16,27,11,47.0,15,2,12,4.6
7.066,82.539,75,43.931,73.578,72,557.7,34,38,41,45.694,26,14,49.0,14,5,12,4.2
8.94,66.859,63,37.728,59.531,60,435.63,29,31,34,40.676,26,8,43.0,18,3,18,1.7
7.036,81.041,75,43.909,72.476,71,554.69,33,38,42,45.688,27,15,50.0,14,5,12,2.8
7.07,55.903,53,31.675,50.131,50,365.46,23,27,30,33.199,22,6,38.5,17,4,17,2.0
5.3,44.524,40,23.015,38.803,39,260.38,20,19,20,24.569,14,6,25.0,8,1,6,10.3
7.425,63.116,59,34.503,55.876,56,423.42,28,28,31,37.296,22,14,36.0,8,2,6,3.6
5.699,75.987,70,43.152,67.676,67,517.63,29,38,41,44.711,29,11,54.0,17,2,12,7.5
5.511,75.138,69,38.439,65.418,66,425.64,35,31,34,41.358,24,14,40.5,12,2,11,7.6
9.036,60.634,58,34.831,54.331,54,425.95,24,30,34,36.614,23,9,42.0,14,3,12,5.6
5.699,78.348,73,43.208,68.77,70,465.69,35,35,38,46.654,31,11,50.0,20,1,18,4.3
4.0,45.315,42,24.3,39.476,40,268.4,20,20,22,26.114,16,5,28.5,12,0,11,10.0
6.666,78.776,72,43.022,70.472,69,561.12,32,37,40,45.091,26,14,48.0,14,4,12,2.9
6.244,81.972,76,44.449,71.981,73,483.71,37,36,39,47.87,31,11,50.0,20,2,18,4.1
6.553,78.292,73,44.035,69.094,70,500.13,34,36,39,47.512,31,11,51.0,20,1,18,4.3
8.91,68.149,64,38.256,60.781,61,431.57,29,32,35,40.483,27,8,45.0,19,4,18,1.6
8.103,65.517,61,34.154,57.003,58,365.57,31,27,30,37.131,23,12,36.0,12,1,12,5.2
5.71,91.308,85,50.33,81.392,81,586.75,38,43,47,52.694,33,12,59.0,21,6,18,4.9
5.77,72.355,66,39.013,64.312,64,453.59,31,33,35,40.949,25,11,45.0,16,5,12,4.7
8.996,57.195,55,32.664,51.2,51,397.54,23,28,32,34.642,21,9,39.5,13,3,11,5.9
7.815,68.73,65,37.772,61.101,61,435.57,29,32,36,39.733,25,11,44.0,14,4,12,4.9
7.495,86.944,79,47.371,77.527,76,584.69,34,42,45,48.603,29,11,56.0,17,5,12,7.9
5.959,62.991,58,33.109,55.472,55,391.51,27,28,31,34.699,21,13,36.0,8,2,6,5.5
5.0,35.78,35,21.413,32.051,32,251.31,13,19,22,22.279,15,3,30.0,16,1,16,9.4
6.03,94.723,88,51.857,84.276,84,600.78,40,44,48,54.455,34,13,60.0,21,6,18,4.8
6.659,95.514,89,53.142,84.949,85,608.8,40,45,49,56.0,36,12,64.0,24,5,18,4.7
5.854,35.78,35,21.413,32.051,32,251.31,13,19,22,22.279,15,3,30.0,16,1,16,9.4
5.0,37.069,36,21.72,32.825,33,250.33,14,19,22,22.83,15,3,30.0,16,0,16,12.1
6.0,51.694,48,27.961,45.803,46,313.43,23,23,25,29.745,19,7,31.0,12,3,12,2.2
5.0,29.073,28,16.677,25.622,26,184.26,12,14,16,17.818,12,3,21.5,11,0,11,7.7
5.959,29.017,28,17.504,25.945,26,218.7,11,15,17,18.676,12,3,22.5,11,0,11,7.7
6.6,44.524,40,23.015,38.803,39,260.38,20,19,20,24.569,14,6,25.0,8,1,6,10.3
6.57,56.318,52,30.202,50.014,50,343.46,25,25,27,31.961,20,8,33.0,12,4,12,2.0
6.668,129.763,123,68.57,115.879,115,795.02,58,57,65,71.989,44,32,72.0,10,13,6,0.0
6.2,69.422,66,41.159,62.207,62,500.04,26,36,40,43.171,28,5,53.0,22,2,18,8.1
6.25,72.837,69,42.686,65.091,65,514.07,28,37,41,44.932,29,6,54.0,22,2,18,7.7
5.84,72.837,69,42.686,65.091,65,514.07,28,37,41,44.932,29,6,54.0,22,2,18,7.7
5.0,32.432,31,19.031,28.829,29,232.73,13,16,18,20.438,13,4,23.5,11,0,11,6.9
5.0,29.073,28,16.677,25.622,26,184.26,12,14,16,17.818,12,3,21.5,11,0,11,7.7
5.0,48.026,46,27.993,42.702,43,317.42,19,24,27,29.563,20,4,36.5,18,1,17,7.0
5.0,30.156,29,18.171,26.84,27,209.27,11,16,18,19.063,13,3,25.5,12,0,11,11.1
5.0,32.488,31,18.204,28.505,29,198.29,14,15,17,19.58,13,4,22.5,11,0,11,6.9
6.004,36.12,35,21.796,32.563,32,269.3,12,20,23,22.216,15,3,31.0,16,1,16,9.4
5.0,37.409,36,22.103,33.338,33,268.32,13,20,23,22.767,15,3,31.0,16,0,16,12.1
5.0,37.112,35,20.445,32.716,33,228.32,16,17,19,21.796,14,5,24.5,11,1,11,6.1
5.0,37.112,35,20.445,32.716,33,228.32,16,17,19,21.796,14,5,24.5,11,1,11,6.1
5.0,40.528,38,21.972,35.6,36,242.35,18,18,20,23.557,15,6,25.5,11,1,11,5.6
5.0,32.488,31,18.204,28.505,29,198.29,14,15,17,19.58,13,4,22.5,11,0,11,6.9
5.0,32.432,31,19.031,28.829,29,232.73,13,16,18,20.438,13,4,23.5,11,0,11,6.9
5.0,37.112,35,20.445,32.716,33,228.32,16,17,19,21.796,14,5,24.5,11,1,11,6.1
5.924,51.488,50,29.149,46.247,46,339.42,21,25,29,30.438,20,8,35.0,12,4,12,2.2
5.0,38.409,37,23.103,34.338,34,280.33,13,21,24,23.767,16,3,32.5,17,0,17,11.8
5.0,29.017,28,17.504,25.945,26,218.7,11,15,17,18.676,12,3,22.5,11,0,11,7.7
5.0,30.156,29,18.171,26.84,27,209.27,11,16,18,19.063,13,3,25.5,12,0,11,11.1
6.119,38.986,38,23.225,34.607,35,261.35,15,20,23,24.586,17,3,31.5,17,0,17,8.6
5.0,45.155,42,24.895,40.105,40,305.44,19,21,23,26.665,15,6,30.5,13,2,11,7.5
6.84,55.192,52,29.761,48.429,49,343.54,25,24,27,32.495,19,10,34.0,14,1,14,6.1
6.0,66.102,60,34.573,58.094,58,399.55,29,29,31,36.529,21,10,39.0,16,3,16,8.6
5.0,69.109,63,35.978,60.734,61,401.57,32,29,31,38.489,24,12,37.0,12,3,12,1.6
5.0,37.056,35,21.273,33.04,33,262.76,15,18,20,22.654,14,5,25.5,11,1,11,6.1
6.0,69.517,63,36.1,60.978,61,413.58,31,30,32,38.29,22,11,40.0,16,3,16,8.2
6.02,81.059,76,44.847,71.97,72,514.68,34,38,42,47.262,30,10,53.0,20,4,18,5.6
6.0,57.137,52,31.301,50.509,50,391.92,23,27,29,32.892,19,8,37.0,16,1,16,10.0
6.07,84.474,79,46.374,74.854,75,528.71,36,39,43,49.023,31,11,54.0,20,4,18,5.3
5.48,34.152,32,19.214,30.043,30,227.3,13,17,19,20.074,12,3,25.5,12,0,11,16.7
6.0,51.694,48,27.961,45.803,46,313.43,23,23,25,29.745,19,7,31.0,12,3,12,2.2
6.0,60.943,56,32.444,54.225,54,373.49,27,27,29,34.176,21,9,35.0,12,5,12,1.9
6.0,51.694,48,27.961,45.803,46,313.43,23,23,25,29.745,19,7,31.0,12,3,12,2.2
6.52,56.318,52,30.202,50.014,50,343.46,25,25,27,31.961,20,8,33.0,12,4,12,2.0
6.0,60.943,56,32.444,54.225,54,373.49,27,27,29,34.176,21,9,35.0,12,5,12,1.9
6.0,60.943,56,32.444,54.225,54,373.49,27,27,29,34.176,21,9,35.0,12,5,12,1.9
7.13,67.149,63,37.256,59.781,60,419.56,29,31,34,39.483,26,8,43.0,18,4,18,1.7
6.9,71.773,67,39.497,63.992,64,449.59,31,33,36,41.699,27,9,45.0,18,5,18,1.6
6.92,62.524,59,35.014,55.571,56,389.53,27,29,32,37.267,25,7,41.0,18,3,18,1.8
7.455,67.149,63,37.256,59.781,60,419.56,29,31,34,39.483,26,8,43.0,18,4,18,1.7
6.0,60.943,56,32.444,54.225,54,373.49,27,27,29,34.176,21,9,35.0,12,5,12,1.9
6.6,71.773,67,39.497,63.992,64,449.59,31,33,36,41.699,27,9,45.0,18,5,18,1.6
5.49,30.737,29,17.687,27.16,27,213.27,11,16,18,18.313,11,2,24.5,12,0,11,18.5
6.55,56.318,52,30.202,50.014,50,343.46,25,25,27,31.961,20,8,33.0,12,4,12,2.0
6.85,62.524,59,35.014,55.571,56,389.53,27,29,32,37.267,25,7,41.0,18,3,18,1.8
6.7,70.856,66,38.771,62.734,63,453.66,31,32,35,41.688,25,10,45.5,19,3,17,4.8
7.866,62.322,59,36.261,55.64,55,472.42,23,32,36,38.063,22,7,46.0,18,1,16,12.7
6.07,91.308,85,50.33,81.392,81,586.75,38,43,47,52.694,33,12,59.0,21,6,18,4.9
6.456,77.699,72,43.791,69.876,68,554.61,28,40,44,44.318,27,9,55.0,17,5,12,8.8
5.0,36.12,35,21.796,32.563,32,269.3,12,20,23,22.216,15,3,31.0,16,1,16,9.4
5.9,87.893,82,48.803,78.509,78,572.72,36,42,46,50.932,32,11,58.0,21,6,18,5.1
5.0,32.432,31,19.031,28.829,29,232.73,13,16,18,20.438,13,4,23.5,11,0,11,6.9
6.921,84.738,80,48.613,75.996,75,586.69,32,43,48,50.137,33,10,61.0,22,4,18,5.3
5.0,38.409,37,23.103,34.338,34,280.33,13,21,24,23.767,16,3,32.5,17,0,17,11.8
6.0,61.478,56,32.331,53.883,54,369.52,27,27,29,34.313,20,9,37.0,16,2,16,9.3
5.0,38.409,37,23.103,34.338,34,280.33,13,21,24,23.767,16,3,32.5,17,0,17,11.8
5.0,33.697,32,18.918,29.833,30,214.29,14,16,18,20.034,13,4,23.5,11,1,11,6.7
5.0,37.409,36,22.103,33.338,33,268.32,13,20,23,22.767,15,3,31.0,16,0,16,12.1
5.0,37.409,36,22.103,33.338,33,268.32,13,20,23,22.767,15,3,31.0,16,0,16,12.1
6.469,84.157,78,47.043,75.65,74,582.66,32,42,46,48.046,30,12,57.0,17,6,12,5.4
7.807,62.378,59,35.433,55.316,55,437.98,24,31,35,37.205,22,7,45.0,18,1,16,12.7
5.0,37.409,36,22.103,33.338,33,268.32,13,20,23,22.767,15,3,31.0,16,0,16,12.1
5.752,29.412,28,17.06,26.134,26,202.25,11,15,17,17.756,12,3,22.5,11,0,11,7.7
5.0,37.112,35,20.445,32.716,33,228.32,16,17,19,21.796,14,5,24.5,11,1,11,6.1
5.0,39.903,39,23.73,35.389,36,260.36,16,20,23,25.341,18,3,31.5,17,0,17,5.6
5.0,38.986,38,23.225,34.607,35,261.35,15,20,23,24.586,17,3,31.5,17,0,17,8.6
5.187,38.069,37,22.72,33.825,34,262.34,14,20,23,23.83,16,3,31.5,17,0,17,11.8
5.0,49.155,47,28.895,44.105,44,353.48,19,25,28,30.665,19,4,38.5,19,2,17,6.8
7.18,73.64,68,38.417,64.316,65,422.63,34,31,34,41.353,25,13,41.0,13,2,12,6.2
6.301,66.034,60,34.834,58.363,58,405.53,29,29,31,36.665,23,11,37.0,12,3,12,1.7
6.26,63.619,58,34.308,56.48,56,403.51,27,29,31,35.904,23,10,38.0,13,3,12,1.8
6.678,75.493,70,42.979,68.32,66,556.58,26,40,44,43.012,26,9,56.0,18,6,12,9.1
6.58,56.318,52,30.202,50.014,50,343.46,25,25,27,31.961,20,8,33.0,12,4,12,2.0
6.0,51.694,48,27.961,45.803,46,313.43,23,23,25,29.745,19,7,31.0,12,3,12,2.2
6.8,75.271,71,41.298,66.618,67,479.7,33,34,38,44.449,27,12,48.5,19,3,17,4.5
7.1,67.378,60,35.612,59.927,58,458.51,26,32,34,36.035,21,11,40.0,9,3,6,6.9
5.8,73.351,68,39.111,64.541,65,435.62,33,32,35,41.802,26,12,43.0,14,3,12,4.6
5.6,72.766,66,36.637,63.425,64,401.61,35,29,31,39.563,23,15,36.0,8,3,6,4.7
5.5,71.276,67,38.967,63.17,63,451.59,30,33,37,40.978,26,12,45.0,14,3,12,4.8
6.492,73.64,68,38.417,64.316,65,422.63,34,31,34,41.353,25,13,41.0,13,2,12,6.2
6.424,82.777,76,43.67,73.334,73,520.73,37,36,39,46.574,27,15,47.0,14,5,12,2.7
7.49,37.321,34,19.939,32.567,33,235.39,17,16,17,21.995,12,5,21.0,7,0,6,9.1
7.18,33.906,31,18.412,29.683,30,221.36,15,15,16,20.233,11,4,20.0,7,0,6,10.0
5.6,70.936,67,38.584,62.658,63,433.6,31,32,36,41.04,26,12,44.0,14,3,12,4.8
5.6,70.88,67,39.411,62.981,63,468.04,30,33,37,41.898,26,12,45.0,14,3,12,4.8
5.7,57.059,54,33.678,51.6,51,452.04,22,29,32,36.148,20,6,42.0,18,3,16,5.9
4.0,35.116,32,19.127,31.011,31,237.36,15,16,17,20.688,11,4,22.0,8,1,6,9.7
6.175,66.936,62,34.584,58.658,59,385.56,31,28,31,37.04,22,14,36.0,8,3,6,5.1
4.0,36.325,33,19.842,32.338,32,253.36,15,17,18,21.142,11,4,24.0,9,2,6,9.4
7.65,76.936,73,42.529,68.632,68,505.63,31,37,42,44.199,27,12,51.5,18,5,17,7.4
7.4,62.706,56,33.196,55.749,54,427.48,24,30,32,33.58,19,10,38.0,9,3,6,9.3
7.866,65.615,61,35.524,57.978,58,438.44,29,29,32,38.301,22,14,37.0,8,2,6,5.2
6.77,40.737,37,21.466,35.451,36,249.42,19,17,18,23.756,13,6,22.0,7,0,6,8.3
6.08,43.155,39,22.895,38.105,38,281.42,19,19,20,24.665,13,6,26.0,9,2,6,7.9
5.0,53.824,51,30.629,47.989,48,351.45,22,26,29,32.228,22,7,38.0,17,2,16,2.1
7.2,68.038,62,36.228,60.414,59,452.53,27,32,35,37.097,22,12,41.0,9,3,6,6.8
7.268,62.991,58,33.109,55.472,55,391.51,27,28,31,34.699,21,13,36.0,8,2,6,5.5
6.8,65.172,58,34.8,58.37,56,460.48,24,32,34,34.728,20,10,40.0,9,4,6,7.1
7.575,65.671,61,34.697,57.654,58,404.0,30,28,31,37.444,22,14,36.0,8,2,6,5.2
6.09,64.757,60,35.094,57.643,57,434.97,27,30,33,36.836,21,13,40.0,10,4,6,7.0
5.7,74.351,70,40.111,65.541,66,447.63,33,33,37,42.802,27,13,45.0,14,3,12,4.5
8.0,67.378,60,35.612,59.927,58,458.51,26,32,34,36.035,21,11,40.0,9,3,6,6.9
6.038,64.615,59,34.524,56.978,57,426.43,29,28,30,37.301,21,13,35.0,8,2,6,5.3
5.0,47.595,45,26.063,42.236,42,321.84,20,22,25,27.637,16,9,29.0,7,2,6,7.1
7.099,58.784,55,32.47,52.211,52,410.38,25,27,30,34.779,20,12,35.0,8,2,6,5.8
8.851,76.936,73,42.529,68.632,68,505.63,31,37,42,44.199,27,12,51.5,18,5,17,7.4
5.6,69.936,65,37.584,61.658,62,421.59,31,31,34,40.04,25,11,42.0,14,3,12,4.8
6.0,48.69,44,24.058,42.032,43,247.42,25,18,19,26.597,16,10,22.0,6,1,6,2.3
9.03,81.767,75,43.583,72.4,72,509.67,35,37,40,45.722,27,12,49.5,18,5,17,6.9
6.886,87.861,81,47.876,78.309,77,583.7,35,42,46,49.358,30,14,56.0,16,5,12,6.5
8.11,63.172,59,33.675,55.552,56,388.98,29,27,30,36.438,22,14,35.0,8,2,6,3.6
7.5,63.623,57,33.702,56.53,55,426.49,25,30,32,34.336,20,10,38.0,9,3,6,7.3
6.6,68.797,61,36.041,61.581,59,478.5,26,33,35,35.944,20,12,40.0,8,5,6,6.8
5.55,62.199,58,33.997,55.094,55,424.41,27,28,31,36.54,21,13,36.0,8,2,6,5.5
9.38,76.936,73,42.529,68.632,68,505.63,31,37,42,44.199,27,12,51.5,18,5,17,7.4
6.8,63.963,57,34.085,57.043,55,444.48,24,31,33,34.273,20,10,39.0,9,3,6,7.3
7.078,58.784,55,32.47,52.211,52,410.38,25,27,30,34.779,20,12,35.0,8,2,6,5.8
7.449,70.142,66,36.396,61.214,62,395.6,33,29,33,39.347,24,16,38.0,8,2,6,4.8
8.3,66.623,61,36.701,59.53,58,462.52,25,33,36,37.336,23,9,44.0,14,3,12,6.9
6.914,62.153,58,33.367,54.676,55,434.42,28,27,30,36.177,21,13,35.0,8,2,6,5.5
7.323,61.995,58,34.393,54.905,55,513.31,27,28,31,37.529,21,13,36.0,8,2,6,5.5
6.552,83.182,78,45.164,73.309,74,499.71,37,37,41,48.324,31,12,51.0,19,3,18,4.1
7.854,88.944,82,49.371,79.527,78,608.71,34,44,48,50.603,31,13,60.0,17,5,12,7.7
6.0,75.059,69,38.847,65.97,66,442.62,34,32,35,41.262,24,15,41.0,9,4,6,6.1
6.0,69.434,64,35.605,60.76,61,400.58,32,29,32,38.046,22,14,37.0,8,3,6,6.6
7.363,61.199,56,32.997,54.094,54,412.4,27,27,29,35.54,20,12,34.0,8,2,6,5.6
6.657,62.255,58,33.17,54.771,55,389.97,28,27,30,35.682,21,13,35.0,8,2,6,5.5
6.88,65.727,61,33.869,57.33,58,369.56,31,27,30,36.586,22,13,35.0,8,2,6,5.2
6.593,62.651,58,32.726,54.96,55,373.52,28,27,30,34.762,21,13,35.0,8,2,6,5.5
7.061,62.255,58,33.17,54.771,55,389.97,28,27,30,35.682,21,13,35.0,8,2,6,5.5
6.538,87.861,81,47.876,78.309,77,583.7,35,42,46,49.358,30,14,56.0,16,5,12,6.5
7.0,70.793,63,37.138,62.81,61,472.54,28,33,35,37.796,22,12,41.0,9,3,6,6.6
7.26,68.142,63,34.396,59.214,60,371.58,33,27,30,37.347,22,15,34.0,7,2,6,5.0
7.769,63.338,59,34.664,55.989,56,414.98,27,29,32,36.927,22,13,39.0,9,2,6,7.1
6.0,67.085,61,35.402,59.381,58,441.52,27,31,34,36.336,22,14,39.0,8,2,6,5.2
7.947,68.026,66,39.717,60.967,61,473.64,27,34,39,42.165,27,9,49.5,19,3,17,4.9
6.349,61.976,58,34.487,54.84,55,515.86,27,28,31,38.341,21,13,36.0,8,2,6,5.5
6.924,66.066,61,34.252,57.843,58,387.55,30,28,31,36.523,22,14,36.0,8,2,6,5.2
6.719,71.145,67,38.299,62.985,63,437.59,31,32,36,40.495,25,12,43.0,13,4,12,4.8
7.536,70.145,65,37.299,61.985,62,425.58,31,31,34,39.495,24,11,41.0,13,4,12,4.8
8.48,73.355,69,40.013,65.312,65,465.6,31,34,38,41.949,26,12,46.0,14,5,12,4.6
9.18,65.315,62,36.245,58.218,58,421.54,27,31,35,37.972,24,10,43.0,14,4,12,5.2
6.714,65.671,61,34.697,57.654,58,404.0,30,28,31,37.444,22,14,36.0,8,2,6,5.2
6.9,62.963,56,33.085,56.043,54,432.47,24,30,32,33.273,19,11,37.0,8,3,6,7.4
8.269,69.03,64,37.051,60.861,61,452.47,31,30,33,40.063,23,15,38.0,8,2,6,4.9
5.0,58.77,54,31.595,51.454,52,350.51,26,26,28,33.853,21,7,36.5,17,1,17,7.7
6.936,73.268,69,38.616,64.323,65,422.62,34,31,35,41.557,26,14,41.0,12,3,12,3.1
6.244,82.972,77,45.449,72.981,74,495.72,37,37,40,48.87,32,12,52.0,20,2,18,4.1
7.324,45.026,42,24.993,39.702,40,281.39,19,21,23,26.563,17,4,30.0,13,1,12,7.5
5.699,81.212,77,47.222,72.17,73,556.22,34,39,43,51.16,33,12,56.0,21,1,18,4.1
8.567,60.634,58,34.831,54.331,54,425.95,24,30,34,36.614,23,9,42.0,14,3,12,5.6
8.39,67.521,64,37.057,59.774,60,419.57,29,31,35,39.279,25,11,43.0,14,3,12,5.0
8.304,73.766,68,37.637,64.425,65,413.62,35,30,33,40.563,24,16,38.0,8,3,6,4.6
6.58,83.68,78,44.186,73.41,74,490.71,38,36,40,47.33,29,15,48.0,14,3,12,5.4
8.893,60.61,58,34.191,54.083,54,411.57,25,29,33,36.404,22,10,40.5,13,3,11,5.6
8.48,59.773,57,33.498,53.225,53,392.5,24,29,33,35.0,22,9,41.0,14,3,12,7.5
8.684,60.481,56,32.234,53.654,53,387.49,25,28,31,33.461,19,10,37.5,12,4,11,9.4
8.425,65.315,62,36.245,58.218,58,421.54,27,31,35,37.972,24,10,43.0,14,4,12,5.2
9.481,68.026,66,39.717,60.967,61,473.64,27,34,39,42.165,27,9,49.5,19,3,17,4.9
8.936,60.69,58,34.003,54.007,54,391.51,25,29,33,35.756,23,9,41.0,14,3,12,5.6
9.076,68.813,65,38.266,61.32,61,448.57,28,33,37,39.978,25,10,46.0,15,4,12,6.6
5.745,79.557,74,43.923,70.098,71,481.69,35,36,39,47.108,31,11,51.0,20,2,18,4.2
5.0,52.713,47,29.111,47.341,46,367.4,20,26,27,29.557,19,6,34.0,13,3,12,2.2
9.131,61.82,59,34.905,55.411,55,427.57,25,30,34,36.858,22,10,41.5,13,4,11,5.5
8.807,61.773,59,35.498,55.225,55,416.52,24,31,35,37.0,24,9,45.0,15,3,12,7.3
7.009,81.501,77,46.75,72.421,73,540.15,34,39,43,49.966,33,12,56.0,21,2,18,4.1
8.033,65.259,62,37.072,58.542,58,455.98,26,32,36,38.83,24,10,44.0,14,4,12,5.2
8.983,64.106,61,35.53,56.891,57,405.54,27,30,34,37.517,24,10,42.0,14,3,12,5.3
7.9,58.857,56,32.993,52.443,52,393.49,23,29,33,34.245,21,9,41.0,14,3,12,9.6
5.824,86.182,81,48.164,76.309,77,535.74,37,40,44,51.324,34,13,57.0,21,3,18,3.9
5.0,32.697,31,17.918,28.833,29,202.28,14,15,17,19.034,12,4,22.0,10,1,10,6.9
6.77,40.911,41,26.745,37.054,37,377.26,13,24,28,28.182,19,0,40.5,25,0,25,10.8
7.3,57.216,54,32.401,50.676,51,381.94,24,27,30,34.705,22,8,38.0,14,1,12,5.9
5.59,66.647,62,35.056,58.407,59,401.63,31,28,31,38.233,22,12,36.5,11,2,11,5.1
6.317,82.399,77,46.23,73.483,73,544.68,33,40,44,48.199,31,10,56.0,21,4,18,5.5
5.699,92.597,86,50.637,82.167,82,585.77,39,43,47,53.245,33,12,59.0,21,5,18,6.1
6.416,71.062,66,37.583,62.29,63,427.67,33,30,33,40.995,24,13,39.5,12,2,11,4.8
6.121,44.704,42,25.711,39.789,40,367.34,19,21,23,28.319,16,6,28.5,11,1,11,5.0
5.699,76.778,72,43.891,69.043,68,532.62,29,39,43,45.131,29,8,55.0,21,5,18,5.9
5.757,87.893,82,48.803,78.509,78,572.72,36,42,46,50.932,32,11,58.0,21,6,18,5.1
6.228,68.856,64,36.771,60.734,61,429.64,31,30,33,39.688,23,12,39.5,12,3,11,4.9
5.785,87.893,82,48.803,78.509,78,572.72,36,42,46,50.932,32,11,58.0,21,6,18,5.1
6.218,83.212,78,47.389,74.621,74,577.13,33,41,45,49.574,31,10,57.0,21,5,18,5.4
5.699,84.478,79,47.276,75.625,75,558.69,34,41,45,49.171,31,10,57.0,21,6,18,5.3
5.699,96.929,90,52.669,85.832,86,598.81,42,44,48,55.762,35,14,60.0,21,5,18,4.7
5.699,85.77,80,48.486,77.171,76,587.69,33,43,47,49.87,31,10,61.0,23,7,18,6.6
5.699,97.142,90,53.286,86.93,86,632.78,40,46,50,55.364,34,13,62.0,21,8,18,4.7
5.699,83.268,78,46.562,74.298,74,542.69,34,40,44,48.716,31,10,56.0,21,5,18,5.4
5.699,87.023,81,48.472,77.694,77,574.71,35,42,46,50.415,32,11,58.0,21,5,18,5.2
6.333,91.388,85,49.922,80.839,81,569.77,39,42,46,52.79,33,12,58.0,21,4,18,6.2
5.699,86.683,81,48.088,77.181,77,556.72,36,41,45,50.478,32,11,57.0,21,5,18,5.2
5.301,67.647,63,36.056,59.407,60,413.64,31,29,32,39.233,23,12,38.5,12,2,11,5.0
6.3,79.046,73,42.4,70.185,70,503.09,35,35,38,45.086,27,14,45.0,13,5,12,2.9
6.587,67.647,63,36.056,59.407,60,413.64,31,29,32,39.233,23,12,38.5,12,2,11,5.0
5.699,92.517,86,51.045,82.72,82,602.75,38,44,48,53.148,33,12,60.0,21,7,18,4.9
5.301,60.816,57,33.003,53.64,54,385.58,27,27,30,35.711,21,10,36.5,12,2,11,5.6
4.0,36.665,33,20.225,32.851,32,271.35,14,18,19,21.08,11,4,25.0,9,2,6,9.4
4.0,36.269,33,20.669,32.662,32,287.8,14,18,19,22.0,11,4,25.0,9,2,6,9.4
5.53,36.269,33,20.669,32.662,32,287.8,14,18,19,22.0,11,4,25.0,9,2,6,9.4
5.72,30.458,29,19.004,27.229,27,339.16,10,17,19,20.972,11,2,25.5,12,0,11,18.5
6.16,38.531,35,20.654,33.894,34,251.39,17,17,18,22.449,12,5,22.0,7,1,6,8.8
6.62,34.246,31,18.795,30.196,30,239.35,14,16,17,20.171,11,4,21.0,7,0,6,10.0
9.09,65.691,62,36.949,58.982,58,451.53,25,33,37,37.915,23,8,46.5,18,5,17,8.6
4.0,40.74,38,22.369,36.222,36,279.4,17,19,21,23.904,13,6,27.0,9,2,6,8.3
7.16,33.85,31,19.24,30.007,30,255.8,14,16,17,21.091,11,4,21.0,7,0,6,10.0
6.593,83.268,78,46.562,74.298,74,542.69,34,40,44,48.716,31,10,56.0,21,5,18,5.4
8.277,62.896,57,32.761,55.538,55,389.51,27,28,30,34.222,19,10,36.5,12,4,11,9.1
4.0,39.74,36,21.369,35.222,35,267.39,17,18,19,22.904,12,5,25.0,9,2,6,8.6
4.0,40.95,37,22.083,36.549,36,283.39,17,19,20,23.358,12,5,26.0,9,3,6,8.3
5.699,83.608,78,46.945,74.81,74,560.68,33,41,45,48.654,31,10,57.0,21,5,18,5.4
5.46,39.74,36,21.369,35.222,35,267.39,17,18,19,22.904,12,5,25.0,9,2,6,8.6
6.218,83.212,78,47.389,74.621,74,577.13,33,41,45,49.574,31,10,57.0,21,5,18,5.4
4.0,33.994,32,20.239,30.273,30,306.19,12,18,20,21.426,12,3,26.5,12,0,11,16.7
6.91,37.321,34,19.939,32.567,33,235.39,17,16,17,21.995,12,5,21.0,7,0,6,9.1
7.676,68.358,64,37.971,61.109,61,435.56,29,32,35,39.938,26,8,44.0,18,5,18,1.6
5.69,38.34,34,21.089,34.105,33,289.36,14,19,20,21.807,12,5,24.0,7,0,6,9.1
4.98,30.681,29,18.515,27.484,27,247.71,10,17,19,19.171,11,2,25.5,12,0,11,18.5
7.39,34.246,31,18.795,30.196,30,239.35,14,16,17,20.171,11,4,21.0,7,0,6,10.0
4.0,33.376,29,17.918,30.076,29,248.31,13,16,16,18.529,9,3,21.0,8,3,6,6.9
4.0,33.994,32,20.239,30.273,30,306.19,12,18,20,21.426,12,3,26.5,12,0,11,16.7
3.85,29.29,28,18.406,26.614,26,293.14,9,17,19,19.114,11,2,25.5,12,1,11,15.4
4.22,29.0,28,18.878,26.364,26,309.21,9,17,19,20.307,11,2,25.5,12,0,11,15.4
5.0,43.155,39,22.895,38.105,38,281.42,19,19,20,24.665,13,6,26.0,9,2,6,7.9
4.0,36.665,33,20.225,32.851,32,271.35,14,18,19,21.08,11,4,25.0,9,2,6,9.4
5.36,35.409,33,19.766,31.156,31,296.2,14,17,19,21.188,11,4,23.0,7,0,6,16.1
3.98,41.824,40,24.293,37.04,37,346.26,16,21,24,25.949,15,6,30.5,12,0,11,13.5
4.0,36.665,33,20.225,32.851,32,271.35,14,18,19,21.08,11,4,25.0,9,2,6,9.4
5.61,36.112,34,19.445,31.716,32,216.31,16,16,18,20.796,13,6,22.0,7,1,6,6.3
3.0,26.491,24,13.106,23.276,23,156.21,12,11,12,13.727,7,6,13.0,1,2,0,8.7
5.0,75.221,69,38.933,65.636,66,438.64,34,32,35,41.603,24,13,42.0,13,2,12,9.1
5.3,33.488,32,19.204,29.505,30,210.3,14,16,18,20.58,14,3,24.5,12,0,11,6.7
8.801,68.517,62,35.1,59.978,60,401.57,31,29,31,37.29,21,11,37.0,9,3,6,8.3
5.3,48.773,44,24.552,42.251,43,260.42,24,19,20,26.841,16,9,24.0,7,1,6,4.7
5.0,72.849,67,37.132,63.643,64,414.61,34,30,33,39.807,23,15,38.0,8,3,6,6.3
5.558,75.138,69,38.439,65.418,66,425.64,35,31,34,41.358,24,14,40.5,12,2,11,7.6
8.842,76.877,71,42.454,68.185,68,510.09,32,36,39,44.909,27,10,49.0,16,3,12,7.4
7.302,66.102,60,34.573,58.094,58,399.55,29,29,31,36.529,21,10,38.0,10,3,6,8.6
6.587,64.189,60,36.025,57.109,57,418.54,26,31,34,37.762,24,7,44.0,16,3,12,7.0
8.697,71.252,66,39.212,62.974,63,468.05,30,33,36,41.694,25,9,45.0,15,2,12,7.9
8.259,71.308,66,38.385,62.65,63,433.61,31,32,35,40.836,25,9,44.0,15,2,12,7.9
8.839,76.933,71,41.627,67.861,68,475.65,33,35,38,44.052,27,10,48.0,16,3,12,7.4
7.273,69.517,63,36.1,60.978,61,413.58,31,30,32,38.29,22,11,39.0,10,3,6,8.2
5.658,67.305,63,38.48,60.727,60,491.05,27,33,36,40.688,24,10,46.0,16,5,12,3.3
5.301,74.434,70,40.605,65.76,66,460.63,32,34,38,43.046,27,11,47.5,18,3,17,6.1
5.301,67.019,62,35.078,58.876,59,398.56,30,29,32,37.285,22,12,38.5,12,3,11,6.8
5.301,69.813,66,39.266,62.32,62,460.58,28,34,38,40.978,26,9,48.5,19,4,17,6.5
5.301,80.474,75,42.374,70.854,71,480.67,36,35,39,45.023,27,16,46.5,13,4,11,5.6
5.301,67.604,64,37.552,59.992,60,432.57,28,32,36,39.523,25,9,45.5,18,3,17,6.7
5.43,56.275,53,31.477,50.123,50,365.47,23,27,30,32.995,21,6,38.5,17,3,17,6.0
7.48,60.478,55,31.331,52.883,53,357.51,27,26,28,33.313,19,9,34.0,9,2,6,9.4
7.693,76.933,71,41.627,67.861,68,475.65,33,35,38,44.052,27,10,48.0,16,3,12,7.4
8.403,73.461,68,40.927,65.301,65,496.06,30,35,38,43.148,26,9,48.0,16,3,12,7.7
8.095,69.461,63,36.927,61.301,61,448.02,30,31,33,39.148,22,11,40.0,10,3,6,8.2
8.483,73.517,68,40.1,64.978,65,461.62,31,34,37,42.29,26,9,47.0,16,3,12,7.7
9.194,80.348,74,43.153,70.745,71,489.68,35,36,39,45.813,28,11,49.0,16,3,12,7.0
7.699,67.444,64,38.147,60.622,60,469.61,27,33,37,40.074,24,10,47.0,16,5,12,5.0
5.301,70.434,65,36.605,61.76,62,412.59,32,30,33,39.046,23,13,39.5,12,3,11,6.5
8.167,70.783,67,40.764,64.353,63,533.68,27,36,40,42.631,24,10,52.0,18,7,12,4.8
8.754,67.837,63,37.686,60.091,60,454.02,28,32,35,39.932,24,8,44.0,15,2,12,8.3
5.657,71.019,67,39.078,62.876,63,446.6,30,33,37,41.284,26,10,46.5,18,3,17,6.3
5.939,67.444,64,38.147,60.622,60,469.61,27,33,37,40.074,24,10,47.0,16,5,12,5.0
6.77,70.72,66,40.007,63.611,63,505.08,29,34,37,42.449,25,11,47.0,16,5,12,3.2
5.301,70.434,65,36.605,61.76,62,412.59,32,30,33,39.046,23,13,39.5,12,3,11,6.5
7.125,66.531,63,38.544,60.611,59,500.58,24,35,39,39.466,23,9,51.0,18,7,12,6.8
6.521,67.444,64,38.147,60.622,60,469.61,27,33,37,40.074,24,10,47.0,16,5,12,5.0
6.876,66.531,63,38.544,60.611,59,500.58,24,35,39,39.466,23,9,51.0,18,7,12,6.8
8.137,64.369,61,37.003,58.251,57,473.57,24,33,37,38.25,23,9,47.0,16,5,12,5.3
7.824,68.654,65,38.862,61.949,61,485.61,27,34,38,40.529,24,10,48.0,16,6,12,4.9
7.301,64.369,61,37.003,58.251,57,473.57,24,33,37,38.25,23,9,47.0,16,5,12,5.3
8.9,63.361,57,33.652,56.403,56,408.57,28,28,29,35.83,20,8,37.0,14,5,12,3.6
5.301,73.849,68,38.132,64.643,65,426.62,34,31,34,40.807,24,14,40.5,12,3,11,6.2
6.658,57.777,54,32.18,51.52,51,401.54,23,28,31,33.892,19,8,40.0,15,3,12,9.8
5.27,30.579,29,18.713,27.389,27,292.16,10,17,19,19.665,11,2,25.5,12,0,11,18.5
9.018,63.106,59,34.53,55.891,56,393.53,27,29,32,36.517,23,9,40.0,14,3,12,5.4
7.8,65.172,61,35.675,57.552,58,413.0,29,29,32,38.438,24,10,40.0,16,2,16,3.4
6.42,95.221,90,52.933,84.403,85,591.81,41,44,49,56.302,37,13,62.0,22,4,18,3.5
6.62,98.929,92,54.669,87.832,88,622.83,42,46,50,57.762,37,13,65.0,24,5,18,4.5
5.75,97.72,92,53.954,86.505,87,606.83,42,45,50,57.307,37,13,63.0,22,4,18,4.6
6.82,94.095,88,52.712,83.294,84,588.81,40,44,48,56.091,37,12,63.0,23,3,18,4.8
6.58,94.304,88,52.427,83.621,84,592.8,40,44,48,55.546,36,12,63.0,24,4,18,4.8
6.886,77.742,71,43.062,69.072,68,525.63,30,38,41,44.41,28,11,52.0,16,2,12,7.4
5.959,77.742,71,43.062,69.072,68,525.63,30,38,41,44.41,28,11,52.0,16,2,12,7.4
8.102,74.327,68,41.535,66.189,65,511.6,28,37,40,42.648,27,10,51.0,16,2,12,7.7
6.569,74.263,67,41.19,66.508,64,540.56,26,38,41,41.216,26,10,50.0,15,2,12,6.3
5.733,68.572,63,37.625,60.792,60,455.56,27,33,36,38.949,24,9,45.0,15,2,12,8.3
7.699,80.074,73,43.094,70.738,70,514.65,33,37,40,44.927,28,12,49.0,15,2,12,5.7
6.921,76.659,70,41.567,67.854,67,500.62,31,36,39,43.165,27,11,48.0,15,2,12,6.0
7.481,82.284,75,44.809,73.065,72,542.66,33,39,42,46.381,29,12,52.0,16,3,12,5.6
8.319,76.659,70,41.567,67.854,67,500.62,31,36,39,43.165,27,11,48.0,15,2,12,6.0
6.538,70.572,65,39.625,62.792,62,479.58,27,35,38,40.949,26,9,49.0,16,2,12,8.1
7.87,84.683,78,46.088,75.181,75,532.7,36,39,42,48.478,30,12,54.0,18,5,12,5.3
6.013,71.655,66,41.119,64.01,63,504.59,26,37,40,42.194,27,9,53.0,17,2,12,9.5
6.629,76.612,70,41.393,67.887,67,499.62,31,36,39,42.927,26,11,48.0,15,3,12,7.5
5.699,73.006,66,40.301,65.214,63,523.56,26,37,40,40.523,25,10,49.0,15,2,12,7.9
5.699,78.825,72,44.556,70.29,69,550.64,29,40,43,45.654,29,11,56.0,17,2,12,8.7
7.398,73.244,67,40.04,64.97,64,486.59,29,35,38,41.404,26,10,47.0,15,2,12,6.3
6.65,96.431,91,53.647,85.73,86,607.81,41,45,50,56.756,37,13,63.0,22,5,18,3.5
6.61,100.218,93,54.975,88.607,89,621.85,43,46,50,58.313,37,13,65.0,24,4,18,5.6
7.276,74.327,68,41.535,66.189,65,511.6,28,37,40,42.648,27,10,51.0,16,2,12,7.7
7.11,92.099,86,51.615,82.065,82,594.77,38,44,48,54.239,35,11,63.0,24,5,18,4.9
6.86,99.427,94,55.745,87.959,89,613.86,43,46,51,59.609,40,12,66.5,27,3,23,3.4
7.06,74.327,68,41.535,66.189,65,511.6,28,37,40,42.648,27,10,51.0,16,2,12,7.7
7.387,77.869,71,42.282,69.181,68,516.62,31,37,40,43.62,27,11,49.0,15,3,12,5.9
6.155,75.006,68,42.301,67.214,65,547.58,26,39,42,42.523,27,10,53.0,16,2,12,7.7
7.602,83.493,76,45.523,74.392,73,558.66,33,40,43,46.836,29,12,53.0,16,4,12,5.5
7.071,80.074,73,43.094,70.738,70,514.65,33,37,40,44.927,28,12,49.0,15,2,12,5.7
7.143,78.825,72,44.556,70.29,69,550.64,29,40,43,45.654,29,11,56.0,17,2,12,8.7
7.62,69.829,64,38.513,62.087,61,472.56,27,34,37,39.642,25,9,46.0,15,2,12,6.6
7.585,70.912,65,40.008,63.305,62,497.57,26,36,39,40.887,26,9,50.0,16,2,12,8.1
6.699,75.346,68,42.685,67.727,65,565.57,25,40,43,42.461,27,10,54.0,16,2,12,7.7
5.6,64.148,60,34.035,56.305,57,386.61,30,27,30,37.228,22,12,37.5,13,2,11,3.5
6.5,45.524,42,24.015,39.803,40,272.39,20,20,22,25.569,15,7,27.0,8,1,6,10.0
6.595,114.171,105,61.292,100.687,101,694.96,50,51,55,65.057,40,16,70.0,24,5,18,5.9
6.896,117.294,108,62.609,103.025,104,692.0,53,51,55,67.12,42,18,70.0,24,4,18,4.8
6.105,114.171,105,61.292,100.687,101,694.96,50,51,55,65.057,40,16,70.0,24,5,18,5.9
7.1,48.939,45,25.542,42.687,43,286.42,22,21,23,27.33,16,8,28.0,8,1,6,9.3
7.1,46.651,42,24.235,40.912,41,275.39,21,20,21,25.779,15,7,26.0,8,2,6,7.3
6.57,106.131,98,57.524,93.592,94,650.9,46,48,52,61.08,38,14,67.0,24,4,18,6.4
8.8,37.694,34,19.961,33.036,33,232.32,16,17,18,21.046,12,4,23.0,8,1,6,12.1
7.747,93.095,85,49.658,82.269,82,576.77,40,42,45,52.25,31,13,57.0,18,5,12,7.3
7.9,47.939,43,24.542,41.687,42,274.41,22,20,21,26.33,15,7,26.0,8,1,6,9.5
6.35,110.756,102,59.765,97.803,98,680.93,48,50,54,63.296,39,15,69.0,24,5,18,6.1
6.742,102.716,95,55.997,90.708,91,636.87,44,47,51,59.319,37,13,66.0,24,4,18,6.6
6.921,70.955,65,38.734,63.196,62,475.56,28,34,37,39.853,25,11,45.0,14,3,12,4.8
5.3,45.524,42,24.015,39.803,40,272.39,20,20,22,25.569,15,7,27.0,8,1,6,10.0
6.6,42.109,39,22.488,36.92,37,258.36,18,19,21,23.807,14,6,26.0,8,1,6,10.8
9.23,66.896,63,36.761,59.538,59,437.55,27,32,36,38.222,23,10,45.0,17,4,16,8.5
5.3,46.651,42,24.235,40.912,41,275.39,21,20,21,25.779,15,7,26.0,8,2,6,7.3
6.9,44.524,40,23.015,38.803,39,260.38,20,19,20,24.569,14,6,25.0,8,1,6,10.3
4.413,105.839,96,55.26,93.021,93,633.88,47,46,49,58.54,34,16,61.0,18,5,12,7.5
7.007,107.507,99,59.228,95.356,95,692.9,44,51,55,62.023,38,14,72.0,26,5,18,8.4
5.888,51.567,49,28.74,45.694,46,322.44,22,24,27,30.534,20,8,34.0,13,2,12,4.3
6.863,58.9,57,33.773,52.36,53,371.51,25,28,32,36.052,25,8,41.5,18,2,17,1.9
6.751,66.746,61,35.019,58.869,58,423.53,28,30,33,36.398,22,14,38.0,8,2,6,5.2
7.2,46.651,42,24.235,40.912,41,275.39,21,20,21,25.779,15,7,26.0,8,2,6,7.3
6.656,69.65,66,38.959,62.178,62,467.64,29,33,37,41.381,25,10,48.0,19,4,16,4.8
5.3,51.355,46,26.068,44.571,45,288.44,24,21,22,28.091,16,8,27.0,8,1,6,8.9
5.3,51.066,47,26.762,44.796,45,301.43,23,22,24,28.54,17,9,29.0,8,2,6,6.7
6.7,41.109,37,21.488,35.92,36,246.35,18,18,19,22.807,13,5,24.0,8,1,6,11.1
6.05,65.943,62,37.444,59.225,59,433.54,27,32,35,39.176,26,7,45.0,19,5,18,1.7
7.6,46.651,42,24.235,40.912,41,275.39,21,20,21,25.779,15,7,26.0,8,2,6,7.3
6.827,68.152,65,38.937,61.076,61,464.63,28,33,37,41.375,26,9,48.5,20,4,17,3.3
6.46,111.673,103,60.271,98.585,99,679.94,49,50,54,64.052,40,16,69.0,24,5,18,5.1
